river,year,count,original_notes,day_of_yr,cumulative_count
Anan Creek,1925,13,,168,13
Anan Creek,1925,4,,169,17
Anan Creek,1925,6,,170,23
Anan Creek,1925,6,,171,29
Anan Creek,1925,14,,172,43
Anan Creek,1925,168,,173,211
Anan Creek,1925,1445,,174,1656
Anan Creek,1925,2768,,175,4424
Anan Creek,1925,3645,,176,8069
Anan Creek,1925,2949,,177,11018
Anan Creek,1925,3465,,178,14483
Anan Creek,1925,1286,,179,15769
Anan Creek,1925,328,,180,16097
Anan Creek,1925,793,,181,16890
Anan Creek,1925,749,,182,17639
Anan Creek,1925,2570,,183,20209
Anan Creek,1925,4976,,184,25185
Anan Creek,1925,5079,,185,30264
Anan Creek,1925,5856,,186,36120
Anan Creek,1925,8694,,187,44814
Anan Creek,1925,14071,,188,58885
Anan Creek,1925,1285,,189,60170
Anan Creek,1925,0,,190,60170
Anan Creek,1925,1519,,191,61689
Anan Creek,1925,1164,,192,62853
Anan Creek,1925,137,,193,62990
Anan Creek,1925,0,,194,62990
Anan Creek,1925,748,,195,63738
Anan Creek,1925,2849,,196,66587
Anan Creek,1925,3963,,197,70550
Anan Creek,1925,1397,,198,71947
Anan Creek,1925,3602,,199,75549
Anan Creek,1925,7312,,200,82861
Anan Creek,1925,10385,,201,93246
Anan Creek,1925,9663,,202,102909
Anan Creek,1925,11235,,203,114144
Anan Creek,1925,10915,,204,125059
Anan Creek,1925,10211,,205,135270
Anan Creek,1925,7841,,206,143111
Anan Creek,1925,4621,,207,147732
Anan Creek,1925,6489,,208,154221
Anan Creek,1925,4467,,209,158688
Anan Creek,1925,6233,,210,164921
Anan Creek,1925,5512,,211,170433
Anan Creek,1925,7302,,212,177735
Anan Creek,1925,3665,,213,181400
Anan Creek,1925,4712,,214,186112
Anan Creek,1925,1938,,215,188050
Anan Creek,1925,1864,,216,189914
Anan Creek,1925,1296,,217,191210
Anan Creek,1925,4905,,218,196115
Anan Creek,1925,8310,,219,204425
Anan Creek,1925,7085,,220,211510
Anan Creek,1925,6001,,221,217511
Anan Creek,1925,6318,,222,223829
Anan Creek,1925,9400,,223,233229
Anan Creek,1925,3818,,224,237047
Anan Creek,1925,3282,,225,240329
Anan Creek,1925,2269,,226,242598
Anan Creek,1925,2961,,227,245559
Anan Creek,1925,1970,,228,247529
Anan Creek,1925,1675,,229,249204
Anan Creek,1925,1517,,230,250721
Anan Creek,1925,1694,,231,252415
Anan Creek,1925,709,,232,253124
Anan Creek,1925,1494,,233,254618
Anan Creek,1925,773,,234,255391
Anan Creek,1925,618,,235,256009
Anan Creek,1925,624,,236,256633
Anan Creek,1925,279,,237,256912
Anan Creek,1925,376,,238,257288
Anan Creek,1925,333,,239,257621
Anan Creek,1925,245,,240,257866
Anan Creek,1925,407,,241,258273
Anan Creek,1925,214,,242,258487
Anan Creek,1925,288,,243,258775
Anan Creek,1925,280,,244,259055
Anan Creek,1925,245,,245,259300
Anan Creek,1925,306,,246,259606
Anan Creek,1925,422,,247,260028
Anan Creek,1925,319,,248,260347
Anan Creek,1925,220,,249,260567
Anan Creek,1925,134,,250,260701
Anan Creek,1925,143,,251,260844
Anan Creek,1926,1,,163,1
Anan Creek,1926,8,,164,9
Anan Creek,1926,16,,165,25
Anan Creek,1926,44,,166,69
Anan Creek,1926,230,,167,299
Anan Creek,1926,177,,168,476
Anan Creek,1926,403,,169,879
Anan Creek,1926,425,,170,1304
Anan Creek,1926,1514,,171,2818
Anan Creek,1926,2984,,172,5802
Anan Creek,1926,1494,,173,7296
Anan Creek,1926,2621,,174,9917
Anan Creek,1926,1875,,175,11792
Anan Creek,1926,563,,176,12355
Anan Creek,1926,893,,177,13248
Anan Creek,1926,5,,178,13253
Anan Creek,1926,234,,179,13487
Anan Creek,1926,493,,180,13980
Anan Creek,1926,1826,,181,15806
Anan Creek,1926,1950,,182,17756
Anan Creek,1926,2445,,183,20201
Anan Creek,1926,5305,,184,25506
Anan Creek,1926,7454,,185,32960
Anan Creek,1926,5655,,186,38615
Anan Creek,1926,7067,,187,45682
Anan Creek,1926,5732,,188,51414
Anan Creek,1926,5730,,189,57144
Anan Creek,1926,4853,,190,61997
Anan Creek,1926,4263,,191,66260
Anan Creek,1926,4483,,192,70743
Anan Creek,1926,4461,,193,75204
Anan Creek,1926,4217,,194,79421
Anan Creek,1926,3909,,195,83330
Anan Creek,1926,3308,,196,86638
Anan Creek,1926,2469,,197,89107
Anan Creek,1926,3548,,198,92655
Anan Creek,1926,1673,,199,94328
Anan Creek,1926,1503,,200,95831
Anan Creek,1926,3984,,201,99815
Anan Creek,1926,4581,,202,104396
Anan Creek,1926,3096,,203,107492
Anan Creek,1926,2199,,204,109691
Anan Creek,1926,0,,205,109691
Anan Creek,1926,776,,206,110467
Anan Creek,1926,877,,207,111344
Anan Creek,1926,1536,,208,112880
Anan Creek,1926,1593,,209,114473
Anan Creek,1926,870,,210,115343
Anan Creek,1926,600,,211,115943
Anan Creek,1926,585,,212,116528
Anan Creek,1926,369,,213,116897
Anan Creek,1926,1476,,214,118373
Anan Creek,1926,908,,215,119281
Anan Creek,1926,528,,216,119809
Anan Creek,1926,262,,217,120071
Anan Creek,1926,310,,218,120381
Anan Creek,1926,142,,219,120523
Anan Creek,1926,108,,220,120631
Anan Creek,1926,47,,221,120678
Anan Creek,1926,39,,222,120717
Anan Creek,1926,46,,223,120763
Anan Creek,1926,44,,224,120807
Anan Creek,1926,36,,225,120843
Anan Creek,1926,21,,226,120864
Anan Creek,1926,23,,227,120887
Anan Creek,1926,23,,228,120910
Anan Creek,1926,6,,229,120916
Anan Creek,1926,325,,230,121241
Anan Creek,1926,190,,231,121431
Anan Creek,1926,41,,232,121472
Anan Creek,1926,40,,233,121512
Anan Creek,1926,47,,234,121559
Anan Creek,1926,30,,235,121589
Anan Creek,1926,18,,236,121607
Anan Creek,1926,82,,237,121689
Anan Creek,1926,14,,238,121703
Anan Creek,1926,18,,239,121721
Anan Creek,1926,21,,240,121742
Anan Creek,1926,17,,241,121759
Anan Creek,1926,1,,242,121760
Anan Creek,1926,14,,243,121774
Anan Creek,1927,1,,173,1
Anan Creek,1927,0,,174,1
Anan Creek,1927,2,,175,3
Anan Creek,1927,2,,176,5
Anan Creek,1927,1,,177,6
Anan Creek,1927,0,,178,6
Anan Creek,1927,4,,179,10
Anan Creek,1927,1,,180,11
Anan Creek,1927,37,,181,48
Anan Creek,1927,94,,182,142
Anan Creek,1927,42,,183,184
Anan Creek,1927,290,,184,474
Anan Creek,1927,138,,185,612
Anan Creek,1927,178,,186,790
Anan Creek,1927,550,,187,1340
Anan Creek,1927,988,,188,2328
Anan Creek,1927,18,,189,2346
Anan Creek,1927,23,,190,2369
Anan Creek,1927,223,,191,2592
Anan Creek,1927,674,,192,3266
Anan Creek,1927,664,,193,3930
Anan Creek,1927,977,,194,4907
Anan Creek,1927,179,,195,5086
Anan Creek,1927,1398,,196,6484
Anan Creek,1927,1254,,197,7738
Anan Creek,1927,879,,198,8617
Anan Creek,1927,897,,199,9514
Anan Creek,1927,642,,200,10156
Anan Creek,1927,656,,201,10812
Anan Creek,1927,1243,,202,12055
Anan Creek,1927,881,,203,12936
Anan Creek,1927,295,,204,13231
Anan Creek,1927,838,,205,14069
Anan Creek,1927,835,,206,14904
Anan Creek,1927,624,,207,15528
Anan Creek,1927,482,,208,16010
Anan Creek,1927,866,,209,16876
Anan Creek,1927,1859,,210,18735
Anan Creek,1927,867,,211,19602
Anan Creek,1927,1726,,212,21328
Anan Creek,1927,876,,213,22204
Anan Creek,1927,818,,214,23022
Anan Creek,1927,996,,215,24018
Anan Creek,1927,395,,216,24413
Anan Creek,1927,761,,217,25174
Anan Creek,1927,947,,218,26121
Anan Creek,1927,592,,219,26713
Anan Creek,1927,603,,220,27316
Anan Creek,1927,359,,221,27675
Anan Creek,1927,340,,222,28015
Anan Creek,1927,1354,,223,29369
Anan Creek,1927,335,,224,29704
Anan Creek,1927,672,,225,30376
Anan Creek,1927,306,,226,30682
Anan Creek,1927,409,,227,31091
Anan Creek,1927,396,,228,31487
Anan Creek,1927,318,,229,31805
Anan Creek,1927,452,,230,32257
Anan Creek,1927,449,,231,32706
Anan Creek,1927,227,,232,32933
Anan Creek,1927,400,,233,33333
Anan Creek,1927,346,,234,33679
Anan Creek,1927,616,,235,34295
Anan Creek,1927,116,,236,34411
Anan Creek,1927,1298,,237,35709
Anan Creek,1927,242,,238,35951
Anan Creek,1927,299,,239,36250
Anan Creek,1927,766,,240,37016
Anan Creek,1927,771,,241,37787
Anan Creek,1927,804,,242,38591
Anan Creek,1927,918,,243,39509
Anan Creek,1927,416,,244,39925
Anan Creek,1927,564,,245,40489
Anan Creek,1927,421,,246,40910
Anan Creek,1927,0,,247,40910
Anan Creek,1927,358,,248,41268
Anan Creek,1927,403,,249,41671
Anan Creek,1927,350,,250,42021
Anan Creek,1927,204,,251,42225
Anan Creek,1927,493,,252,42718
Anan Creek,1927,283,,253,43001
Anan Creek,1927,130,,254,43131
Anan Creek,1927,204,,255,43335
Anan Creek,1927,252,,256,43587
Anan Creek,1927,43,,257,43630
Anan Creek,1927,179,,258,43809
Anan Creek,1927,454,,259,44263
Anan Creek,1927,88,,260,44351
Anan Creek,1927,94,,261,44445
Anan Creek,1927,97,,262,44542
Anan Creek,1927,120,,263,44662
Anan Creek,1927,85,,265,44747
Anan Creek,1927,75,,266,44822
Anan Creek,1928,4,,169,4
Anan Creek,1928,0,,170,4
Anan Creek,1928,8,,171,12
Anan Creek,1928,8,,172,20
Anan Creek,1928,427,,173,447
Anan Creek,1928,458,,174,905
Anan Creek,1928,471,,175,1376
Anan Creek,1928,825,,176,2201
Anan Creek,1928,2170,,177,4371
Anan Creek,1928,3011,,178,7382
Anan Creek,1928,4198,,179,11580
Anan Creek,1928,4561,,180,16141
Anan Creek,1928,3570,,181,19711
Anan Creek,1928,3114,,182,22825
Anan Creek,1928,5628,,183,28453
Anan Creek,1928,4356,,184,32809
Anan Creek,1928,5854,,185,38663
Anan Creek,1928,5646,,186,44309
Anan Creek,1928,6555,,187,50864
Anan Creek,1928,4869,,188,55733
Anan Creek,1928,2691,,189,58424
Anan Creek,1928,4598,,190,63022
Anan Creek,1928,4397,,191,67419
Anan Creek,1928,3462,,192,70881
Anan Creek,1928,848,,193,71729
Anan Creek,1928,1524,,194,73253
Anan Creek,1928,2466,,195,75719
Anan Creek,1928,5204,,196,80923
Anan Creek,1928,8561,,197,89484
Anan Creek,1928,14922,,198,104406
Anan Creek,1928,15696,,199,120102
Anan Creek,1928,11136,,200,131238
Anan Creek,1928,2318,,201,133556
Anan Creek,1928,957,,202,134513
Anan Creek,1928,47,,203,134560
Anan Creek,1928,4936,,204,139496
Anan Creek,1928,5652,,205,145148
Anan Creek,1928,7177,,206,152325
Anan Creek,1928,8265,,207,160590
Anan Creek,1928,8309,,208,168899
Anan Creek,1928,5005,,209,173904
Anan Creek,1928,3838,,210,177742
Anan Creek,1928,3827,,211,181569
Anan Creek,1928,3007,,212,184576
Anan Creek,1928,2381,,213,186957
Anan Creek,1928,1365,,214,188322
Anan Creek,1928,1422,,215,189744
Anan Creek,1928,863,,216,190607
Anan Creek,1928,214,,217,190821
Anan Creek,1928,853,,218,191674
Anan Creek,1928,378,,219,192052
Anan Creek,1928,180,,220,192232
Anan Creek,1928,0,,221,192232
Anan Creek,1928,12,,222,192244
Anan Creek,1928,18,,223,192262
Anan Creek,1928,8,,224,192270
Anan Creek,1928,52,,225,192322
Anan Creek,1928,356,,226,192678
Anan Creek,1928,185,,227,192863
Anan Creek,1928,184,,228,193047
Anan Creek,1928,113,,229,193160
Anan Creek,1928,113,,230,193273
Anan Creek,1928,248,,231,193521
Anan Creek,1928,90,,232,193611
Anan Creek,1928,69,,233,193680
Anan Creek,1928,32,,234,193712
Anan Creek,1928,1,,235,193713
Anan Creek,1928,53,,236,193766
Anan Creek,1928,46,,237,193812
Anan Creek,1928,6,,238,193818
Anan Creek,1928,24,,239,193842
Anan Creek,1928,17,,240,193859
Anan Creek,1928,19,,241,193878
Anan Creek,1928,33,,242,193911
Anan Creek,1928,34,,243,193945
Anan Creek,1928,47,,244,193992
Anan Creek,1928,50,,245,194042
Anan Creek,1928,74,,246,194116
Anan Creek,1928,46,,247,194162
Anan Creek,1928,65,,248,194227
Anan Creek,1928,38,,249,194265
Anan Creek,1928,44,,250,194309
Anan Creek,1928,36,,251,194345
Anan Creek,1928,55,,252,194400
Anan Creek,1928,243,,253,194643
Anan Creek,1928,194,,254,194837
Anan Creek,1928,171,,255,195008
Anan Creek,1928,106,,256,195114
Anan Creek,1928,228,,257,195342
Anan Creek,1928,53,,258,195395
Anan Creek,1928,37,,259,195432
Anan Creek,1928,38,,260,195470
Anan Creek,1928,17,,261,195487
Anan Creek,1928,9,,262,195496
Anan Creek,1928,0,,263,195496
Anan Creek,1928,0,,264,195496
Anan Creek,1928,4,,265,195500
Anan Creek,1928,7,,266,195507
Anan Creek,1928,6,,267,195513
Anan Creek,1929,4,,165,4
Anan Creek,1929,1,,166,5
Anan Creek,1929,10,,167,15
Anan Creek,1929,13,,168,28
Anan Creek,1929,3,,169,31
Anan Creek,1929,20,,170,51
Anan Creek,1929,6,,171,57
Anan Creek,1929,11,,172,68
Anan Creek,1929,183,,173,251
Anan Creek,1929,553,,174,804
Anan Creek,1929,534,,175,1338
Anan Creek,1929,796,,176,2134
Anan Creek,1929,46,,177,2180
Anan Creek,1929,542,,178,2722
Anan Creek,1929,855,,179,3577
Anan Creek,1929,2699,,180,6276
Anan Creek,1929,2791,,181,9067
Anan Creek,1929,3705,,182,12772
Anan Creek,1929,1272,,183,14044
Anan Creek,1929,1410,,184,15454
Anan Creek,1929,2899,,185,18353
Anan Creek,1929,2494,,186,20847
Anan Creek,1929,3207,,187,24054
Anan Creek,1929,7113,,188,31167
Anan Creek,1929,7095,,189,38262
Anan Creek,1929,4121,,190,42383
Anan Creek,1929,5470,,191,47853
Anan Creek,1929,6340,,192,54193
Anan Creek,1929,6254,,193,60447
Anan Creek,1929,4480,,194,64927
Anan Creek,1929,4882,,195,69809
Anan Creek,1929,4175,,196,73984
Anan Creek,1929,3016,,197,77000
Anan Creek,1929,2196,,198,79196
Anan Creek,1929,1818,,199,81014
Anan Creek,1929,3685,,200,84699
Anan Creek,1929,4209,,201,88908
Anan Creek,1929,4229,,202,93137
Anan Creek,1929,4223,,203,97360
Anan Creek,1929,2273,,204,99633
Anan Creek,1929,2663,,205,102296
Anan Creek,1929,3431,,206,105727
Anan Creek,1929,6306,,207,112033
Anan Creek,1929,922,,208,112955
Anan Creek,1929,3067,,209,116022
Anan Creek,1929,2693,,210,118715
Anan Creek,1929,6063,,211,124778
Anan Creek,1929,9113,,212,133891
Anan Creek,1929,9267,,213,143158
Anan Creek,1929,10454,,214,153612
Anan Creek,1929,5930,,215,159542
Anan Creek,1929,8370,,216,167912
Anan Creek,1929,5632,,217,173544
Anan Creek,1929,5044,,218,178588
Anan Creek,1929,5001,,219,183589
Anan Creek,1929,5156,,220,188745
Anan Creek,1929,2992,,221,191737
Anan Creek,1929,3031,,222,194768
Anan Creek,1929,2618,,223,197386
Anan Creek,1929,2796,,224,200182
Anan Creek,1929,2595,,225,202777
Anan Creek,1929,2001,,226,204778
Anan Creek,1929,1957,,227,206735
Anan Creek,1929,1140,,228,207875
Anan Creek,1929,523,,229,208398
Anan Creek,1929,1002,,230,209400
Anan Creek,1929,1023,,231,210423
Anan Creek,1929,1078,,232,211501
Anan Creek,1929,0,,233,211501
Anan Creek,1929,0,,234,211501
Anan Creek,1929,512,,235,212013
Anan Creek,1929,586,,236,212599
Anan Creek,1929,199,,237,212798
Anan Creek,1929,272,,238,213070
Anan Creek,1929,782,,239,213852
Anan Creek,1929,688,,240,214540
Anan Creek,1929,500,,241,215040
Anan Creek,1929,503,,242,215543
Anan Creek,1929,300,,243,215843
Anan Creek,1929,852,,244,216695
Anan Creek,1929,564,,245,217259
Anan Creek,1929,526,,246,217785
Anan Creek,1929,423,,247,218208
Anan Creek,1929,161,,248,218369
Anan Creek,1929,403,,249,218772
Anan Creek,1929,232,,250,219004
Anan Creek,1929,266,,251,219270
Anan Creek,1929,209,,252,219479
Anan Creek,1929,144,,253,219623
Anan Creek,1929,104,,254,219727
Anan Creek,1929,325,,255,220052
Anan Creek,1929,104,,256,220156
Anan Creek,1929,132,,257,220288
Anan Creek,1929,114,,258,220402
Anan Creek,1929,225,,259,220627
Anan Creek,1929,173,,260,220800
Anan Creek,1929,213,,261,221013
Anan Creek,1929,265,,262,221278
Anan Creek,1929,111,,263,221389
Anan Creek,1929,39,,264,221428
Anan Creek,1929,34,,265,221462
Anan Creek,1930,1,,163,1
Anan Creek,1930,2,,164,3
Anan Creek,1930,1,,165,4
Anan Creek,1930,0,,166,4
Anan Creek,1930,4,,167,8
Anan Creek,1930,7,,168,15
Anan Creek,1930,1,,169,16
Anan Creek,1930,3,,170,19
Anan Creek,1930,3,,171,22
Anan Creek,1930,5,,172,27
Anan Creek,1930,16,,173,43
Anan Creek,1930,40,,174,83
Anan Creek,1930,189,,175,272
Anan Creek,1930,95,,176,367
Anan Creek,1930,1275,,177,1642
Anan Creek,1930,2209,,178,3851
Anan Creek,1930,3203,,179,7054
Anan Creek,1930,2267,,180,9321
Anan Creek,1930,610,,181,9931
Anan Creek,1930,1239,,182,11170
Anan Creek,1930,3399,,183,14569
Anan Creek,1930,4066,,184,18635
Anan Creek,1930,3876,,185,22511
Anan Creek,1930,9171,,186,31682
Anan Creek,1930,11543,,187,43225
Anan Creek,1930,2544,,188,45769
Anan Creek,1930,4002,,189,49771
Anan Creek,1930,9319,,190,59090
Anan Creek,1930,24950,,191,84040
Anan Creek,1930,30611,,192,114651
Anan Creek,1930,31897,,193,146548
Anan Creek,1930,33754,,194,180302
Anan Creek,1930,27119,,195,207421
Anan Creek,1930,8487,,196,215908
Anan Creek,1930,6816,,197,222724
Anan Creek,1930,10956,,198,233680
Anan Creek,1930,20100,,199,253780
Anan Creek,1930,30301,,200,284081
Anan Creek,1930,24834,,201,308915
Anan Creek,1930,5792,,202,314707
Anan Creek,1930,1189,,203,315896
Anan Creek,1930,3539,,204,319435
Anan Creek,1930,7746,,205,327181
Anan Creek,1930,9617,,206,336798
Anan Creek,1930,10423,,207,347221
Anan Creek,1930,16576,,208,363797
Anan Creek,1930,14530,,209,378327
Anan Creek,1930,1698,,210,380025
Anan Creek,1930,6440,,211,386465
Anan Creek,1930,26378,,212,412843
Anan Creek,1930,19641,,213,432484
Anan Creek,1930,220,,214,432704
Anan Creek,1930,32215,,215,464919
Anan Creek,1930,13353,,216,478272
Anan Creek,1930,4751,,217,483023
Anan Creek,1930,150,,218,483173
Anan Creek,1930,2141,,219,485314
Anan Creek,1930,4629,,220,489943
Anan Creek,1930,8028,,221,497971
Anan Creek,1930,10631,,222,508602
Anan Creek,1930,10292,,223,518894
Anan Creek,1930,10978,,224,529872
Anan Creek,1930,7044,,225,536916
Anan Creek,1930,2088,,226,539004
Anan Creek,1930,5694,,227,544698
Anan Creek,1930,3044,,228,547742
Anan Creek,1930,2053,,229,549795
Anan Creek,1930,325,,230,550120
Anan Creek,1930,1122,,231,551242
Anan Creek,1930,813,,232,552055
Anan Creek,1930,746,,233,552801
Anan Creek,1930,835,,234,553636
Anan Creek,1930,961,,235,554597
Anan Creek,1930,608,,236,555205
Anan Creek,1930,487,,237,555692
Anan Creek,1930,248,,238,555940
Anan Creek,1930,1433,,239,557373
Anan Creek,1930,427,,240,557800
Anan Creek,1930,295,,241,558095
Anan Creek,1930,483,,242,558578
Anan Creek,1930,250,,243,558828
Anan Creek,1930,251,,244,559079
Anan Creek,1930,310,,245,559389
Anan Creek,1930,310,,246,559699
Anan Creek,1930,284,,247,559983
Anan Creek,1930,408,,248,560391
Anan Creek,1930,356,,249,560747
Anan Creek,1930,267,,250,561014
Anan Creek,1931,5,,168,5
Anan Creek,1931,1,,169,6
Anan Creek,1931,7,,170,13
Anan Creek,1931,5,,171,18
Anan Creek,1931,66,,172,84
Anan Creek,1931,90,,173,174
Anan Creek,1931,325,,174,499
Anan Creek,1931,624,,175,1123
Anan Creek,1931,1484,,176,2607
Anan Creek,1931,2754,,177,5361
Anan Creek,1931,2720,,178,8081
Anan Creek,1931,2791,,179,10872
Anan Creek,1931,3330,,180,14202
Anan Creek,1931,5770,,181,19972
Anan Creek,1931,8882,,182,28854
Anan Creek,1931,8763,,183,37617
Anan Creek,1931,9219,,184,46836
Anan Creek,1931,8648,,185,55484
Anan Creek,1931,8644,,186,64128
Anan Creek,1931,13979,,187,78107
Anan Creek,1931,15202,,188,93309
Anan Creek,1931,18022,,189,111331
Anan Creek,1931,18743,,190,130074
Anan Creek,1931,15693,,191,145767
Anan Creek,1931,13300,,192,159067
Anan Creek,1931,6627,,193,165694
Anan Creek,1931,15013,,194,180707
Anan Creek,1931,19563,,195,200270
Anan Creek,1931,31906,,196,232176
Anan Creek,1931,24383,,197,256559
Anan Creek,1931,18467,,198,275026
Anan Creek,1931,13090,,199,288116
Anan Creek,1931,8136,,200,296252
Anan Creek,1931,9064,,201,305316
Anan Creek,1931,12013,,202,317329
Anan Creek,1931,10646,,203,327975
Anan Creek,1931,5717,,204,333692
Anan Creek,1931,9494,,205,343186
Anan Creek,1931,8114,,206,351300
Anan Creek,1931,22522,,207,373822
Anan Creek,1931,20027,,208,393849
Anan Creek,1931,18754,,209,412603
Anan Creek,1931,16737,,210,429340
Anan Creek,1931,15809,,211,445149
Anan Creek,1931,13626,,212,458775
Anan Creek,1931,12503,,213,471278
Anan Creek,1931,10483,,214,481761
Anan Creek,1931,9817,,215,491578
Anan Creek,1931,9446,,216,501024
Anan Creek,1931,6992,,217,508016
Anan Creek,1931,7793,,218,515809
Anan Creek,1931,7363,,219,523172
Anan Creek,1931,7320,,220,530492
Anan Creek,1931,8157,,221,538649
Anan Creek,1931,8153,,222,546802
Anan Creek,1931,8153,,223,554955
Anan Creek,1931,8153,,224,563108
Anan Creek,1931,8153,,225,571261
Anan Creek,1931,8153,,226,579414
Anan Creek,1931,8153,,227,587567
Anan Creek,1931,7244,,228,594811
Anan Creek,1931,5034,,229,599845
Anan Creek,1931,3046,,230,602891
Anan Creek,1931,1327,,231,604218
Anan Creek,1931,1847,,232,606065
Anan Creek,1931,1148,,233,607213
Anan Creek,1931,1516,,234,608729
Anan Creek,1931,895,,235,609624
Anan Creek,1931,169,,236,609793
Anan Creek,1931,672,,237,610465
Anan Creek,1931,791,,238,611256
Anan Creek,1931,413,,239,611669
Anan Creek,1931,132,,240,611801
Anan Creek,1931,486,,241,612287
Anan Creek,1931,742,,242,613029
Anan Creek,1931,575,,243,613604
Anan Creek,1932,10,,186,10
Anan Creek,1932,45,,187,55
Anan Creek,1932,1033,,188,1088
Anan Creek,1932,1628,,189,2716
Anan Creek,1932,2647,,191,5363
Anan Creek,1932,1884,,192,7247
Anan Creek,1932,2197,,193,9444
Anan Creek,1932,1880,,194,11324
Anan Creek,1932,1061,,195,12385
Anan Creek,1932,2449,,196,14834
Anan Creek,1932,2017,,197,16851
Anan Creek,1932,5607,,198,22458
Anan Creek,1932,4857,,199,27315
Anan Creek,1932,3193,,200,30508
Anan Creek,1932,1328,,201,31836
Anan Creek,1932,818,,202,32654
Anan Creek,1932,431,,203,33085
Anan Creek,1932,147,,204,33232
Anan Creek,1932,1286,,205,34518
Anan Creek,1932,2915,,206,37433
Anan Creek,1932,5067,,207,42500
Anan Creek,1932,3628,,208,46128
Anan Creek,1932,4394,,209,50522
Anan Creek,1932,2047,,210,52569
Anan Creek,1932,1630,,211,54199
Anan Creek,1932,702,,212,54901
Anan Creek,1932,785,,213,55686
Anan Creek,1932,792,,214,56478
Anan Creek,1932,2000,,215,58478
Anan Creek,1932,2262,,216,60740
Anan Creek,1932,2264,,217,63004
Anan Creek,1932,4281,,218,67285
Anan Creek,1932,5309,,219,72594
Anan Creek,1932,7170,,220,79764
Anan Creek,1932,8291,,221,88055
Anan Creek,1932,7510,,222,95565
Anan Creek,1932,5077,,223,100642
Anan Creek,1932,5889,,225,106531
Anan Creek,1932,5212,,226,111743
Anan Creek,1932,2346,,227,114089
Anan Creek,1932,1982,,228,116071
Anan Creek,1932,2565,,229,118636
Anan Creek,1932,2428,,230,121064
Anan Creek,1932,1223,,231,122287
Anan Creek,1932,979,,232,123266
Anan Creek,1932,691,,233,123957
Anan Creek,1932,295,,234,124252
Anan Creek,1932,310,,235,124562
Anan Creek,1932,392,,236,124954
Anan Creek,1932,148,,237,125102
Anan Creek,1932,414,,238,125516
Anan Creek,1932,39,,239,125555
Anan Creek,1932,831,,240,126386
Anan Creek,1932,163,,241,126549
Anan Creek,1932,100,,242,126649
Anan Creek,1932,55,,243,126704
Anan Creek,1932,33,,245,126737
Anan Creek,1932,15,,247,126752
Anan Creek,1932,55,,248,126807
Anan Creek,1932,27,,249,126834
Anan Creek,1932,18,,250,126852
Chilkoot Lake,1976,500,,238,500
Chilkoot Lake,1976,500,,239,1000
Chilkoot Lake,1976,250,,240,1250
Chilkoot Lake,1977,4,,158,4
Chilkoot Lake,1977,7,,178,11
Chilkoot Lake,1977,53,,179,64
Chilkoot Lake,1977,36,,180,100
Chilkoot Lake,1977,17,,181,117
Chilkoot Lake,1977,7,,182,124
Chilkoot Lake,1977,15,,183,139
Chilkoot Lake,1977,18,,184,157
Chilkoot Lake,1977,28,,185,185
Chilkoot Lake,1977,43,,186,228
Chilkoot Lake,1977,14,,187,242
Chilkoot Lake,1977,19,,189,261
Chilkoot Lake,1977,17,,192,278
Chilkoot Lake,1977,2,,193,280
Chilkoot Lake,1977,1,,196,281
Chilkoot Lake,1977,8,,200,289
Chilkoot Lake,1977,9,,201,298
Chilkoot Lake,1977,4,,202,302
Chilkoot Lake,1977,14,,203,316
Chilkoot Lake,1977,6,,204,322
Chilkoot Lake,1977,20,,205,342
Chilkoot Lake,1977,9,,206,351
Chilkoot Lake,1977,18,,207,369
Chilkoot Lake,1977,22,,209,391
Chilkoot Lake,1977,39,,210,430
Chilkoot Lake,1977,27,,211,457
Chilkoot Lake,1977,25,,212,482
Chilkoot Lake,1977,19,,213,501
Chilkoot Lake,1977,12,,214,513
Chilkoot Lake,1977,13,,215,526
Chilkoot Lake,1977,25,,216,551
Chilkoot Lake,1977,35,,217,586
Chilkoot Lake,1977,47,,218,633
Chilkoot Lake,1977,108,,219,741
Chilkoot Lake,1977,89,,220,830
Chilkoot Lake,1977,74,,221,904
Chilkoot Lake,1977,464,,222,1368
Chilkoot Lake,1977,426,,223,1794
Chilkoot Lake,1977,322,,224,2116
Chilkoot Lake,1977,643,,225,2759
Chilkoot Lake,1977,564,,226,3323
Chilkoot Lake,1977,287,,227,3610
Chilkoot Lake,1977,438,,228,4048
Chilkoot Lake,1977,277,,229,4325
Chilkoot Lake,1977,108,,230,4433
Chilkoot Lake,1977,76,,231,4509
Chilkoot Lake,1977,32,,232,4541
Chilkoot Lake,1977,53,,233,4594
Chilkoot Lake,1977,30,,234,4624
Chilkoot Lake,1977,163,,235,4787
Chilkoot Lake,1977,131,,236,4918
Chilkoot Lake,1977,16,,237,4934
Chilkoot Lake,1977,25,,238,4959
Chilkoot Lake,1977,2,,239,4961
Chilkoot Lake,1977,42,,243,5003
Chilkoot Lake,1977,46,,244,5049
Chilkoot Lake,1977,52,,245,5101
Chilkoot Lake,1977,12,,246,5113
Chilkoot Lake,1977,12,,247,5125
Chilkoot Lake,1977,43,,248,5168
Chilkoot Lake,1977,38,,249,5206
Chilkoot Lake,1977,25,,250,5231
Chilkoot Lake,1977,14,,251,5245
Chilkoot Lake,1977,19,,252,5264
Chilkoot Lake,1977,6,,253,5270
Chilkoot Lake,1978,39,,254,39
Chilkoot Lake,1978,12,,262,51
Chilkoot Lake,1978,18,,263,69
Chilkoot Lake,1978,8,,265,77
Chilkoot Lake,1978,6,,266,83
Chilkoot Lake,1978,5,,267,88
Chilkoot Lake,1978,10,,268,98
Chilkoot Lake,1978,5,,269,103
Chilkoot Lake,1978,4,,270,107
Chilkoot Lake,1978,3,,271,110
Chilkoot Lake,1978,1,,275,111
Chilkoot Lake,1978,1,,276,112
Chilkoot Lake,1980,1,,214,1
Chilkoot Lake,1980,2,,215,3
Chilkoot Lake,1980,42,,217,45
Chilkoot Lake,1980,107,,218,152
Chilkoot Lake,1980,178,,219,330
Chilkoot Lake,1980,415,,220,745
Chilkoot Lake,1980,68,,221,813
Chilkoot Lake,1980,95,,222,908
Chilkoot Lake,1980,111,,223,1019
Chilkoot Lake,1980,102,,224,1121
Chilkoot Lake,1980,33,,225,1154
Chilkoot Lake,1980,43,,226,1197
Chilkoot Lake,1980,29,,227,1226
Chilkoot Lake,1980,22,,228,1248
Chilkoot Lake,1980,36,,229,1284
Chilkoot Lake,1980,26,,230,1310
Chilkoot Lake,1980,51,,231,1361
Chilkoot Lake,1980,19,,232,1380
Chilkoot Lake,1980,32,,233,1412
Chilkoot Lake,1980,65,,234,1477
Chilkoot Lake,1980,113,,235,1590
Chilkoot Lake,1980,206,,236,1796
Chilkoot Lake,1980,436,,237,2232
Chilkoot Lake,1980,698,,238,2930
Chilkoot Lake,1980,213,,239,3143
Chilkoot Lake,1980,61,,240,3204
Chilkoot Lake,1980,88,,241,3292
Chilkoot Lake,1980,117,,242,3409
Chilkoot Lake,1980,53,,243,3462
Chilkoot Lake,1980,118,,244,3580
Chilkoot Lake,1980,35,,245,3615
Chilkoot Lake,1980,13,,246,3628
Chilkoot Lake,1980,51,,247,3679
Chilkoot Lake,1980,151,,248,3830
Chilkoot Lake,1980,84,,249,3914
Chilkoot Lake,1980,163,,250,4077
Chilkoot Lake,1980,70,,251,4147
Chilkoot Lake,1980,103,,252,4250
Chilkoot Lake,1980,67,,253,4317
Chilkoot Lake,1980,45,,254,4362
Chilkoot Lake,1980,76,,255,4438
Chilkoot Lake,1980,42,,256,4480
Chilkoot Lake,1980,45,,257,4525
Chilkoot Lake,1980,40,,258,4565
Chilkoot Lake,1980,19,,259,4584
Chilkoot Lake,1980,10,,260,4594
Chilkoot Lake,1980,24,,261,4618
Chilkoot Lake,1980,9,,263,4627
Chilkoot Lake,1980,5,,264,4632
Chilkoot Lake,1980,4,,265,4636
Chilkoot Lake,1980,7,,266,4643
Chilkoot Lake,1980,3,,267,4646
Chilkoot Lake,1980,7,,268,4653
Chilkoot Lake,1980,5,,269,4658
Chilkoot Lake,1980,17,,270,4675
Chilkoot Lake,1980,3,,271,4678
Chilkoot Lake,1980,3,,272,4681
Chilkoot Lake,1980,2,,274,4683
Chilkoot Lake,1981,14,,194,14
Chilkoot Lake,1981,3,,196,17
Chilkoot Lake,1981,2,,197,19
Chilkoot Lake,1981,16,,198,35
Chilkoot Lake,1981,16,,199,51
Chilkoot Lake,1981,10,,200,61
Chilkoot Lake,1981,7,,201,68
Chilkoot Lake,1981,111,,202,179
Chilkoot Lake,1981,11,,203,190
Chilkoot Lake,1981,12,,204,202
Chilkoot Lake,1981,164,,205,366
Chilkoot Lake,1981,94,,206,460
Chilkoot Lake,1981,335,,207,795
Chilkoot Lake,1981,81,,208,876
Chilkoot Lake,1981,395,,210,1271
Chilkoot Lake,1981,784,,211,2055
Chilkoot Lake,1981,733,,212,2788
Chilkoot Lake,1981,364,,213,3152
Chilkoot Lake,1981,92,,215,3244
Chilkoot Lake,1981,1863,,216,5107
Chilkoot Lake,1981,231,,217,5338
Chilkoot Lake,1981,42,,218,5380
Chilkoot Lake,1981,109,,219,5489
Chilkoot Lake,1981,428,,220,5917
Chilkoot Lake,1981,612,,221,6529
Chilkoot Lake,1981,1077,,222,7606
Chilkoot Lake,1981,1481,,223,9087
Chilkoot Lake,1981,2537,,224,11624
Chilkoot Lake,1981,1017,,225,12641
Chilkoot Lake,1981,1521,,226,14162
Chilkoot Lake,1981,465,,227,14627
Chilkoot Lake,1981,234,,228,14861
Chilkoot Lake,1981,410,,229,15271
Chilkoot Lake,1981,577,,230,15848
Chilkoot Lake,1981,3359,,231,19207
Chilkoot Lake,1981,234,,235,19441
Chilkoot Lake,1981,1165,,236,20606
Chilkoot Lake,1981,945,,237,21551
Chilkoot Lake,1981,1069,,238,22620
Chilkoot Lake,1981,1782,,239,24402
Chilkoot Lake,1981,1306,,240,25708
Chilkoot Lake,1981,1064,,241,26772
Chilkoot Lake,1981,602,,242,27374
Chilkoot Lake,1981,1604,,243,28978
Chilkoot Lake,1981,1120,,244,30098
Chilkoot Lake,1981,812,,245,30910
Chilkoot Lake,1981,1378,,246,32288
Chilkoot Lake,1981,1880,,247,34168
Chilkoot Lake,1981,374,,248,34542
Chilkoot Lake,1981,108,,249,34650
Chilkoot Lake,1981,5,,259,34655
Chilkoot Lake,1981,19,,260,34674
Chilkoot Lake,1981,10,,261,34684
Chilkoot Lake,1981,48,,268,34732
Chilkoot Lake,1981,32,,269,34764
Chilkoot Lake,1981,12,,270,34776
Chilkoot Lake,1981,25,,271,34801
Chilkoot Lake,1981,4,,272,34805
Chilkoot Lake,1981,10,,273,34815
Chilkoot Lake,1981,4,,274,34819
Chilkoot Lake,1981,2,,276,34821
Chilkoot Lake,1982,20,,179,20
Chilkoot Lake,1982,32,,180,52
Chilkoot Lake,1982,30,,181,82
Chilkoot Lake,1982,1,,207,83
Chilkoot Lake,1982,40,,213,123
Chilkoot Lake,1982,138,,214,261
Chilkoot Lake,1982,89,,215,350
Chilkoot Lake,1982,130,,216,480
Chilkoot Lake,1982,130,,217,610
Chilkoot Lake,1982,75,,218,685
Chilkoot Lake,1982,141,,219,826
Chilkoot Lake,1982,71,,220,897
Chilkoot Lake,1982,236,,221,1133
Chilkoot Lake,1982,278,,222,1411
Chilkoot Lake,1982,143,,223,1554
Chilkoot Lake,1982,200,,224,1754
Chilkoot Lake,1982,139,,225,1893
Chilkoot Lake,1982,82,,226,1975
Chilkoot Lake,1982,153,,227,2128
Chilkoot Lake,1982,115,,228,2243
Chilkoot Lake,1982,188,,229,2431
Chilkoot Lake,1982,280,,230,2711
Chilkoot Lake,1982,242,,231,2953
Chilkoot Lake,1982,71,,232,3024
Chilkoot Lake,1982,65,,233,3089
Chilkoot Lake,1982,74,,234,3163
Chilkoot Lake,1982,304,,235,3467
Chilkoot Lake,1982,406,,236,3873
Chilkoot Lake,1982,215,,237,4088
Chilkoot Lake,1982,167,,238,4255
Chilkoot Lake,1982,157,,239,4412
Chilkoot Lake,1982,54,,240,4466
Chilkoot Lake,1982,88,,241,4554
Chilkoot Lake,1982,43,,242,4597
Chilkoot Lake,1982,59,,243,4656
Chilkoot Lake,1982,70,,244,4726
Chilkoot Lake,1982,81,,245,4807
Chilkoot Lake,1982,234,,246,5041
Chilkoot Lake,1982,207,,247,5248
Chilkoot Lake,1982,259,,248,5507
Chilkoot Lake,1982,173,,249,5680
Chilkoot Lake,1982,15,,250,5695
Chilkoot Lake,1982,20,,251,5715
Chilkoot Lake,1982,78,,252,5793
Chilkoot Lake,1982,97,,253,5890
Chilkoot Lake,1982,80,,254,5970
Chilkoot Lake,1982,367,,255,6337
Chilkoot Lake,1982,208,,256,6545
Chilkoot Lake,1982,120,,257,6665
Chilkoot Lake,1983,6,,187,6
Chilkoot Lake,1983,41,,188,47
Chilkoot Lake,1983,11,,189,58
Chilkoot Lake,1983,17,,190,75
Chilkoot Lake,1983,12,,191,87
Chilkoot Lake,1983,11,,192,98
Chilkoot Lake,1983,32,,193,130
Chilkoot Lake,1983,36,,194,166
Chilkoot Lake,1983,44,,195,210
Chilkoot Lake,1983,28,,196,238
Chilkoot Lake,1983,50,,197,288
Chilkoot Lake,1983,168,,198,456
Chilkoot Lake,1983,107,,199,563
Chilkoot Lake,1983,138,,200,701
Chilkoot Lake,1983,103,,201,804
Chilkoot Lake,1983,47,,202,851
Chilkoot Lake,1983,43,,203,894
Chilkoot Lake,1983,40,,204,934
Chilkoot Lake,1983,33,,205,967
Chilkoot Lake,1983,35,,206,1002
Chilkoot Lake,1983,441,,207,1443
Chilkoot Lake,1983,454,,208,1897
Chilkoot Lake,1983,170,,209,2067
Chilkoot Lake,1983,181,,210,2248
Chilkoot Lake,1983,237,,211,2485
Chilkoot Lake,1983,235,,212,2720
Chilkoot Lake,1983,102,,213,2822
Chilkoot Lake,1983,248,,214,3070
Chilkoot Lake,1983,267,,215,3337
Chilkoot Lake,1983,252,,216,3589
Chilkoot Lake,1983,227,,217,3816
Chilkoot Lake,1983,240,,218,4056
Chilkoot Lake,1983,223,,219,4279
Chilkoot Lake,1983,664,,220,4943
Chilkoot Lake,1983,1790,,221,6733
Chilkoot Lake,1983,615,,222,7348
Chilkoot Lake,1983,173,,223,7521
Chilkoot Lake,1983,81,,224,7602
Chilkoot Lake,1983,142,,225,7744
Chilkoot Lake,1983,58,,226,7802
Chilkoot Lake,1983,80,,227,7882
Chilkoot Lake,1983,88,,228,7970
Chilkoot Lake,1983,116,,229,8086
Chilkoot Lake,1983,101,,230,8187
Chilkoot Lake,1983,111,,231,8298
Chilkoot Lake,1983,63,,232,8361
Chilkoot Lake,1983,127,,233,8488
Chilkoot Lake,1983,436,,234,8924
Chilkoot Lake,1983,62,,235,8986
Chilkoot Lake,1983,74,,236,9060
Chilkoot Lake,1983,52,,237,9112
Chilkoot Lake,1983,23,,238,9135
Chilkoot Lake,1983,34,,239,9169
Chilkoot Lake,1983,37,,240,9206
Chilkoot Lake,1983,66,,241,9272
Chilkoot Lake,1983,211,,242,9483
Chilkoot Lake,1983,243,,243,9726
Chilkoot Lake,1983,218,,244,9944
Chilkoot Lake,1983,28,,245,9972
Chilkoot Lake,1983,28,,246,10000
Chilkoot Lake,1983,54,,247,10054
Chilkoot Lake,1983,82,,248,10136
Chilkoot Lake,1983,56,,249,10192
Chilkoot Lake,1983,138,,250,10330
Chilkoot Lake,1983,120,,251,10450
Chilkoot Lake,1983,91,,252,10541
Chilkoot Lake,1983,196,,253,10737
Chilkoot Lake,1983,34,,254,10771
Chilkoot Lake,1983,75,,255,10846
Chilkoot Lake,1983,89,,256,10935
Chilkoot Lake,1983,41,,257,10976
Chilkoot Lake,1983,29,,258,11005
Chilkoot Lake,1983,65,,259,11070
Chilkoot Lake,1983,40,,260,11110
Chilkoot Lake,1983,35,,261,11145
Chilkoot Lake,1983,33,,262,11178
Chilkoot Lake,1983,17,,263,11195
Chilkoot Lake,1983,11,,264,11206
Chilkoot Lake,1983,10,,265,11216
Chilkoot Lake,1983,5,,266,11221
Chilkoot Lake,1983,6,,271,11227
Chilkoot Lake,1983,5,,272,11232
Chilkoot Lake,1983,3,,273,11235
Chilkoot Lake,1983,2,,274,11237
Chilkoot Lake,1984,17,,190,17
Chilkoot Lake,1984,14,,191,31
Chilkoot Lake,1984,30,,192,61
Chilkoot Lake,1984,17,,193,78
Chilkoot Lake,1984,11,,194,89
Chilkoot Lake,1984,12,,195,101
Chilkoot Lake,1984,5,,196,106
Chilkoot Lake,1984,11,,197,117
Chilkoot Lake,1984,10,,198,127
Chilkoot Lake,1984,16,,199,143
Chilkoot Lake,1984,3,,200,146
Chilkoot Lake,1984,25,,202,171
Chilkoot Lake,1984,24,,203,195
Chilkoot Lake,1984,26,,204,221
Chilkoot Lake,1984,7,,205,228
Chilkoot Lake,1984,12,,206,240
Chilkoot Lake,1984,57,,207,297
Chilkoot Lake,1984,20,,208,317
Chilkoot Lake,1984,25,,209,342
Chilkoot Lake,1984,22,,210,364
Chilkoot Lake,1984,27,,211,391
Chilkoot Lake,1984,25,,212,416
Chilkoot Lake,1984,10,,213,426
Chilkoot Lake,1984,33,,214,459
Chilkoot Lake,1984,58,,215,517
Chilkoot Lake,1984,60,,216,577
Chilkoot Lake,1984,31,,217,608
Chilkoot Lake,1984,76,,218,684
Chilkoot Lake,1984,142,,219,826
Chilkoot Lake,1984,59,,220,885
Chilkoot Lake,1984,85,,221,970
Chilkoot Lake,1984,38,,222,1008
Chilkoot Lake,1984,21,,223,1029
Chilkoot Lake,1984,13,,224,1042
Chilkoot Lake,1984,48,,225,1090
Chilkoot Lake,1984,66,,226,1156
Chilkoot Lake,1984,101,,227,1257
Chilkoot Lake,1984,102,,228,1359
Chilkoot Lake,1984,109,,229,1468
Chilkoot Lake,1984,85,,230,1553
Chilkoot Lake,1984,194,,231,1747
Chilkoot Lake,1984,131,,232,1878
Chilkoot Lake,1984,51,,233,1929
Chilkoot Lake,1984,57,,234,1986
Chilkoot Lake,1984,55,,235,2041
Chilkoot Lake,1984,29,,236,2070
Chilkoot Lake,1984,129,,237,2199
Chilkoot Lake,1984,114,,238,2313
Chilkoot Lake,1984,42,,239,2355
Chilkoot Lake,1984,43,,240,2398
Chilkoot Lake,1984,140,,241,2538
Chilkoot Lake,1984,170,,242,2708
Chilkoot Lake,1984,100,,243,2808
Chilkoot Lake,1984,118,,244,2926
Chilkoot Lake,1984,97,,245,3023
Chilkoot Lake,1984,275,,246,3298
Chilkoot Lake,1984,176,,247,3474
Chilkoot Lake,1984,180,,248,3654
Chilkoot Lake,1984,147,,249,3801
Chilkoot Lake,1984,73,,250,3874
Chilkoot Lake,1984,56,,251,3930
Chilkoot Lake,1984,247,,252,4177
Chilkoot Lake,1984,327,,253,4504
Chilkoot Lake,1984,242,,254,4746
Chilkoot Lake,1984,166,,255,4912
Chilkoot Lake,1984,98,,256,5010
Chilkoot Lake,1984,24,,257,5034
Chilkoot Lake,1985,5,,185,5
Chilkoot Lake,1985,18,,186,23
Chilkoot Lake,1985,3,,187,26
Chilkoot Lake,1985,2,,188,28
Chilkoot Lake,1985,4,,190,32
Chilkoot Lake,1985,4,,191,36
Chilkoot Lake,1985,17,,192,53
Chilkoot Lake,1985,4,,193,57
Chilkoot Lake,1985,1,,194,58
Chilkoot Lake,1985,2,,195,60
Chilkoot Lake,1985,1,,196,61
Chilkoot Lake,1985,19,,197,80
Chilkoot Lake,1985,15,,198,95
Chilkoot Lake,1985,23,,199,118
Chilkoot Lake,1985,17,,200,135
Chilkoot Lake,1985,14,,201,149
Chilkoot Lake,1985,19,,202,168
Chilkoot Lake,1985,34,,203,202
Chilkoot Lake,1985,46,,204,248
Chilkoot Lake,1985,28,,205,276
Chilkoot Lake,1985,25,,206,301
Chilkoot Lake,1985,75,,207,376
Chilkoot Lake,1985,40,,208,416
Chilkoot Lake,1985,47,,209,463
Chilkoot Lake,1985,92,,210,555
Chilkoot Lake,1985,127,,211,682
Chilkoot Lake,1985,198,,212,880
Chilkoot Lake,1985,199,,213,1079
Chilkoot Lake,1985,110,,214,1189
Chilkoot Lake,1985,111,,215,1300
Chilkoot Lake,1985,47,,216,1347
Chilkoot Lake,1985,58,,217,1405
Chilkoot Lake,1985,106,,218,1511
Chilkoot Lake,1985,134,,219,1645
Chilkoot Lake,1985,80,,220,1725
Chilkoot Lake,1985,129,,221,1854
Chilkoot Lake,1985,67,,222,1921
Chilkoot Lake,1985,138,,223,2059
Chilkoot Lake,1985,137,,224,2196
Chilkoot Lake,1985,217,,225,2413
Chilkoot Lake,1985,210,,226,2623
Chilkoot Lake,1985,108,,227,2731
Chilkoot Lake,1985,125,,228,2856
Chilkoot Lake,1985,80,,229,2936
Chilkoot Lake,1985,61,,230,2997
Chilkoot Lake,1985,1249,,231,4246
Chilkoot Lake,1985,402,,232,4648
Chilkoot Lake,1985,228,,233,4876
Chilkoot Lake,1985,194,,234,5070
Chilkoot Lake,1985,111,,235,5181
Chilkoot Lake,1985,163,,236,5344
Chilkoot Lake,1985,178,,237,5522
Chilkoot Lake,1985,652,,238,6174
Chilkoot Lake,1985,580,,239,6754
Chilkoot Lake,1985,1590,,240,8344
Chilkoot Lake,1985,1396,,241,9740
Chilkoot Lake,1985,1845,,242,11585
Chilkoot Lake,1985,1174,,243,12759
Chilkoot Lake,1985,1500,,244,14259
Chilkoot Lake,1985,1743,,245,16002
Chilkoot Lake,1985,1510,,246,17512
Chilkoot Lake,1985,1336,,247,18848
Chilkoot Lake,1985,1103,,248,19951
Chilkoot Lake,1985,1083,,249,21034
Chilkoot Lake,1985,1702,,250,22736
Chilkoot Lake,1985,2068,,251,24804
Chilkoot Lake,1985,2281,,252,27085
Chilkoot Lake,1985,1407,,253,28492
Chilkoot Lake,1985,1212,,254,29704
Chilkoot Lake,1985,887,,255,30591
Chilkoot Lake,1985,507,,256,31098
Chilkoot Lake,1985,370,,257,31468
Chilkoot Lake,1985,598,,258,32066
Chilkoot Lake,1985,310,,259,32376
Chilkoot Lake,1985,353,,260,32729
Chilkoot Lake,1985,220,,261,32949
Chilkoot Lake,1985,163,,262,33112
Chilkoot Lake,1985,120,,263,33232
Chilkoot Lake,1985,140,,264,33372
Chilkoot Lake,1985,56,,265,33428
Chilkoot Lake,1985,31,,266,33459
Chilkoot Lake,1985,17,,267,33476
Chilkoot Lake,1985,20,,268,33496
Chilkoot Lake,1985,19,,269,33515
Chilkoot Lake,1985,13,,270,33528
Chilkoot Lake,1985,22,,271,33550
Chilkoot Lake,1985,14,,272,33564
Chilkoot Lake,1985,20,,273,33584
Chilkoot Lake,1985,10,,274,33594
Chilkoot Lake,1985,9,,275,33603
Chilkoot Lake,1985,2,,276,33605
Chilkoot Lake,1985,3,,278,33608
Chilkoot Lake,1986,17,,180,17
Chilkoot Lake,1986,6,,188,23
Chilkoot Lake,1986,11,,189,34
Chilkoot Lake,1986,8,,190,42
Chilkoot Lake,1986,9,,191,51
Chilkoot Lake,1986,3,,192,54
Chilkoot Lake,1986,4,,193,58
Chilkoot Lake,1986,3,,194,61
Chilkoot Lake,1986,6,,195,67
Chilkoot Lake,1986,2,,196,69
Chilkoot Lake,1986,7,,197,76
Chilkoot Lake,1986,3,,199,79
Chilkoot Lake,1986,4,,200,83
Chilkoot Lake,1986,1,,201,84
Chilkoot Lake,1986,12,,202,96
Chilkoot Lake,1986,12,,203,108
Chilkoot Lake,1986,9,,204,117
Chilkoot Lake,1986,30,,205,147
Chilkoot Lake,1986,10,,206,157
Chilkoot Lake,1986,8,,207,165
Chilkoot Lake,1986,5,,208,170
Chilkoot Lake,1986,13,,209,183
Chilkoot Lake,1986,26,,210,209
Chilkoot Lake,1986,38,,211,247
Chilkoot Lake,1986,37,,212,284
Chilkoot Lake,1986,29,,213,313
Chilkoot Lake,1986,23,,214,336
Chilkoot Lake,1986,21,,215,357
Chilkoot Lake,1986,17,,216,374
Chilkoot Lake,1986,29,,217,403
Chilkoot Lake,1986,38,,218,441
Chilkoot Lake,1986,35,,219,476
Chilkoot Lake,1986,32,,220,508
Chilkoot Lake,1986,27,,221,535
Chilkoot Lake,1986,12,,222,547
Chilkoot Lake,1986,27,,223,574
Chilkoot Lake,1986,10,,224,584
Chilkoot Lake,1986,6,,225,590
Chilkoot Lake,1986,8,,226,598
Chilkoot Lake,1986,2,,228,600
Chilkoot Lake,1986,26,,230,626
Chilkoot Lake,1986,13,,231,639
Chilkoot Lake,1986,8,,232,647
Chilkoot Lake,1986,3,,233,650
Chilkoot Lake,1986,4,,234,654
Chilkoot Lake,1986,41,,235,695
Chilkoot Lake,1986,7,,236,702
Chilkoot Lake,1986,22,,237,724
Chilkoot Lake,1986,9,,238,733
Chilkoot Lake,1986,3,,239,736
Chilkoot Lake,1986,4,,240,740
Chilkoot Lake,1986,10,,241,750
Chilkoot Lake,1986,6,,242,756
Chilkoot Lake,1986,7,,243,763
Chilkoot Lake,1986,11,,244,774
Chilkoot Lake,1986,21,,245,795
Chilkoot Lake,1986,37,,246,832
Chilkoot Lake,1986,29,,247,861
Chilkoot Lake,1986,14,,248,875
Chilkoot Lake,1986,21,,249,896
Chilkoot Lake,1986,46,,250,942
Chilkoot Lake,1986,23,,251,965
Chilkoot Lake,1986,19,,252,984
Chilkoot Lake,1986,19,,253,1003
Chilkoot Lake,1986,23,,254,1026
Chilkoot Lake,1986,42,,255,1068
Chilkoot Lake,1986,24,,256,1092
Chilkoot Lake,1986,16,,257,1108
Chilkoot Lake,1986,17,,258,1125
Chilkoot Lake,1986,18,,259,1143
Chilkoot Lake,1986,9,,260,1152
Chilkoot Lake,1986,13,,261,1165
Chilkoot Lake,1986,10,,262,1175
Chilkoot Lake,1986,12,,263,1187
Chilkoot Lake,1986,14,,264,1201
Chilkoot Lake,1986,6,,265,1207
Chilkoot Lake,1986,3,,266,1210
Chilkoot Lake,1986,2,,267,1212
Chilkoot Lake,1986,3,,269,1215
Chilkoot Lake,1986,3,,270,1218
Chilkoot Lake,1986,7,,271,1225
Chilkoot Lake,1986,1,,272,1226
Chilkoot Lake,1986,7,,273,1233
Chilkoot Lake,1986,10,,275,1243
Chilkoot Lake,1986,1,,276,1244
Chilkoot Lake,1986,3,,278,1247
Chilkoot Lake,1986,1,,281,1248
Chilkoot Lake,1986,1,,282,1249
Chilkoot Lake,1987,3,,190,3
Chilkoot Lake,1987,16,,194,19
Chilkoot Lake,1987,13,,195,32
Chilkoot Lake,1987,17,,196,49
Chilkoot Lake,1987,5,,197,54
Chilkoot Lake,1987,27,,198,81
Chilkoot Lake,1987,18,,199,99
Chilkoot Lake,1987,79,,200,178
Chilkoot Lake,1987,55,,201,233
Chilkoot Lake,1987,84,,202,317
Chilkoot Lake,1987,42,,203,359
Chilkoot Lake,1987,12,,204,371
Chilkoot Lake,1987,36,,205,407
Chilkoot Lake,1987,44,,206,451
Chilkoot Lake,1987,61,,207,512
Chilkoot Lake,1987,94,,208,606
Chilkoot Lake,1987,75,,209,681
Chilkoot Lake,1987,121,,210,802
Chilkoot Lake,1987,44,,211,846
Chilkoot Lake,1987,37,,212,883
Chilkoot Lake,1987,51,,213,934
Chilkoot Lake,1987,59,,214,993
Chilkoot Lake,1987,81,,215,1074
Chilkoot Lake,1987,89,,216,1163
Chilkoot Lake,1987,78,,217,1241
Chilkoot Lake,1987,51,,218,1292
Chilkoot Lake,1987,103,,219,1395
Chilkoot Lake,1987,139,,220,1534
Chilkoot Lake,1987,49,,221,1583
Chilkoot Lake,1987,34,,222,1617
Chilkoot Lake,1987,141,,223,1758
Chilkoot Lake,1987,277,,224,2035
Chilkoot Lake,1987,141,,225,2176
Chilkoot Lake,1987,83,,226,2259
Chilkoot Lake,1987,85,,227,2344
Chilkoot Lake,1987,106,,228,2450
Chilkoot Lake,1987,156,,229,2606
Chilkoot Lake,1987,212,,230,2818
Chilkoot Lake,1987,741,,231,3559
Chilkoot Lake,1987,405,,232,3964
Chilkoot Lake,1987,88,,233,4052
Chilkoot Lake,1987,454,,234,4506
Chilkoot Lake,1987,232,,235,4738
Chilkoot Lake,1987,218,,236,4956
Chilkoot Lake,1987,215,,237,5171
Chilkoot Lake,1987,96,,238,5267
Chilkoot Lake,1987,105,,239,5372
Chilkoot Lake,1987,148,,240,5520
Chilkoot Lake,1987,143,,241,5663
Chilkoot Lake,1987,86,,242,5749
Chilkoot Lake,1987,238,,243,5987
Chilkoot Lake,1987,173,,244,6160
Chilkoot Lake,1987,68,,245,6228
Chilkoot Lake,1987,93,,246,6321
Chilkoot Lake,1987,42,,247,6363
Chilkoot Lake,1987,49,,248,6412
Chilkoot Lake,1987,24,,249,6436
Chilkoot Lake,1987,25,,250,6461
Chilkoot Lake,1987,23,,251,6484
Chilkoot Lake,1987,25,,252,6509
Chilkoot Lake,1987,6,,255,6515
Chilkoot Lake,1987,29,,256,6544
Chilkoot Lake,1987,29,,257,6573
Chilkoot Lake,1987,29,,258,6602
Chilkoot Lake,1987,11,,259,6613
Chilkoot Lake,1987,24,,260,6637
Chilkoot Lake,1987,10,,261,6647
Chilkoot Lake,1987,8,,262,6655
Chilkoot Lake,1987,6,,263,6661
Chilkoot Lake,1987,7,,264,6668
Chilkoot Lake,1987,5,,265,6673
Chilkoot Lake,1987,7,,266,6680
Chilkoot Lake,1987,4,,267,6684
Chilkoot Lake,1987,2,,269,6686
Chilkoot Lake,1987,1,,272,6687
Chilkoot Lake,1987,2,,273,6689
Chilkoot Lake,1988,1,,185,1
Chilkoot Lake,1988,1,,187,2
Chilkoot Lake,1988,1,,188,3
Chilkoot Lake,1988,1,,191,4
Chilkoot Lake,1988,2,,192,6
Chilkoot Lake,1988,1,,193,7
Chilkoot Lake,1988,4,,194,11
Chilkoot Lake,1988,1,,195,12
Chilkoot Lake,1988,5,,197,17
Chilkoot Lake,1988,4,,198,21
Chilkoot Lake,1988,1,,199,22
Chilkoot Lake,1988,2,,200,24
Chilkoot Lake,1988,5,,201,29
Chilkoot Lake,1988,1,,202,30
Chilkoot Lake,1988,1,,203,31
Chilkoot Lake,1988,1,,204,32
Chilkoot Lake,1988,4,,205,36
Chilkoot Lake,1988,4,,206,40
Chilkoot Lake,1988,9,,207,49
Chilkoot Lake,1988,9,,208,58
Chilkoot Lake,1988,14,,209,72
Chilkoot Lake,1988,20,,210,92
Chilkoot Lake,1988,52,,211,144
Chilkoot Lake,1988,43,,212,187
Chilkoot Lake,1988,27,,213,214
Chilkoot Lake,1988,27,,214,241
Chilkoot Lake,1988,82,,215,323
Chilkoot Lake,1988,38,,216,361
Chilkoot Lake,1988,41,,217,402
Chilkoot Lake,1988,12,,218,414
Chilkoot Lake,1988,25,,219,439
Chilkoot Lake,1988,11,,220,450
Chilkoot Lake,1988,63,,221,513
Chilkoot Lake,1988,105,,222,618
Chilkoot Lake,1988,43,,223,661
Chilkoot Lake,1988,21,,224,682
Chilkoot Lake,1988,90,,225,772
Chilkoot Lake,1988,56,,226,828
Chilkoot Lake,1988,62,,227,890
Chilkoot Lake,1988,165,,228,1055
Chilkoot Lake,1988,125,,229,1180
Chilkoot Lake,1988,32,,230,1212
Chilkoot Lake,1988,57,,231,1269
Chilkoot Lake,1988,19,,232,1288
Chilkoot Lake,1988,50,,233,1338
Chilkoot Lake,1988,31,,234,1369
Chilkoot Lake,1988,21,,235,1390
Chilkoot Lake,1988,3,,236,1393
Chilkoot Lake,1988,59,,237,1452
Chilkoot Lake,1988,86,,238,1538
Chilkoot Lake,1988,83,,239,1621
Chilkoot Lake,1988,36,,240,1657
Chilkoot Lake,1988,67,,241,1724
Chilkoot Lake,1988,64,,242,1788
Chilkoot Lake,1988,75,,243,1863
Chilkoot Lake,1988,7,,244,1870
Chilkoot Lake,1988,82,,245,1952
Chilkoot Lake,1988,139,,246,2091
Chilkoot Lake,1988,130,,247,2221
Chilkoot Lake,1988,58,,248,2279
Chilkoot Lake,1988,92,,249,2371
Chilkoot Lake,1988,94,,250,2465
Chilkoot Lake,1988,87,,251,2552
Chilkoot Lake,1988,78,,252,2630
Chilkoot Lake,1988,18,,253,2648
Chilkoot Lake,1988,56,,254,2704
Chilkoot Lake,1988,33,,255,2737
Chilkoot Lake,1988,81,,256,2818
Chilkoot Lake,1988,51,,257,2869
Chilkoot Lake,1988,170,,258,3039
Chilkoot Lake,1988,201,,259,3240
Chilkoot Lake,1988,323,,260,3563
Chilkoot Lake,1988,252,,261,3815
Chilkoot Lake,1988,129,,262,3944
Chilkoot Lake,1988,178,,263,4122
Chilkoot Lake,1988,126,,264,4248
Chilkoot Lake,1988,215,,265,4463
Chilkoot Lake,1988,311,,266,4774
Chilkoot Lake,1988,120,,267,4894
Chilkoot Lake,1988,147,,268,5041
Chilkoot Lake,1988,57,,269,5098
Chilkoot Lake,1988,40,,270,5138
Chilkoot Lake,1988,41,,271,5179
Chilkoot Lake,1988,54,,272,5233
Chilkoot Lake,1988,10,,273,5243
Chilkoot Lake,1988,7,,274,5250
Chilkoot Lake,1988,6,,275,5256
Chilkoot Lake,1988,10,,276,5266
Chilkoot Lake,1988,7,,277,5273
Chilkoot Lake,1988,1,,285,5274
Chilkoot Lake,1989,2,,191,2
Chilkoot Lake,1989,4,,195,6
Chilkoot Lake,1989,4,,196,10
Chilkoot Lake,1989,5,,197,15
Chilkoot Lake,1989,2,,198,17
Chilkoot Lake,1989,6,,200,23
Chilkoot Lake,1989,8,,201,31
Chilkoot Lake,1989,5,,202,36
Chilkoot Lake,1989,1,,203,37
Chilkoot Lake,1989,5,,204,42
Chilkoot Lake,1989,12,,205,54
Chilkoot Lake,1989,27,,206,81
Chilkoot Lake,1989,9,,207,90
Chilkoot Lake,1989,11,,208,101
Chilkoot Lake,1989,4,,209,105
Chilkoot Lake,1989,7,,210,112
Chilkoot Lake,1989,2,,211,114
Chilkoot Lake,1989,38,,212,152
Chilkoot Lake,1989,76,,213,228
Chilkoot Lake,1989,3,,214,231
Chilkoot Lake,1989,2,,215,233
Chilkoot Lake,1989,3,,216,236
Chilkoot Lake,1989,3,,217,239
Chilkoot Lake,1989,1,,218,240
Chilkoot Lake,1989,3,,220,243
Chilkoot Lake,1989,19,,221,262
Chilkoot Lake,1989,86,,222,348
Chilkoot Lake,1989,89,,223,437
Chilkoot Lake,1989,51,,225,488
Chilkoot Lake,1989,36,,226,524
Chilkoot Lake,1989,41,,228,565
Chilkoot Lake,1989,28,,229,593
Chilkoot Lake,1989,93,,230,686
Chilkoot Lake,1989,14,,231,700
Chilkoot Lake,1989,54,,232,754
Chilkoot Lake,1989,193,,233,947
Chilkoot Lake,1989,86,,234,1033
Chilkoot Lake,1989,25,,235,1058
Chilkoot Lake,1989,22,,236,1080
Chilkoot Lake,1989,13,,237,1093
Chilkoot Lake,1989,47,,238,1140
Chilkoot Lake,1989,22,,239,1162
Chilkoot Lake,1989,76,,240,1238
Chilkoot Lake,1989,103,,241,1341
Chilkoot Lake,1989,63,,242,1404
Chilkoot Lake,1989,37,,243,1441
Chilkoot Lake,1989,55,,244,1496
Chilkoot Lake,1989,18,,245,1514
Chilkoot Lake,1989,36,,246,1550
Chilkoot Lake,1989,70,,247,1620
Chilkoot Lake,1989,40,,248,1660
Chilkoot Lake,1989,61,,249,1721
Chilkoot Lake,1989,42,,250,1763
Chilkoot Lake,1989,7,,252,1770
Chilkoot Lake,1989,11,,253,1781
Chilkoot Lake,1989,32,,254,1813
Chilkoot Lake,1989,24,,255,1837
Chilkoot Lake,1989,10,,256,1847
Chilkoot Lake,1989,13,,257,1860
Chilkoot Lake,1989,43,,258,1903
Chilkoot Lake,1989,38,,259,1941
Chilkoot Lake,1989,35,,260,1976
Chilkoot Lake,1989,32,,261,2008
Chilkoot Lake,1989,7,,262,2015
Chilkoot Lake,1989,30,,263,2045
Chilkoot Lake,1989,29,,264,2074
Chilkoot Lake,1989,7,,265,2081
Chilkoot Lake,1989,4,,266,2085
Chilkoot Lake,1989,5,,267,2090
Chilkoot Lake,1989,3,,269,2093
Chilkoot Lake,1989,2,,272,2095
Chilkoot Lake,1989,6,,273,2101
Chilkoot Lake,1989,6,,274,2107
Chilkoot Lake,1989,4,,275,2111
Chilkoot Lake,1989,2,,276,2113
Chilkoot Lake,1989,1,,279,2114
Chilkoot Lake,1989,2,,280,2116
Chilkoot Lake,1989,1,,281,2117
Chilkoot Lake,1989,1,,288,2118
Chilkoot Lake,1990,2,,178,2
Chilkoot Lake,1990,2,,179,4
Chilkoot Lake,1990,4,,180,8
Chilkoot Lake,1990,2,,181,10
Chilkoot Lake,1990,1,,183,11
Chilkoot Lake,1990,1,,184,12
Chilkoot Lake,1990,8,,185,20
Chilkoot Lake,1990,5,,186,25
Chilkoot Lake,1990,7,,187,32
Chilkoot Lake,1990,9,,188,41
Chilkoot Lake,1990,5,,189,46
Chilkoot Lake,1990,4,,190,50
Chilkoot Lake,1990,7,,191,57
Chilkoot Lake,1990,3,,192,60
Chilkoot Lake,1990,2,,193,62
Chilkoot Lake,1990,8,,194,70
Chilkoot Lake,1990,3,,195,73
Chilkoot Lake,1990,5,,196,78
Chilkoot Lake,1990,5,,197,83
Chilkoot Lake,1990,6,,198,89
Chilkoot Lake,1990,5,,199,94
Chilkoot Lake,1990,15,,200,109
Chilkoot Lake,1990,3,,201,112
Chilkoot Lake,1990,5,,202,117
Chilkoot Lake,1990,51,,203,168
Chilkoot Lake,1990,43,,204,211
Chilkoot Lake,1990,9,,205,220
Chilkoot Lake,1990,6,,206,226
Chilkoot Lake,1990,3,,207,229
Chilkoot Lake,1990,5,,208,234
Chilkoot Lake,1990,21,,209,255
Chilkoot Lake,1990,20,,210,275
Chilkoot Lake,1990,46,,211,321
Chilkoot Lake,1990,7,,212,328
Chilkoot Lake,1990,7,,213,335
Chilkoot Lake,1990,28,,214,363
Chilkoot Lake,1990,74,,215,437
Chilkoot Lake,1990,23,,216,460
Chilkoot Lake,1990,10,,217,470
Chilkoot Lake,1990,10,,218,480
Chilkoot Lake,1990,18,,219,498
Chilkoot Lake,1990,67,,220,565
Chilkoot Lake,1990,71,,221,636
Chilkoot Lake,1990,30,,222,666
Chilkoot Lake,1990,36,,223,702
Chilkoot Lake,1990,13,,224,715
Chilkoot Lake,1990,18,,225,733
Chilkoot Lake,1990,47,,226,780
Chilkoot Lake,1990,51,,227,831
Chilkoot Lake,1990,50,,228,881
Chilkoot Lake,1990,33,,229,914
Chilkoot Lake,1990,130,,230,1044
Chilkoot Lake,1990,79,,231,1123
Chilkoot Lake,1990,50,,232,1173
Chilkoot Lake,1990,30,,233,1203
Chilkoot Lake,1990,302,,234,1505
Chilkoot Lake,1990,945,,235,2450
Chilkoot Lake,1990,296,,236,2746
Chilkoot Lake,1990,260,,237,3006
Chilkoot Lake,1990,130,,238,3136
Chilkoot Lake,1990,383,,239,3519
Chilkoot Lake,1990,317,,240,3836
Chilkoot Lake,1990,274,,241,4110
Chilkoot Lake,1990,292,,242,4402
Chilkoot Lake,1990,174,,243,4576
Chilkoot Lake,1990,224,,244,4800
Chilkoot Lake,1990,471,,245,5271
Chilkoot Lake,1990,448,,246,5719
Chilkoot Lake,1990,520,,247,6239
Chilkoot Lake,1990,493,,248,6732
Chilkoot Lake,1990,570,,249,7302
Chilkoot Lake,1990,780,,250,8082
Chilkoot Lake,1990,229,,251,8311
Chilkoot Lake,1990,246,,252,8557
Chilkoot Lake,1990,237,,253,8794
Chilkoot Lake,1990,389,,254,9183
Chilkoot Lake,1990,337,,255,9520
Chilkoot Lake,1990,187,,256,9707
Chilkoot Lake,1990,156,,257,9863
Chilkoot Lake,1990,87,,258,9950
Chilkoot Lake,1990,38,,259,9988
Chilkoot Lake,1990,50,,260,10038
Chilkoot Lake,1990,90,,261,10128
Chilkoot Lake,1990,42,,262,10170
Chilkoot Lake,1990,97,,263,10267
Chilkoot Lake,1990,24,,264,10291
Chilkoot Lake,1990,4,,270,10295
Chilkoot Lake,1990,6,,271,10301
Chilkoot Lake,1990,4,,272,10305
Chilkoot Lake,1990,3,,273,10308
Chilkoot Lake,1990,6,,274,10314
Chilkoot Lake,1990,9,,275,10323
Chilkoot Lake,1990,6,,276,10329
Chilkoot Lake,1990,12,,277,10341
Chilkoot Lake,1990,8,,278,10349
Chilkoot Lake,1990,30,,279,10379
Chilkoot Lake,1990,9,,280,10388
Chilkoot Lake,1990,4,,281,10392
Chilkoot Lake,1990,1,,282,10393
Chilkoot Lake,1990,1,,283,10394
Chilkoot Lake,1990,3,,284,10397
Chilkoot Lake,1990,1,,286,10398
Chilkoot Lake,1991,2,,191,2
Chilkoot Lake,1991,8,,192,10
Chilkoot Lake,1991,2,,193,12
Chilkoot Lake,1991,2,,194,14
Chilkoot Lake,1991,14,,195,28
Chilkoot Lake,1991,4,,196,32
Chilkoot Lake,1991,5,,197,37
Chilkoot Lake,1991,7,,198,44
Chilkoot Lake,1991,8,,199,52
Chilkoot Lake,1991,1,,200,53
Chilkoot Lake,1991,9,,201,62
Chilkoot Lake,1991,12,,202,74
Chilkoot Lake,1991,22,,203,96
Chilkoot Lake,1991,30,,204,126
Chilkoot Lake,1991,120,,205,246
Chilkoot Lake,1991,117,,206,363
Chilkoot Lake,1991,174,,207,537
Chilkoot Lake,1991,51,,208,588
Chilkoot Lake,1991,36,,209,624
Chilkoot Lake,1991,80,,210,704
Chilkoot Lake,1991,61,,211,765
Chilkoot Lake,1991,92,,212,857
Chilkoot Lake,1991,10,,213,867
Chilkoot Lake,1991,26,,214,893
Chilkoot Lake,1991,16,,215,909
Chilkoot Lake,1991,39,,217,948
Chilkoot Lake,1991,14,,218,962
Chilkoot Lake,1991,23,,219,985
Chilkoot Lake,1991,23,,220,1008
Chilkoot Lake,1991,42,,221,1050
Chilkoot Lake,1991,68,,222,1118
Chilkoot Lake,1991,33,,223,1151
Chilkoot Lake,1991,40,,224,1191
Chilkoot Lake,1991,260,,225,1451
Chilkoot Lake,1991,31,,226,1482
Chilkoot Lake,1991,15,,227,1497
Chilkoot Lake,1991,31,,228,1528
Chilkoot Lake,1991,21,,229,1549
Chilkoot Lake,1991,56,,230,1605
Chilkoot Lake,1991,21,,231,1626
Chilkoot Lake,1991,5,,232,1631
Chilkoot Lake,1991,7,,233,1638
Chilkoot Lake,1991,22,,234,1660
Chilkoot Lake,1991,24,,235,1684
Chilkoot Lake,1991,61,,236,1745
Chilkoot Lake,1991,46,,237,1791
Chilkoot Lake,1991,11,,238,1802
Chilkoot Lake,1991,9,,239,1811
Chilkoot Lake,1991,52,,240,1863
Chilkoot Lake,1991,62,,241,1925
Chilkoot Lake,1991,49,,242,1974
Chilkoot Lake,1991,38,,243,2012
Chilkoot Lake,1991,67,,244,2079
Chilkoot Lake,1991,31,,245,2110
Chilkoot Lake,1991,71,,246,2181
Chilkoot Lake,1991,56,,247,2237
Chilkoot Lake,1991,48,,248,2285
Chilkoot Lake,1991,4,,249,2289
Chilkoot Lake,1991,1,,250,2290
Chilkoot Lake,1991,23,,251,2313
Chilkoot Lake,1991,33,,252,2346
Chilkoot Lake,1991,12,,253,2358
Chilkoot Lake,1991,10,,254,2368
Chilkoot Lake,1991,8,,255,2376
Chilkoot Lake,1991,23,,256,2399
Chilkoot Lake,1991,26,,257,2425
Chilkoot Lake,1991,13,,258,2438
Chilkoot Lake,1991,12,,259,2450
Chilkoot Lake,1991,13,,260,2463
Chilkoot Lake,1991,7,,261,2470
Chilkoot Lake,1991,1,,262,2471
Chilkoot Lake,1991,5,,263,2476
Chilkoot Lake,1991,3,,264,2479
Chilkoot Lake,1991,10,,265,2489
Chilkoot Lake,1991,4,,266,2493
Chilkoot Lake,1991,10,,267,2503
Chilkoot Lake,1991,11,,268,2514
Chilkoot Lake,1991,6,,269,2520
Chilkoot Lake,1991,8,,270,2528
Chilkoot Lake,1991,2,,271,2530
Chilkoot Lake,1991,3,,272,2533
Chilkoot Lake,1991,13,,273,2546
Chilkoot Lake,1991,3,,274,2549
Chilkoot Lake,1991,4,,275,2553
Chilkoot Lake,1991,1,,276,2554
Chilkoot Lake,1991,3,,277,2557
Chilkoot Lake,1991,24,,278,2581
Chilkoot Lake,1991,4,,279,2585
Chilkoot Lake,1991,2,,280,2587
Chilkoot Lake,1991,1,,281,2588
Chilkoot Lake,1992,3,,180,3
Chilkoot Lake,1992,5,,189,8
Chilkoot Lake,1992,5,,191,13
Chilkoot Lake,1992,1,,192,14
Chilkoot Lake,1992,3,,193,17
Chilkoot Lake,1992,11,,194,28
Chilkoot Lake,1992,5,,195,33
Chilkoot Lake,1992,6,,197,39
Chilkoot Lake,1992,2,,198,41
Chilkoot Lake,1992,4,,199,45
Chilkoot Lake,1992,4,,200,49
Chilkoot Lake,1992,11,,201,60
Chilkoot Lake,1992,9,,202,69
Chilkoot Lake,1992,13,,203,82
Chilkoot Lake,1992,19,,204,101
Chilkoot Lake,1992,9,,205,110
Chilkoot Lake,1992,14,,206,124
Chilkoot Lake,1992,13,,207,137
Chilkoot Lake,1992,21,,208,158
Chilkoot Lake,1992,15,,209,173
Chilkoot Lake,1992,18,,210,191
Chilkoot Lake,1992,19,,211,210
Chilkoot Lake,1992,70,,212,280
Chilkoot Lake,1992,86,,213,366
Chilkoot Lake,1992,110,,214,476
Chilkoot Lake,1992,80,,215,556
Chilkoot Lake,1992,154,,216,710
Chilkoot Lake,1992,48,,217,758
Chilkoot Lake,1992,50,,218,808
Chilkoot Lake,1992,63,,219,871
Chilkoot Lake,1992,122,,220,993
Chilkoot Lake,1992,116,,221,1109
Chilkoot Lake,1992,132,,222,1241
Chilkoot Lake,1992,288,,223,1529
Chilkoot Lake,1992,74,,224,1603
Chilkoot Lake,1992,25,,225,1628
Chilkoot Lake,1992,23,,226,1651
Chilkoot Lake,1992,36,,227,1687
Chilkoot Lake,1992,36,,228,1723
Chilkoot Lake,1992,4,,229,1727
Chilkoot Lake,1992,2,,230,1729
Chilkoot Lake,1992,32,,231,1761
Chilkoot Lake,1992,69,,232,1830
Chilkoot Lake,1992,96,,233,1926
Chilkoot Lake,1992,173,,234,2099
Chilkoot Lake,1992,200,,235,2299
Chilkoot Lake,1992,316,,236,2615
Chilkoot Lake,1992,37,,237,2652
Chilkoot Lake,1992,23,,238,2675
Chilkoot Lake,1992,95,,239,2770
Chilkoot Lake,1992,109,,240,2879
Chilkoot Lake,1992,443,,241,3322
Chilkoot Lake,1992,214,,242,3536
Chilkoot Lake,1992,226,,243,3762
Chilkoot Lake,1992,255,,244,4017
Chilkoot Lake,1992,121,,245,4138
Chilkoot Lake,1992,217,,246,4355
Chilkoot Lake,1992,394,,247,4749
Chilkoot Lake,1992,498,,248,5247
Chilkoot Lake,1992,311,,249,5558
Chilkoot Lake,1992,203,,250,5761
Chilkoot Lake,1992,198,,251,5959
Chilkoot Lake,1992,160,,252,6119
Chilkoot Lake,1992,107,,253,6226
Chilkoot Lake,1992,216,,254,6442
Chilkoot Lake,1992,134,,255,6576
Chilkoot Lake,1992,219,,256,6795
Chilkoot Lake,1992,232,,257,7027
Chilkoot Lake,1992,152,,258,7179
Chilkoot Lake,1992,129,,259,7308
Chilkoot Lake,1992,54,,260,7362
Chilkoot Lake,1992,142,,261,7504
Chilkoot Lake,1992,74,,262,7578
Chilkoot Lake,1992,62,,263,7640
Chilkoot Lake,1992,28,,264,7668
Chilkoot Lake,1992,33,,265,7701
Chilkoot Lake,1992,16,,266,7717
Chilkoot Lake,1992,63,,267,7780
Chilkoot Lake,1992,50,,268,7830
Chilkoot Lake,1992,6,,269,7836
Chilkoot Lake,1993,2,,191,2
Chilkoot Lake,1993,1,,193,3
Chilkoot Lake,1993,3,,194,6
Chilkoot Lake,1993,5,,195,11
Chilkoot Lake,1993,2,,197,13
Chilkoot Lake,1993,1,,198,14
Chilkoot Lake,1993,2,,200,16
Chilkoot Lake,1993,1,,202,17
Chilkoot Lake,1993,1,,204,18
Chilkoot Lake,1993,2,,205,20
Chilkoot Lake,1993,3,,208,23
Chilkoot Lake,1993,1,,209,24
Chilkoot Lake,1993,5,,210,29
Chilkoot Lake,1993,3,,211,32
Chilkoot Lake,1993,1,,212,33
Chilkoot Lake,1993,4,,213,37
Chilkoot Lake,1993,17,,214,54
Chilkoot Lake,1993,2,,216,56
Chilkoot Lake,1993,21,,217,77
Chilkoot Lake,1993,9,,218,86
Chilkoot Lake,1993,8,,219,94
Chilkoot Lake,1993,12,,220,106
Chilkoot Lake,1993,28,,221,134
Chilkoot Lake,1993,3,,222,137
Chilkoot Lake,1993,5,,223,142
Chilkoot Lake,1993,2,,224,144
Chilkoot Lake,1993,2,,225,146
Chilkoot Lake,1993,7,,226,153
Chilkoot Lake,1993,4,,227,157
Chilkoot Lake,1993,3,,228,160
Chilkoot Lake,1993,14,,229,174
Chilkoot Lake,1993,23,,230,197
Chilkoot Lake,1993,26,,231,223
Chilkoot Lake,1993,17,,232,240
Chilkoot Lake,1993,20,,233,260
Chilkoot Lake,1993,14,,234,274
Chilkoot Lake,1993,15,,235,289
Chilkoot Lake,1993,4,,236,293
Chilkoot Lake,1993,3,,237,296
Chilkoot Lake,1993,1,,238,297
Chilkoot Lake,1993,2,,239,299
Chilkoot Lake,1993,2,,240,301
Chilkoot Lake,1993,1,,241,302
Chilkoot Lake,1993,3,,242,305
Chilkoot Lake,1993,9,,243,314
Chilkoot Lake,1993,2,,244,316
Chilkoot Lake,1993,1,,245,317
Chilkoot Lake,1993,3,,246,320
Chilkoot Lake,1993,3,,247,323
Chilkoot Lake,1993,1,,248,324
Chilkoot Lake,1993,4,,249,328
Chilkoot Lake,1993,1,,250,329
Chilkoot Lake,1993,2,,251,331
Chilkoot Lake,1993,4,,252,335
Chilkoot Lake,1993,2,,253,337
Chilkoot Lake,1993,3,,254,340
Chilkoot Lake,1993,3,,255,343
Chilkoot Lake,1993,2,,256,345
Chilkoot Lake,1993,3,,257,348
Chilkoot Lake,1993,1,,259,349
Chilkoot Lake,1993,3,,260,352
Chilkoot Lake,1993,2,,262,354
Chilkoot Lake,1993,1,,264,355
Chilkoot Lake,1993,1,,266,356
Chilkoot Lake,1993,1,,269,357
Chilkoot Lake,1994,1,,178,1
Chilkoot Lake,1994,1,,179,2
Chilkoot Lake,1994,9,,180,11
Chilkoot Lake,1994,7,,181,18
Chilkoot Lake,1994,38,,182,56
Chilkoot Lake,1994,12,,183,68
Chilkoot Lake,1994,6,,184,74
Chilkoot Lake,1994,16,,185,90
Chilkoot Lake,1994,1,,186,91
Chilkoot Lake,1994,18,,187,109
Chilkoot Lake,1994,9,,188,118
Chilkoot Lake,1994,3,,189,121
Chilkoot Lake,1994,23,,190,144
Chilkoot Lake,1994,6,,191,150
Chilkoot Lake,1994,9,,192,159
Chilkoot Lake,1994,25,,193,184
Chilkoot Lake,1994,31,,194,215
Chilkoot Lake,1994,34,,195,249
Chilkoot Lake,1994,27,,196,276
Chilkoot Lake,1994,67,,197,343
Chilkoot Lake,1994,119,,198,462
Chilkoot Lake,1994,11,,199,473
Chilkoot Lake,1994,38,,200,511
Chilkoot Lake,1994,14,,201,525
Chilkoot Lake,1994,19,,202,544
Chilkoot Lake,1994,42,,203,586
Chilkoot Lake,1994,64,,204,650
Chilkoot Lake,1994,129,,205,779
Chilkoot Lake,1994,52,,206,831
Chilkoot Lake,1994,57,,207,888
Chilkoot Lake,1994,82,,208,970
Chilkoot Lake,1994,112,,209,1082
Chilkoot Lake,1994,48,,210,1130
Chilkoot Lake,1994,21,,211,1151
Chilkoot Lake,1994,8,,212,1159
Chilkoot Lake,1994,20,,213,1179
Chilkoot Lake,1994,57,,214,1236
Chilkoot Lake,1994,43,,215,1279
Chilkoot Lake,1994,25,,216,1304
Chilkoot Lake,1994,34,,217,1338
Chilkoot Lake,1994,41,,218,1379
Chilkoot Lake,1994,58,,219,1437
Chilkoot Lake,1994,34,,220,1471
Chilkoot Lake,1994,32,,221,1503
Chilkoot Lake,1994,24,,222,1527
Chilkoot Lake,1994,35,,223,1562
Chilkoot Lake,1994,192,,224,1754
Chilkoot Lake,1994,96,,225,1850
Chilkoot Lake,1994,125,,226,1975
Chilkoot Lake,1994,192,,227,2167
Chilkoot Lake,1994,399,,228,2566
Chilkoot Lake,1994,111,,229,2677
Chilkoot Lake,1994,245,,230,2922
Chilkoot Lake,1994,238,,231,3160
Chilkoot Lake,1994,388,,232,3548
Chilkoot Lake,1994,191,,233,3739
Chilkoot Lake,1994,83,,234,3822
Chilkoot Lake,1994,87,,235,3909
Chilkoot Lake,1994,120,,236,4029
Chilkoot Lake,1994,380,,237,4409
Chilkoot Lake,1994,416,,238,4825
Chilkoot Lake,1994,384,,239,5209
Chilkoot Lake,1994,981,,240,6190
Chilkoot Lake,1994,960,,241,7150
Chilkoot Lake,1994,927,,242,8077
Chilkoot Lake,1994,381,,243,8458
Chilkoot Lake,1994,545,,244,9003
Chilkoot Lake,1994,1295,,245,10298
Chilkoot Lake,1994,2148,,246,12446
Chilkoot Lake,1994,1328,,247,13774
Chilkoot Lake,1994,648,,248,14422
Chilkoot Lake,1994,1740,,249,16162
Chilkoot Lake,1994,1533,,250,17695
Chilkoot Lake,1994,773,,251,18468
Chilkoot Lake,1994,1276,,252,19744
Chilkoot Lake,1994,703,,253,20447
Chilkoot Lake,1994,290,,254,20737
Chilkoot Lake,1994,467,,255,21204
Chilkoot Lake,1994,718,,256,21922
Chilkoot Lake,1994,428,,257,22350
Chilkoot Lake,1994,1,,264,22351
Chilkoot Lake,1994,18,,265,22369
Chilkoot Lake,1994,62,,266,22431
Chilkoot Lake,1994,41,,267,22472
Chilkoot Lake,1995,1,,194,1
Chilkoot Lake,1995,2,,196,3
Chilkoot Lake,1995,1,,198,4
Chilkoot Lake,1995,2,,199,6
Chilkoot Lake,1995,1,,200,7
Chilkoot Lake,1995,2,,202,9
Chilkoot Lake,1995,3,,203,12
Chilkoot Lake,1995,6,,204,18
Chilkoot Lake,1995,26,,205,44
Chilkoot Lake,1995,2,,206,46
Chilkoot Lake,1995,10,,207,56
Chilkoot Lake,1995,6,,208,62
Chilkoot Lake,1995,4,,209,66
Chilkoot Lake,1995,16,,210,82
Chilkoot Lake,1995,10,,211,92
Chilkoot Lake,1995,28,,212,120
Chilkoot Lake,1995,74,,213,194
Chilkoot Lake,1995,11,,214,205
Chilkoot Lake,1995,8,,215,213
Chilkoot Lake,1995,2,,216,215
Chilkoot Lake,1995,19,,217,234
Chilkoot Lake,1995,17,,218,251
Chilkoot Lake,1995,13,,219,264
Chilkoot Lake,1995,31,,220,295
Chilkoot Lake,1995,45,,221,340
Chilkoot Lake,1995,57,,222,397
Chilkoot Lake,1995,18,,223,415
Chilkoot Lake,1995,52,,224,467
Chilkoot Lake,1995,53,,225,520
Chilkoot Lake,1995,31,,226,551
Chilkoot Lake,1995,45,,227,596
Chilkoot Lake,1995,84,,228,680
Chilkoot Lake,1995,85,,229,765
Chilkoot Lake,1995,35,,230,800
Chilkoot Lake,1995,20,,231,820
Chilkoot Lake,1995,23,,232,843
Chilkoot Lake,1995,19,,233,862
Chilkoot Lake,1995,10,,234,872
Chilkoot Lake,1995,11,,235,883
Chilkoot Lake,1995,16,,236,899
Chilkoot Lake,1995,5,,237,904
Chilkoot Lake,1995,16,,238,920
Chilkoot Lake,1995,12,,239,932
Chilkoot Lake,1995,3,,240,935
Chilkoot Lake,1995,12,,241,947
Chilkoot Lake,1995,11,,242,958
Chilkoot Lake,1995,36,,243,994
Chilkoot Lake,1995,19,,244,1013
Chilkoot Lake,1995,14,,245,1027
Chilkoot Lake,1995,15,,246,1042
Chilkoot Lake,1995,26,,247,1068
Chilkoot Lake,1995,41,,248,1109
Chilkoot Lake,1995,56,,249,1165
Chilkoot Lake,1995,47,,250,1212
Chilkoot Lake,1995,27,,251,1239
Chilkoot Lake,1995,3,,252,1242
Chilkoot Lake,1995,1,,253,1243
Chilkoot Lake,1996,1,,171,1
Chilkoot Lake,1996,2,,174,3
Chilkoot Lake,1996,15,,175,18
Chilkoot Lake,1996,1,,176,19
Chilkoot Lake,1996,2,,178,21
Chilkoot Lake,1996,1,,180,22
Chilkoot Lake,1996,1,,181,23
Chilkoot Lake,1996,8,,184,31
Chilkoot Lake,1996,1,,185,32
Chilkoot Lake,1996,1,,186,33
Chilkoot Lake,1996,4,,187,37
Chilkoot Lake,1996,1,,188,38
Chilkoot Lake,1996,3,,189,41
Chilkoot Lake,1996,1,,190,42
Chilkoot Lake,1996,2,,192,44
Chilkoot Lake,1996,5,,193,49
Chilkoot Lake,1996,1,,194,50
Chilkoot Lake,1996,69,,195,119
Chilkoot Lake,1996,79,,197,198
Chilkoot Lake,1996,7,,198,205
Chilkoot Lake,1996,38,,199,243
Chilkoot Lake,1996,6,,200,249
Chilkoot Lake,1996,167,,201,416
Chilkoot Lake,1996,16,,202,432
Chilkoot Lake,1996,68,,203,500
Chilkoot Lake,1996,2,,204,502
Chilkoot Lake,1996,3,,205,505
Chilkoot Lake,1996,7,,206,512
Chilkoot Lake,1996,109,,207,621
Chilkoot Lake,1996,130,,208,751
Chilkoot Lake,1996,121,,209,872
Chilkoot Lake,1996,18,,210,890
Chilkoot Lake,1996,17,,211,907
Chilkoot Lake,1996,20,,212,927
Chilkoot Lake,1996,29,,213,956
Chilkoot Lake,1996,38,,214,994
Chilkoot Lake,1996,21,,215,1015
Chilkoot Lake,1996,41,,216,1056
Chilkoot Lake,1996,33,,217,1089
Chilkoot Lake,1996,29,,218,1118
Chilkoot Lake,1996,48,,219,1166
Chilkoot Lake,1996,34,,220,1200
Chilkoot Lake,1996,36,,221,1236
Chilkoot Lake,1996,49,,222,1285
Chilkoot Lake,1996,21,,223,1306
Chilkoot Lake,1996,92,,224,1398
Chilkoot Lake,1996,59,,225,1457
Chilkoot Lake,1996,83,,226,1540
Chilkoot Lake,1996,109,,227,1649
Chilkoot Lake,1996,52,,228,1701
Chilkoot Lake,1996,69,,229,1770
Chilkoot Lake,1996,109,,230,1879
Chilkoot Lake,1996,81,,231,1960
Chilkoot Lake,1996,21,,232,1981
Chilkoot Lake,1996,149,,233,2130
Chilkoot Lake,1996,12,,234,2142
Chilkoot Lake,1996,9,,235,2151
Chilkoot Lake,1996,29,,236,2180
Chilkoot Lake,1996,30,,237,2210
Chilkoot Lake,1996,79,,238,2289
Chilkoot Lake,1996,62,,239,2351
Chilkoot Lake,1996,52,,240,2403
Chilkoot Lake,1996,23,,241,2426
Chilkoot Lake,1996,21,,242,2447
Chilkoot Lake,1996,34,,243,2481
Chilkoot Lake,1996,34,,244,2515
Chilkoot Lake,1996,75,,245,2590
Chilkoot Lake,1996,50,,246,2640
Chilkoot Lake,1996,44,,247,2684
Chilkoot Lake,1996,35,,248,2719
Chilkoot Lake,1996,33,,249,2752
Chilkoot Lake,1996,13,,250,2765
Chilkoot Lake,1996,31,,251,2796
Chilkoot Lake,1996,8,,252,2804
Chilkoot Lake,1996,30,,253,2834
Chilkoot Lake,1996,33,,254,2867
Chilkoot Lake,1997,2,,184,2
Chilkoot Lake,1997,1,,185,3
Chilkoot Lake,1997,3,,187,6
Chilkoot Lake,1997,4,,188,10
Chilkoot Lake,1997,2,,189,12
Chilkoot Lake,1997,9,,191,21
Chilkoot Lake,1997,4,,192,25
Chilkoot Lake,1997,2,,193,27
Chilkoot Lake,1997,2,,194,29
Chilkoot Lake,1997,6,,195,35
Chilkoot Lake,1997,2,,196,37
Chilkoot Lake,1997,18,,197,55
Chilkoot Lake,1997,18,,198,73
Chilkoot Lake,1997,2,,199,75
Chilkoot Lake,1997,45,,200,120
Chilkoot Lake,1997,44,,201,164
Chilkoot Lake,1997,49,,202,213
Chilkoot Lake,1997,25,,203,238
Chilkoot Lake,1997,34,,204,272
Chilkoot Lake,1997,62,,205,334
Chilkoot Lake,1997,84,,206,418
Chilkoot Lake,1997,101,,207,519
Chilkoot Lake,1997,41,,208,560
Chilkoot Lake,1997,62,,209,622
Chilkoot Lake,1997,194,,210,816
Chilkoot Lake,1997,113,,211,929
Chilkoot Lake,1997,167,,212,1096
Chilkoot Lake,1997,194,,213,1290
Chilkoot Lake,1997,251,,214,1541
Chilkoot Lake,1997,445,,215,1986
Chilkoot Lake,1997,143,,216,2129
Chilkoot Lake,1997,482,,217,2611
Chilkoot Lake,1997,302,,218,2913
Chilkoot Lake,1997,646,,219,3559
Chilkoot Lake,1997,616,,220,4175
Chilkoot Lake,1997,1069,,221,5244
Chilkoot Lake,1997,2086,,222,7330
Chilkoot Lake,1997,682,,223,8012
Chilkoot Lake,1997,108,,224,8120
Chilkoot Lake,1997,229,,225,8349
Chilkoot Lake,1997,108,,226,8457
Chilkoot Lake,1997,677,,227,9134
Chilkoot Lake,1997,1456,,228,10590
Chilkoot Lake,1997,1232,,229,11822
Chilkoot Lake,1997,3245,,230,15067
Chilkoot Lake,1997,2632,,231,17699
Chilkoot Lake,1997,1440,,232,19139
Chilkoot Lake,1997,788,,233,19927
Chilkoot Lake,1997,260,,234,20187
Chilkoot Lake,1997,515,,235,20702
Chilkoot Lake,1997,480,,236,21182
Chilkoot Lake,1997,303,,237,21485
Chilkoot Lake,1997,375,,238,21860
Chilkoot Lake,1997,266,,239,22126
Chilkoot Lake,1997,383,,240,22509
Chilkoot Lake,1997,438,,241,22947
Chilkoot Lake,1997,491,,242,23438
Chilkoot Lake,1997,399,,243,23837
Chilkoot Lake,1997,645,,244,24482
Chilkoot Lake,1997,746,,245,25228
Chilkoot Lake,1997,271,,246,25499
Chilkoot Lake,1997,205,,247,25704
Chilkoot Lake,1997,48,,248,25752
Chilkoot Lake,1997,187,,249,25939
Chilkoot Lake,1997,109,,250,26048
Chilkoot Lake,1997,91,,251,26139
Chilkoot Lake,1997,58,,252,26197
Chilkoot Lake,1998,5,,184,5
Chilkoot Lake,1998,1,,185,6
Chilkoot Lake,1998,1,,186,7
Chilkoot Lake,1998,1,,187,8
Chilkoot Lake,1998,3,,188,11
Chilkoot Lake,1998,12,,189,23
Chilkoot Lake,1998,16,,190,39
Chilkoot Lake,1998,34,,191,73
Chilkoot Lake,1998,42,,192,115
Chilkoot Lake,1998,51,,193,166
Chilkoot Lake,1998,13,,194,179
Chilkoot Lake,1998,8,,195,187
Chilkoot Lake,1998,19,,196,206
Chilkoot Lake,1998,30,,197,236
Chilkoot Lake,1998,78,,198,314
Chilkoot Lake,1998,44,,199,358
Chilkoot Lake,1998,55,,200,413
Chilkoot Lake,1998,151,,201,564
Chilkoot Lake,1998,314,,202,878
Chilkoot Lake,1998,132,,203,1010
Chilkoot Lake,1998,187,,204,1197
Chilkoot Lake,1998,80,,205,1277
Chilkoot Lake,1998,55,,206,1332
Chilkoot Lake,1998,95,,207,1427
Chilkoot Lake,1998,108,,208,1535
Chilkoot Lake,1998,117,,209,1652
Chilkoot Lake,1998,96,,210,1748
Chilkoot Lake,1998,413,,211,2161
Chilkoot Lake,1998,322,,212,2483
Chilkoot Lake,1998,221,,213,2704
Chilkoot Lake,1998,352,,214,3056
Chilkoot Lake,1998,243,,215,3299
Chilkoot Lake,1998,421,,216,3720
Chilkoot Lake,1998,1927,,217,5647
Chilkoot Lake,1998,1144,,218,6791
Chilkoot Lake,1998,662,,219,7453
Chilkoot Lake,1998,445,,220,7898
Chilkoot Lake,1998,1102,,221,9000
Chilkoot Lake,1998,771,,222,9771
Chilkoot Lake,1998,927,,223,10698
Chilkoot Lake,1998,2053,,224,12751
Chilkoot Lake,1998,1271,,225,14022
Chilkoot Lake,1998,1856,,226,15878
Chilkoot Lake,1998,1512,,227,17390
Chilkoot Lake,1998,2242,,228,19632
Chilkoot Lake,1998,1326,,229,20958
Chilkoot Lake,1998,1135,,230,22093
Chilkoot Lake,1998,1412,,231,23505
Chilkoot Lake,1998,2686,,232,26191
Chilkoot Lake,1998,2216,,233,28407
Chilkoot Lake,1998,2424,,234,30831
Chilkoot Lake,1998,2065,,235,32896
Chilkoot Lake,1998,1644,,236,34540
Chilkoot Lake,1998,1070,,237,35610
Chilkoot Lake,1998,1189,,238,36799
Chilkoot Lake,1998,1000,,239,37799
Chilkoot Lake,1998,519,,240,38318
Chilkoot Lake,1998,26,,241,38344
Chilkoot Lake,1998,495,,242,38839
Chilkoot Lake,1998,1921,,243,40760
Chilkoot Lake,1998,33,,244,40793
Chilkoot Lake,1998,408,,245,41201
Chilkoot Lake,1998,415,,246,41616
Chilkoot Lake,1998,325,,247,41941
Chilkoot Lake,1998,605,,248,42546
Chilkoot Lake,1998,466,,249,43012
Chilkoot Lake,1998,121,,250,43133
Chilkoot Lake,1998,26,,251,43159
Chilkoot Lake,1998,212,,252,43371
Chilkoot Lake,1998,340,,253,43711
Chilkoot Lake,1998,149,,254,43860
Chilkoot Lake,1998,44,,255,43904
Chilkoot Lake,1998,97,,256,44001
Chilkoot Lake,1999,4,,193,4
Chilkoot Lake,1999,2,,194,6
Chilkoot Lake,1999,1,,195,7
Chilkoot Lake,1999,3,,196,10
Chilkoot Lake,1999,3,,197,13
Chilkoot Lake,1999,3,,198,16
Chilkoot Lake,1999,7,,199,23
Chilkoot Lake,1999,3,,200,26
Chilkoot Lake,1999,8,,201,34
Chilkoot Lake,1999,7,,202,41
Chilkoot Lake,1999,18,,203,59
Chilkoot Lake,1999,28,,204,87
Chilkoot Lake,1999,41,,205,128
Chilkoot Lake,1999,98,,206,226
Chilkoot Lake,1999,118,,207,344
Chilkoot Lake,1999,117,,208,461
Chilkoot Lake,1999,55,,209,516
Chilkoot Lake,1999,47,,210,563
Chilkoot Lake,1999,192,,211,755
Chilkoot Lake,1999,251,,212,1006
Chilkoot Lake,1999,488,,213,1494
Chilkoot Lake,1999,158,,214,1652
Chilkoot Lake,1999,116,,215,1768
Chilkoot Lake,1999,85,,216,1853
Chilkoot Lake,1999,65,,217,1918
Chilkoot Lake,1999,76,,218,1994
Chilkoot Lake,1999,48,,219,2042
Chilkoot Lake,1999,148,,220,2190
Chilkoot Lake,1999,110,,221,2300
Chilkoot Lake,1999,186,,222,2486
Chilkoot Lake,1999,235,,223,2721
Chilkoot Lake,1999,683,,224,3404
Chilkoot Lake,1999,339,,225,3743
Chilkoot Lake,1999,368,,226,4111
Chilkoot Lake,1999,1153,,227,5264
Chilkoot Lake,1999,813,,228,6077
Chilkoot Lake,1999,357,,229,6434
Chilkoot Lake,1999,533,,230,6967
Chilkoot Lake,1999,545,,231,7512
Chilkoot Lake,1999,448,,232,7960
Chilkoot Lake,1999,572,,233,8532
Chilkoot Lake,1999,312,,234,8844
Chilkoot Lake,1999,332,,235,9176
Chilkoot Lake,1999,693,,236,9869
Chilkoot Lake,1999,2194,,237,12063
Chilkoot Lake,1999,1244,,238,13307
Chilkoot Lake,1999,1138,,239,14445
Chilkoot Lake,1999,2504,,240,16949
Chilkoot Lake,1999,697,,241,17646
Chilkoot Lake,1999,742,,242,18388
Chilkoot Lake,1999,1069,,243,19457
Chilkoot Lake,1999,2048,,244,21505
Chilkoot Lake,1999,2091,,245,23596
Chilkoot Lake,1999,2035,,246,25631
Chilkoot Lake,1999,1037,,247,26668
Chilkoot Lake,1999,1898,,248,28566
Chilkoot Lake,1999,3015,,249,31581
Chilkoot Lake,1999,2045,,250,33626
Chilkoot Lake,1999,3082,,251,36708
Chilkoot Lake,1999,6109,,252,42817
Chilkoot Lake,1999,7562,,253,50379
Chilkoot Lake,1999,3088,,255,53467
Chilkoot Lake,1999,3225,,256,56692
Chilkoot Lake,2000,5,,194,5
Chilkoot Lake,2000,3,,195,8
Chilkoot Lake,2000,4,,196,12
Chilkoot Lake,2000,2,,197,14
Chilkoot Lake,2000,28,,199,42
Chilkoot Lake,2000,39,,200,81
Chilkoot Lake,2000,21,,201,102
Chilkoot Lake,2000,29,,202,131
Chilkoot Lake,2000,20,,203,151
Chilkoot Lake,2000,8,,204,159
Chilkoot Lake,2000,14,,205,173
Chilkoot Lake,2000,17,,206,190
Chilkoot Lake,2000,30,,207,220
Chilkoot Lake,2000,134,,208,354
Chilkoot Lake,2000,61,,209,415
Chilkoot Lake,2000,228,,210,643
Chilkoot Lake,2000,121,,211,764
Chilkoot Lake,2000,336,,212,1100
Chilkoot Lake,2000,126,,213,1226
Chilkoot Lake,2000,133,,214,1359
Chilkoot Lake,2000,200,,215,1559
Chilkoot Lake,2000,419,,216,1978
Chilkoot Lake,2000,413,,217,2391
Chilkoot Lake,2000,111,,218,2502
Chilkoot Lake,2000,148,,219,2650
Chilkoot Lake,2000,341,,220,2991
Chilkoot Lake,2000,436,,221,3427
Chilkoot Lake,2000,545,,222,3972
Chilkoot Lake,2000,206,,223,4178
Chilkoot Lake,2000,442,,224,4620
Chilkoot Lake,2000,447,,225,5067
Chilkoot Lake,2000,383,,226,5450
Chilkoot Lake,2000,487,,227,5937
Chilkoot Lake,2000,139,,228,6076
Chilkoot Lake,2000,212,,229,6288
Chilkoot Lake,2000,183,,230,6471
Chilkoot Lake,2000,541,,231,7012
Chilkoot Lake,2000,364,,232,7376
Chilkoot Lake,2000,163,,233,7539
Chilkoot Lake,2000,484,,234,8023
Chilkoot Lake,2000,712,,235,8735
Chilkoot Lake,2000,857,,236,9592
Chilkoot Lake,2000,688,,237,10280
Chilkoot Lake,2000,572,,238,10852
Chilkoot Lake,2000,246,,239,11098
Chilkoot Lake,2000,1250,,240,12348
Chilkoot Lake,2000,1014,,241,13362
Chilkoot Lake,2000,776,,242,14138
Chilkoot Lake,2000,1100,,243,15238
Chilkoot Lake,2000,1015,,244,16253
Chilkoot Lake,2000,2386,,245,18639
Chilkoot Lake,2000,845,,246,19484
Chilkoot Lake,2000,1088,,247,20572
Chilkoot Lake,2000,622,,248,21194
Chilkoot Lake,2000,65,,249,21259
Chilkoot Lake,2000,32,,250,21291
Chilkoot Lake,2000,159,,251,21450
Chilkoot Lake,2000,1000,,252,22450
Chilkoot Lake,2000,641,,253,23091
Chilkoot Lake,2000,290,,254,23381
Chilkoot Lake,2000,255,,255,23636
Chilkoot Lake,2001,3,,180,3
Chilkoot Lake,2001,1,,181,4
Chilkoot Lake,2001,1,,185,5
Chilkoot Lake,2001,16,,187,21
Chilkoot Lake,2001,12,,189,33
Chilkoot Lake,2001,12,,190,45
Chilkoot Lake,2001,24,,191,69
Chilkoot Lake,2001,10,,192,79
Chilkoot Lake,2001,18,,193,97
Chilkoot Lake,2001,4,,194,101
Chilkoot Lake,2001,12,,195,113
Chilkoot Lake,2001,2,,196,115
Chilkoot Lake,2001,31,,197,146
Chilkoot Lake,2001,23,,198,169
Chilkoot Lake,2001,66,,199,235
Chilkoot Lake,2001,128,,200,363
Chilkoot Lake,2001,291,,201,654
Chilkoot Lake,2001,146,,202,800
Chilkoot Lake,2001,133,,203,933
Chilkoot Lake,2001,91,,204,1024
Chilkoot Lake,2001,58,,205,1082
Chilkoot Lake,2001,103,,206,1185
Chilkoot Lake,2001,86,,207,1271
Chilkoot Lake,2001,80,,208,1351
Chilkoot Lake,2001,132,,209,1483
Chilkoot Lake,2001,121,,210,1604
Chilkoot Lake,2001,162,,211,1766
Chilkoot Lake,2001,371,,212,2137
Chilkoot Lake,2001,671,,213,2808
Chilkoot Lake,2001,583,,214,3391
Chilkoot Lake,2001,229,,215,3620
Chilkoot Lake,2001,284,,216,3904
Chilkoot Lake,2001,205,,217,4109
Chilkoot Lake,2001,392,,218,4501
Chilkoot Lake,2001,270,,219,4771
Chilkoot Lake,2001,168,,220,4939
Chilkoot Lake,2001,262,,221,5201
Chilkoot Lake,2001,426,,222,5627
Chilkoot Lake,2001,1037,,223,6664
Chilkoot Lake,2001,671,,224,7335
Chilkoot Lake,2001,564,,225,7899
Chilkoot Lake,2001,418,,226,8317
Chilkoot Lake,2001,856,,227,9173
Chilkoot Lake,2001,651,,228,9824
Chilkoot Lake,2001,1115,,229,10939
Chilkoot Lake,2001,2837,,230,13776
Chilkoot Lake,2001,714,,231,14490
Chilkoot Lake,2001,1178,,232,15668
Chilkoot Lake,2001,2165,,233,17833
Chilkoot Lake,2001,2031,,234,19864
Chilkoot Lake,2001,1308,,235,21172
Chilkoot Lake,2001,2846,,236,24018
Chilkoot Lake,2001,1074,,237,25092
Chilkoot Lake,2001,545,,238,25637
Chilkoot Lake,2001,842,,239,26479
Chilkoot Lake,2001,250,,240,26729
Chilkoot Lake,2001,401,,241,27130
Chilkoot Lake,2001,482,,242,27612
Chilkoot Lake,2001,442,,243,28054
Chilkoot Lake,2001,370,,244,28424
Chilkoot Lake,2001,377,,245,28801
Chilkoot Lake,2001,367,,246,29168
Chilkoot Lake,2001,291,,247,29459
Chilkoot Lake,2001,232,,248,29691
Chilkoot Lake,2001,580,,249,30271
Chilkoot Lake,2001,154,,250,30425
Chilkoot Lake,2001,311,,251,30736
Chilkoot Lake,2001,213,,252,30949
Chilkoot Lake,2001,577,,253,31526
Chilkoot Lake,2001,477,,254,32003
Chilkoot Lake,2001,291,,255,32294
Chilkoot Lake,2002,2,,186,2
Chilkoot Lake,2002,2,,187,4
Chilkoot Lake,2002,4,,189,8
Chilkoot Lake,2002,12,,191,20
Chilkoot Lake,2002,13,,192,33
Chilkoot Lake,2002,11,,193,44
Chilkoot Lake,2002,5,,194,49
Chilkoot Lake,2002,3,,195,52
Chilkoot Lake,2002,1,,196,53
Chilkoot Lake,2002,5,,197,58
Chilkoot Lake,2002,14,,198,72
Chilkoot Lake,2002,19,,199,91
Chilkoot Lake,2002,20,,200,111
Chilkoot Lake,2002,16,,201,127
Chilkoot Lake,2002,108,,202,235
Chilkoot Lake,2002,345,,203,580
Chilkoot Lake,2002,674,,204,1254
Chilkoot Lake,2002,193,,205,1447
Chilkoot Lake,2002,118,,206,1565
Chilkoot Lake,2002,121,,207,1686
Chilkoot Lake,2002,117,,208,1803
Chilkoot Lake,2002,172,,209,1975
Chilkoot Lake,2002,142,,210,2117
Chilkoot Lake,2002,348,,211,2465
Chilkoot Lake,2002,580,,212,3045
Chilkoot Lake,2002,1046,,213,4091
Chilkoot Lake,2002,783,,214,4874
Chilkoot Lake,2002,682,,215,5556
Chilkoot Lake,2002,1244,,216,6800
Chilkoot Lake,2002,826,,217,7626
Chilkoot Lake,2002,1168,,218,8794
Chilkoot Lake,2002,904,,219,9698
Chilkoot Lake,2002,1034,,220,10732
Chilkoot Lake,2002,588,,221,11320
Chilkoot Lake,2002,1768,,222,13088
Chilkoot Lake,2002,996,,223,14084
Chilkoot Lake,2002,380,,224,14464
Chilkoot Lake,2002,176,,225,14640
Chilkoot Lake,2002,1280,,226,15920
Chilkoot Lake,2002,4100,,227,20020
Chilkoot Lake,2002,9635,,228,29655
Chilkoot Lake,2002,7703,,229,37358
Chilkoot Lake,2002,8945,,230,46303
Chilkoot Lake,2002,3524,,231,49827
Chilkoot Lake,2002,2000,,232,51827
Chilkoot Lake,2002,1677,,233,53504
Chilkoot Lake,2002,1054,,234,54558
Chilkoot Lake,2002,1231,,235,55789
Chilkoot Lake,2002,930,,236,56719
Chilkoot Lake,2002,2795,,237,59514
Chilkoot Lake,2002,2579,,238,62093
Chilkoot Lake,2002,2127,,239,64220
Chilkoot Lake,2002,678,,240,64898
Chilkoot Lake,2002,336,,241,65234
Chilkoot Lake,2002,579,,242,65813
Chilkoot Lake,2002,759,,243,66572
Chilkoot Lake,2002,1031,,244,67603
Chilkoot Lake,2002,4102,,245,71705
Chilkoot Lake,2002,1397,,246,73102
Chilkoot Lake,2002,1035,,247,74137
Chilkoot Lake,2002,878,,248,75015
Chilkoot Lake,2002,909,,249,75924
Chilkoot Lake,2002,1219,,250,77143
Chilkoot Lake,2002,983,,251,78126
Chilkoot Lake,2002,856,,252,78982
Chilkoot Lake,2002,415,,253,79397
Chilkoot Lake,2002,242,,254,79639
Chilkoot Lake,2003,1,,171,1
Chilkoot Lake,2003,1,,174,2
Chilkoot Lake,2003,1,,175,3
Chilkoot Lake,2003,1,,180,4
Chilkoot Lake,2003,3,,181,7
Chilkoot Lake,2003,1,,183,8
Chilkoot Lake,2003,1,,184,9
Chilkoot Lake,2003,4,,185,13
Chilkoot Lake,2003,5,,186,18
Chilkoot Lake,2003,3,,187,21
Chilkoot Lake,2003,3,,188,24
Chilkoot Lake,2003,27,,189,51
Chilkoot Lake,2003,11,,190,62
Chilkoot Lake,2003,52,,191,114
Chilkoot Lake,2003,81,,192,195
Chilkoot Lake,2003,63,,193,258
Chilkoot Lake,2003,63,,194,321
Chilkoot Lake,2003,51,,195,372
Chilkoot Lake,2003,48,,196,420
Chilkoot Lake,2003,34,,197,454
Chilkoot Lake,2003,58,,198,512
Chilkoot Lake,2003,97,,199,609
Chilkoot Lake,2003,164,,200,773
Chilkoot Lake,2003,280,,201,1053
Chilkoot Lake,2003,88,,202,1141
Chilkoot Lake,2003,80,,203,1221
Chilkoot Lake,2003,142,,204,1363
Chilkoot Lake,2003,184,,205,1547
Chilkoot Lake,2003,202,,206,1749
Chilkoot Lake,2003,378,,207,2127
Chilkoot Lake,2003,162,,208,2289
Chilkoot Lake,2003,397,,209,2686
Chilkoot Lake,2003,580,,210,3266
Chilkoot Lake,2003,304,,211,3570
Chilkoot Lake,2003,577,,212,4147
Chilkoot Lake,2003,1129,,213,5276
Chilkoot Lake,2003,880,,214,6156
Chilkoot Lake,2003,1051,,215,7207
Chilkoot Lake,2003,903,,216,8110
Chilkoot Lake,2003,1511,,217,9621
Chilkoot Lake,2003,2481,,218,12102
Chilkoot Lake,2003,2714,,219,14816
Chilkoot Lake,2003,3478,,220,18294
Chilkoot Lake,2003,4513,,221,22807
Chilkoot Lake,2003,3796,,222,26603
Chilkoot Lake,2003,3131,,223,29734
Chilkoot Lake,2003,2157,,224,31891
Chilkoot Lake,2003,1664,,225,33555
Chilkoot Lake,2003,548,,226,34103
Chilkoot Lake,2003,354,,227,34457
Chilkoot Lake,2003,164,,230,34621
Chilkoot Lake,2003,143,,231,34764
Chilkoot Lake,2003,461,,232,35225
Chilkoot Lake,2003,474,,233,35699
Chilkoot Lake,2003,1100,,234,36799
Chilkoot Lake,2003,1476,,235,38275
Chilkoot Lake,2003,1946,,236,40221
Chilkoot Lake,2003,1658,,237,41879
Chilkoot Lake,2003,2258,,238,44137
Chilkoot Lake,2003,3849,,239,47986
Chilkoot Lake,2003,2595,,240,50581
Chilkoot Lake,2003,1777,,241,52358
Chilkoot Lake,2003,1155,,242,53513
Chilkoot Lake,2003,267,,243,53780
Chilkoot Lake,2003,50,,244,53830
Chilkoot Lake,2003,89,,245,53919
Chilkoot Lake,2003,184,,246,54103
Chilkoot Lake,2003,113,,247,54216
Chilkoot Lake,2003,134,,248,54350
Chilkoot Lake,2003,561,,249,54911
Chilkoot Lake,2003,244,,250,55155
Chilkoot Lake,2003,134,,251,55289
Chilkoot Lake,2003,135,,252,55424
Chilkoot Lake,2004,1,,179,1
Chilkoot Lake,2004,1,,180,2
Chilkoot Lake,2004,2,,181,4
Chilkoot Lake,2004,2,,183,6
Chilkoot Lake,2004,1,,184,7
Chilkoot Lake,2004,3,,185,10
Chilkoot Lake,2004,9,,186,19
Chilkoot Lake,2004,5,,187,24
Chilkoot Lake,2004,7,,188,31
Chilkoot Lake,2004,7,,189,38
Chilkoot Lake,2004,20,,190,58
Chilkoot Lake,2004,35,,191,93
Chilkoot Lake,2004,15,,192,108
Chilkoot Lake,2004,70,,193,178
Chilkoot Lake,2004,70,,194,248
Chilkoot Lake,2004,124,,195,372
Chilkoot Lake,2004,88,,196,460
Chilkoot Lake,2004,78,,197,538
Chilkoot Lake,2004,235,,198,773
Chilkoot Lake,2004,382,,199,1155
Chilkoot Lake,2004,536,,200,1691
Chilkoot Lake,2004,703,,201,2394
Chilkoot Lake,2004,594,,202,2988
Chilkoot Lake,2004,1118,,203,4106
Chilkoot Lake,2004,814,,204,4920
Chilkoot Lake,2004,1061,,205,5981
Chilkoot Lake,2004,588,,206,6569
Chilkoot Lake,2004,364,,207,6933
Chilkoot Lake,2004,312,,208,7245
Chilkoot Lake,2004,623,,209,7868
Chilkoot Lake,2004,331,,210,8199
Chilkoot Lake,2004,736,,211,8935
Chilkoot Lake,2004,1286,,212,10221
Chilkoot Lake,2004,3183,,213,13404
Chilkoot Lake,2004,11521,,214,24925
Chilkoot Lake,2004,8038,,215,32963
Chilkoot Lake,2004,4611,,216,37574
Chilkoot Lake,2004,3516,,217,41090
Chilkoot Lake,2004,3438,,218,44528
Chilkoot Lake,2004,1888,,219,46416
Chilkoot Lake,2004,1838,,220,48254
Chilkoot Lake,2004,2393,,221,50647
Chilkoot Lake,2004,3436,,222,54083
Chilkoot Lake,2004,666,,223,54749
Chilkoot Lake,2004,1107,,224,55856
Chilkoot Lake,2004,1245,,225,57101
Chilkoot Lake,2004,2454,,226,59555
Chilkoot Lake,2004,1980,,227,61535
Chilkoot Lake,2004,3530,,228,65065
Chilkoot Lake,2004,2437,,229,67502
Chilkoot Lake,2004,1694,,230,69196
Chilkoot Lake,2004,1514,,231,70710
Chilkoot Lake,2004,2533,,232,73243
Chilkoot Lake,2004,2659,,233,75902
Chilkoot Lake,2004,1664,,234,77566
Chilkoot Lake,2004,1856,,235,79422
Chilkoot Lake,2004,2688,,236,82110
Chilkoot Lake,2004,2518,,237,84628
Chilkoot Lake,2004,2426,,238,87054
Chilkoot Lake,2004,2255,,239,89309
Chilkoot Lake,2004,1784,,240,91093
Chilkoot Lake,2004,2535,,241,93628
Chilkoot Lake,2004,1292,,242,94920
Chilkoot Lake,2004,1543,,243,96463
Chilkoot Lake,2004,1066,,244,97529
Chilkoot Lake,2004,1371,,245,98900
Chilkoot Lake,2004,803,,246,99703
Chilkoot Lake,2004,519,,247,100222
Chilkoot Lake,2004,393,,248,100615
Chilkoot Lake,2004,1254,,249,101869
Chilkoot Lake,2004,871,,250,102740
Chilkoot Lake,2004,1022,,251,103762
Chilkoot Lake,2004,878,,252,104640
Chilkoot Lake,2004,1052,,253,105692
Chilkoot Lake,2004,1399,,254,107091
Chilkoot Lake,2004,903,,255,107994
Chilkoot Lake,2005,1,,174,1
Chilkoot Lake,2005,4,,177,5
Chilkoot Lake,2005,13,,178,18
Chilkoot Lake,2005,8,,179,26
Chilkoot Lake,2005,5,,180,31
Chilkoot Lake,2005,2,,181,33
Chilkoot Lake,2005,3,,182,36
Chilkoot Lake,2005,8,,183,44
Chilkoot Lake,2005,9,,184,53
Chilkoot Lake,2005,4,,185,57
Chilkoot Lake,2005,1,,186,58
Chilkoot Lake,2005,14,,187,72
Chilkoot Lake,2005,17,,188,89
Chilkoot Lake,2005,21,,189,110
Chilkoot Lake,2005,41,,190,151
Chilkoot Lake,2005,302,,191,453
Chilkoot Lake,2005,142,,192,595
Chilkoot Lake,2005,59,,193,654
Chilkoot Lake,2005,25,,194,679
Chilkoot Lake,2005,275,,195,954
Chilkoot Lake,2005,179,,196,1133
Chilkoot Lake,2005,179,,197,1312
Chilkoot Lake,2005,135,,198,1447
Chilkoot Lake,2005,389,,199,1836
Chilkoot Lake,2005,540,,200,2376
Chilkoot Lake,2005,1351,,201,3727
Chilkoot Lake,2005,1254,,202,4981
Chilkoot Lake,2005,2422,,203,7403
Chilkoot Lake,2005,3050,,204,10453
Chilkoot Lake,2005,2232,,205,12685
Chilkoot Lake,2005,2961,,206,15646
Chilkoot Lake,2005,2376,,207,18022
Chilkoot Lake,2005,4000,,208,22022
Chilkoot Lake,2005,3313,,209,25335
Chilkoot Lake,2005,3700,,210,29035
Chilkoot Lake,2005,2500,,211,31535
Chilkoot Lake,2005,4114,,212,35649
Chilkoot Lake,2005,3343,,213,38992
Chilkoot Lake,2005,4006,,214,42998
Chilkoot Lake,2005,3920,,215,46918
Chilkoot Lake,2005,422,,216,47340
Chilkoot Lake,2005,352,,217,47692
Chilkoot Lake,2005,354,,218,48046
Chilkoot Lake,2005,1626,,219,49672
Chilkoot Lake,2005,1982,,220,51654
Chilkoot Lake,2005,3450,,221,55104
Chilkoot Lake,2005,3654,,222,58758
Chilkoot Lake,2005,1050,,223,59808
Chilkoot Lake,2005,893,,224,60701
Chilkoot Lake,2005,1146,,225,61847
Chilkoot Lake,2005,1802,,226,63649
Chilkoot Lake,2005,1254,,227,64903
Chilkoot Lake,2005,973,,228,65876
Chilkoot Lake,2005,873,,229,66749
Chilkoot Lake,2005,952,,230,67701
Chilkoot Lake,2005,343,,231,68044
Chilkoot Lake,2005,381,,232,68425
Chilkoot Lake,2005,646,,233,69071
Chilkoot Lake,2005,1414,,234,70485
Chilkoot Lake,2005,818,,235,71303
Chilkoot Lake,2005,850,,236,72153
Chilkoot Lake,2005,339,,237,72492
Chilkoot Lake,2005,368,,238,72860
Chilkoot Lake,2005,816,,239,73676
Chilkoot Lake,2005,1569,,240,75245
Chilkoot Lake,2005,1563,,241,76808
Chilkoot Lake,2005,955,,242,77763
Chilkoot Lake,2005,547,,243,78310
Chilkoot Lake,2005,1001,,244,79311
Chilkoot Lake,2005,1363,,245,80674
Chilkoot Lake,2005,1789,,246,82463
Chilkoot Lake,2005,2211,,247,84674
Chilkoot Lake,2005,1945,,248,86619
Chilkoot Lake,2005,753,,249,87372
Chilkoot Lake,2005,259,,250,87631
Chilkoot Lake,2005,482,,251,88113
Chilkoot Lake,2005,419,,252,88532
Chilkoot Lake,2005,523,,253,89055
Chilkoot Lake,2005,1169,,254,90224
Chilkoot Lake,2005,262,,255,90486
Chilkoot Lake,2006,1,,183,1
Chilkoot Lake,2006,6,,184,7
Chilkoot Lake,2006,5,,185,12
Chilkoot Lake,2006,17,,186,29
Chilkoot Lake,2006,18,,187,47
Chilkoot Lake,2006,33,,188,80
Chilkoot Lake,2006,65,,189,145
Chilkoot Lake,2006,95,,190,240
Chilkoot Lake,2006,112,,191,352
Chilkoot Lake,2006,131,,192,483
Chilkoot Lake,2006,240,,193,723
Chilkoot Lake,2006,284,,194,1007
Chilkoot Lake,2006,267,,195,1274
Chilkoot Lake,2006,202,,196,1476
Chilkoot Lake,2006,225,,197,1701
Chilkoot Lake,2006,188,,198,1889
Chilkoot Lake,2006,206,,199,2095
Chilkoot Lake,2006,380,,200,2475
Chilkoot Lake,2006,338,,201,2813
Chilkoot Lake,2006,696,,202,3509
Chilkoot Lake,2006,528,,203,4037
Chilkoot Lake,2006,367,,204,4404
Chilkoot Lake,2006,361,,205,4765
Chilkoot Lake,2006,330,,206,5095
Chilkoot Lake,2006,180,,207,5275
Chilkoot Lake,2006,285,,208,5560
Chilkoot Lake,2006,388,,209,5948
Chilkoot Lake,2006,420,,210,6368
Chilkoot Lake,2006,597,,211,6965
Chilkoot Lake,2006,332,,212,7297
Chilkoot Lake,2006,452,,213,7749
Chilkoot Lake,2006,557,,214,8306
Chilkoot Lake,2006,1309,,215,9615
Chilkoot Lake,2006,1220,,216,10835
Chilkoot Lake,2006,702,,217,11537
Chilkoot Lake,2006,823,,218,12360
Chilkoot Lake,2006,816,,219,13176
Chilkoot Lake,2006,1040,,220,14216
Chilkoot Lake,2006,1918,,221,16134
Chilkoot Lake,2006,891,,222,17025
Chilkoot Lake,2006,1005,,223,18030
Chilkoot Lake,2006,405,,224,18435
Chilkoot Lake,2006,1009,,225,19444
Chilkoot Lake,2006,368,,226,19812
Chilkoot Lake,2006,337,,227,20149
Chilkoot Lake,2006,596,,228,20745
Chilkoot Lake,2006,1015,,229,21760
Chilkoot Lake,2006,411,,230,22171
Chilkoot Lake,2006,458,,231,22629
Chilkoot Lake,2006,388,,232,23017
Chilkoot Lake,2006,914,,233,23931
Chilkoot Lake,2006,1546,,234,25477
Chilkoot Lake,2006,1513,,235,26990
Chilkoot Lake,2006,1444,,236,28434
Chilkoot Lake,2006,451,,237,28885
Chilkoot Lake,2006,215,,238,29100
Chilkoot Lake,2006,340,,239,29440
Chilkoot Lake,2006,448,,240,29888
Chilkoot Lake,2006,545,,241,30433
Chilkoot Lake,2006,307,,242,30740
Chilkoot Lake,2006,309,,243,31049
Chilkoot Lake,2006,47,,244,31096
Chilkoot Lake,2006,89,,245,31185
Chilkoot Lake,2006,241,,246,31426
Chilkoot Lake,2006,243,,247,31669
Chilkoot Lake,2006,226,,248,31895
Chilkoot Lake,2006,413,,249,32308
Chilkoot Lake,2006,532,,250,32840
Chilkoot Lake,2006,259,,251,33099
Chilkoot Lake,2006,133,,252,33232
Chilkoot Lake,2006,188,,253,33420
Chilkoot Lake,2006,129,,254,33549
Chilkoot Lake,2006,94,,255,33643
Chilkoot Lake,2006,245,,256,33888
Chilkoot Lake,2007,1,,188,1
Chilkoot Lake,2007,2,,190,3
Chilkoot Lake,2007,1,,191,4
Chilkoot Lake,2007,6,,192,10
Chilkoot Lake,2007,3,,193,13
Chilkoot Lake,2007,1,,194,14
Chilkoot Lake,2007,1,,197,15
Chilkoot Lake,2007,3,,199,18
Chilkoot Lake,2007,3,,200,21
Chilkoot Lake,2007,8,,201,29
Chilkoot Lake,2007,7,,202,36
Chilkoot Lake,2007,6,,203,42
Chilkoot Lake,2007,55,,204,97
Chilkoot Lake,2007,102,,205,199
Chilkoot Lake,2007,91,,206,290
Chilkoot Lake,2007,49,,207,339
Chilkoot Lake,2007,55,,208,394
Chilkoot Lake,2007,63,,209,457
Chilkoot Lake,2007,127,,210,584
Chilkoot Lake,2007,184,,211,768
Chilkoot Lake,2007,219,,212,987
Chilkoot Lake,2007,261,,213,1248
Chilkoot Lake,2007,258,,214,1506
Chilkoot Lake,2007,59,,215,1565
Chilkoot Lake,2007,73,,216,1638
Chilkoot Lake,2007,101,,217,1739
Chilkoot Lake,2007,126,,218,1865
Chilkoot Lake,2007,237,,219,2102
Chilkoot Lake,2007,856,,220,2958
Chilkoot Lake,2007,3056,,221,6014
Chilkoot Lake,2007,2918,,222,8932
Chilkoot Lake,2007,1666,,223,10598
Chilkoot Lake,2007,2248,,224,12846
Chilkoot Lake,2007,1693,,225,14539
Chilkoot Lake,2007,2604,,226,17143
Chilkoot Lake,2007,2869,,227,20012
Chilkoot Lake,2007,3962,,228,23974
Chilkoot Lake,2007,2041,,229,26015
Chilkoot Lake,2007,2030,,230,28045
Chilkoot Lake,2007,1815,,231,29860
Chilkoot Lake,2007,1904,,232,31764
Chilkoot Lake,2007,1460,,233,33224
Chilkoot Lake,2007,2935,,234,36159
Chilkoot Lake,2007,2784,,235,38943
Chilkoot Lake,2007,2080,,236,41023
Chilkoot Lake,2007,1649,,237,42672
Chilkoot Lake,2007,1811,,238,44483
Chilkoot Lake,2007,949,,239,45432
Chilkoot Lake,2007,1453,,240,46885
Chilkoot Lake,2007,2014,,241,48899
Chilkoot Lake,2007,2040,,242,50939
Chilkoot Lake,2007,1942,,243,52881
Chilkoot Lake,2007,1556,,244,54437
Chilkoot Lake,2007,1650,,245,56087
Chilkoot Lake,2007,784,,246,56871
Chilkoot Lake,2007,289,,247,57160
Chilkoot Lake,2007,201,,248,57361
Chilkoot Lake,2007,379,,249,57740
Chilkoot Lake,2007,568,,250,58308
Chilkoot Lake,2007,703,,251,59011
Chilkoot Lake,2007,738,,252,59749
Chilkoot Lake,2007,596,,253,60345
Chilkoot Lake,2007,607,,254,60952
Chilkoot Lake,2007,517,,255,61469
Chilkoot Lake,2008,1,,188,1
Chilkoot Lake,2008,1,,189,2
Chilkoot Lake,2008,5,,191,7
Chilkoot Lake,2008,4,,194,11
Chilkoot Lake,2008,3,,195,14
Chilkoot Lake,2008,5,,196,19
Chilkoot Lake,2008,29,,197,48
Chilkoot Lake,2008,12,,198,60
Chilkoot Lake,2008,1,,199,61
Chilkoot Lake,2008,7,,200,68
Chilkoot Lake,2008,7,,201,75
Chilkoot Lake,2008,4,,202,79
Chilkoot Lake,2008,14,,203,93
Chilkoot Lake,2008,23,,204,116
Chilkoot Lake,2008,33,,205,149
Chilkoot Lake,2008,58,,206,207
Chilkoot Lake,2008,68,,207,275
Chilkoot Lake,2008,82,,208,357
Chilkoot Lake,2008,200,,209,557
Chilkoot Lake,2008,686,,210,1243
Chilkoot Lake,2008,442,,211,1685
Chilkoot Lake,2008,409,,212,2094
Chilkoot Lake,2008,259,,213,2353
Chilkoot Lake,2008,193,,214,2546
Chilkoot Lake,2008,150,,215,2696
Chilkoot Lake,2008,148,,216,2844
Chilkoot Lake,2008,104,,217,2948
Chilkoot Lake,2008,202,,218,3150
Chilkoot Lake,2008,71,,219,3221
Chilkoot Lake,2008,145,,220,3366
Chilkoot Lake,2008,123,,221,3489
Chilkoot Lake,2008,145,,222,3634
Chilkoot Lake,2008,183,,223,3817
Chilkoot Lake,2008,118,,224,3935
Chilkoot Lake,2008,42,,225,3977
Chilkoot Lake,2008,21,,227,3998
Chilkoot Lake,2008,275,,228,4273
Chilkoot Lake,2008,754,,229,5027
Chilkoot Lake,2008,853,,230,5880
Chilkoot Lake,2008,945,,231,6825
Chilkoot Lake,2008,2655,,232,9480
Chilkoot Lake,2008,1031,,233,10511
Chilkoot Lake,2008,832,,234,11343
Chilkoot Lake,2008,494,,235,11837
Chilkoot Lake,2008,161,,236,11998
Chilkoot Lake,2008,38,,237,12036
Chilkoot Lake,2008,71,,238,12107
Chilkoot Lake,2008,237,,239,12344
Chilkoot Lake,2008,303,,240,12647
Chilkoot Lake,2008,526,,241,13173
Chilkoot Lake,2008,420,,242,13593
Chilkoot Lake,2008,198,,243,13791
Chilkoot Lake,2008,224,,244,14015
Chilkoot Lake,2008,171,,245,14186
Chilkoot Lake,2008,111,,246,14297
Chilkoot Lake,2008,128,,247,14425
Chilkoot Lake,2008,89,,248,14514
Chilkoot Lake,2008,88,,249,14602
Chilkoot Lake,2008,128,,250,14730
Chilkoot Lake,2008,80,,251,14810
Chilkoot Lake,2008,106,,252,14916
Chilkoot Lake,2008,32,,253,14948
Chilkoot Lake,2008,101,,254,15049
Chilkoot Lake,2008,56,,255,15105
Chilkoot Lake,2009,5,,183,5
Chilkoot Lake,2009,38,,184,43
Chilkoot Lake,2009,5,,185,48
Chilkoot Lake,2009,7,,186,55
Chilkoot Lake,2009,9,,187,64
Chilkoot Lake,2009,3,,188,67
Chilkoot Lake,2009,5,,189,72
Chilkoot Lake,2009,10,,190,82
Chilkoot Lake,2009,8,,191,90
Chilkoot Lake,2009,24,,192,114
Chilkoot Lake,2009,7,,193,121
Chilkoot Lake,2009,12,,194,133
Chilkoot Lake,2009,7,,195,140
Chilkoot Lake,2009,20,,196,160
Chilkoot Lake,2009,77,,197,237
Chilkoot Lake,2009,78,,198,315
Chilkoot Lake,2009,98,,199,413
Chilkoot Lake,2009,67,,200,480
Chilkoot Lake,2009,77,,201,557
Chilkoot Lake,2009,63,,202,620
Chilkoot Lake,2009,14,,203,634
Chilkoot Lake,2009,81,,204,715
Chilkoot Lake,2009,72,,205,787
Chilkoot Lake,2009,110,,206,897
Chilkoot Lake,2009,167,,207,1064
Chilkoot Lake,2009,901,,208,1965
Chilkoot Lake,2009,515,,209,2480
Chilkoot Lake,2009,261,,210,2741
Chilkoot Lake,2009,81,,211,2822
Chilkoot Lake,2009,103,,212,2925
Chilkoot Lake,2009,137,,213,3062
Chilkoot Lake,2009,568,,214,3630
Chilkoot Lake,2009,487,,215,4117
Chilkoot Lake,2009,1011,,216,5128
Chilkoot Lake,2009,857,,217,5985
Chilkoot Lake,2009,1392,,218,7377
Chilkoot Lake,2009,1253,,219,8630
Chilkoot Lake,2009,1376,,220,10006
Chilkoot Lake,2009,810,,221,10816
Chilkoot Lake,2009,1290,,222,12106
Chilkoot Lake,2009,1176,,223,13282
Chilkoot Lake,2009,903,,224,14185
Chilkoot Lake,2009,689,,225,14874
Chilkoot Lake,2009,373,,226,15247
Chilkoot Lake,2009,226,,227,15473
Chilkoot Lake,2009,246,,228,15719
Chilkoot Lake,2009,27,,229,15746
Chilkoot Lake,2009,27,,230,15773
Chilkoot Lake,2009,88,,231,15861
Chilkoot Lake,2009,1404,,232,17265
Chilkoot Lake,2009,3511,,233,20776
Chilkoot Lake,2009,2120,,234,22896
Chilkoot Lake,2009,2032,,235,24928
Chilkoot Lake,2009,1639,,236,26567
Chilkoot Lake,2009,836,,237,27403
Chilkoot Lake,2009,183,,238,27586
Chilkoot Lake,2009,286,,239,27872
Chilkoot Lake,2009,6,,240,27878
Chilkoot Lake,2009,111,,244,27989
Chilkoot Lake,2009,269,,245,28258
Chilkoot Lake,2009,278,,246,28536
Chilkoot Lake,2009,820,,247,29356
Chilkoot Lake,2009,1093,,248,30449
Chilkoot Lake,2009,1211,,249,31660
Chilkoot Lake,2009,730,,250,32390
Chilkoot Lake,2009,750,,251,33140
Chilkoot Lake,2009,1156,,252,34296
Chilkoot Lake,2009,187,,253,34483
Chilkoot Lake,2010,1,,189,1
Chilkoot Lake,2010,3,,190,4
Chilkoot Lake,2010,1,,191,5
Chilkoot Lake,2010,7,,193,12
Chilkoot Lake,2010,17,,194,29
Chilkoot Lake,2010,22,,195,51
Chilkoot Lake,2010,24,,196,75
Chilkoot Lake,2010,17,,197,92
Chilkoot Lake,2010,18,,198,110
Chilkoot Lake,2010,13,,199,123
Chilkoot Lake,2010,24,,200,147
Chilkoot Lake,2010,10,,201,157
Chilkoot Lake,2010,40,,202,197
Chilkoot Lake,2010,23,,203,220
Chilkoot Lake,2010,85,,204,305
Chilkoot Lake,2010,40,,205,345
Chilkoot Lake,2010,54,,206,399
Chilkoot Lake,2010,43,,207,442
Chilkoot Lake,2010,82,,208,524
Chilkoot Lake,2010,184,,209,708
Chilkoot Lake,2010,108,,210,816
Chilkoot Lake,2010,358,,211,1174
Chilkoot Lake,2010,343,,212,1517
Chilkoot Lake,2010,420,,213,1937
Chilkoot Lake,2010,606,,214,2543
Chilkoot Lake,2010,357,,215,2900
Chilkoot Lake,2010,290,,216,3190
Chilkoot Lake,2010,537,,217,3727
Chilkoot Lake,2010,224,,218,3951
Chilkoot Lake,2010,230,,219,4181
Chilkoot Lake,2010,306,,220,4487
Chilkoot Lake,2010,444,,221,4931
Chilkoot Lake,2010,601,,222,5532
Chilkoot Lake,2010,586,,223,6118
Chilkoot Lake,2010,1761,,224,7879
Chilkoot Lake,2010,3588,,225,11467
Chilkoot Lake,2010,2127,,226,13594
Chilkoot Lake,2010,1437,,227,15031
Chilkoot Lake,2010,697,,228,15728
Chilkoot Lake,2010,273,,229,16001
Chilkoot Lake,2010,455,,230,16456
Chilkoot Lake,2010,363,,231,16819
Chilkoot Lake,2010,471,,232,17290
Chilkoot Lake,2010,929,,233,18219
Chilkoot Lake,2010,1295,,234,19514
Chilkoot Lake,2010,465,,235,19979
Chilkoot Lake,2010,845,,236,20824
Chilkoot Lake,2010,1525,,237,22349
Chilkoot Lake,2010,1263,,238,23612
Chilkoot Lake,2010,865,,239,24477
Chilkoot Lake,2010,585,,240,25062
Chilkoot Lake,2010,601,,241,25663
Chilkoot Lake,2010,609,,242,26272
Chilkoot Lake,2010,700,,243,26972
Chilkoot Lake,2010,239,,244,27211
Chilkoot Lake,2010,457,,245,27668
Chilkoot Lake,2010,433,,246,28101
Chilkoot Lake,2010,267,,247,28368
Chilkoot Lake,2010,247,,248,28615
Chilkoot Lake,2010,544,,249,29159
Chilkoot Lake,2010,374,,250,29533
Chilkoot Lake,2010,292,,251,29825
Chilkoot Lake,2010,255,,252,30080
Chilkoot Lake,2010,179,,253,30259
Chilkoot Lake,2010,151,,254,30410
Chilkoot Lake,2010,147,,255,30557
Chilkoot Lake,2010,167,,256,30724
Chilkoot Lake,2010,106,,257,30830
Chilkoot Lake,2011,1,,184,1
Chilkoot Lake,2011,4,,185,5
Chilkoot Lake,2011,13,,186,18
Chilkoot Lake,2011,6,,187,24
Chilkoot Lake,2011,2,,188,26
Chilkoot Lake,2011,11,,189,37
Chilkoot Lake,2011,12,,190,49
Chilkoot Lake,2011,20,,191,69
Chilkoot Lake,2011,15,,192,84
Chilkoot Lake,2011,41,,193,125
Chilkoot Lake,2011,93,,194,218
Chilkoot Lake,2011,149,,195,367
Chilkoot Lake,2011,87,,196,454
Chilkoot Lake,2011,210,,197,664
Chilkoot Lake,2011,101,,198,765
Chilkoot Lake,2011,30,,199,795
Chilkoot Lake,2011,62,,200,857
Chilkoot Lake,2011,121,,201,978
Chilkoot Lake,2011,141,,202,1119
Chilkoot Lake,2011,136,,203,1255
Chilkoot Lake,2011,182,,204,1437
Chilkoot Lake,2011,83,,205,1520
Chilkoot Lake,2011,97,,206,1617
Chilkoot Lake,2011,122,,207,1739
Chilkoot Lake,2011,59,,208,1798
Chilkoot Lake,2011,99,,209,1897
Chilkoot Lake,2011,102,,210,1999
Chilkoot Lake,2011,181,,211,2180
Chilkoot Lake,2011,514,,212,2694
Chilkoot Lake,2011,148,,213,2842
Chilkoot Lake,2011,333,,214,3175
Chilkoot Lake,2011,126,,215,3301
Chilkoot Lake,2011,120,,216,3421
Chilkoot Lake,2011,126,,217,3547
Chilkoot Lake,2011,323,,218,3870
Chilkoot Lake,2011,402,,219,4272
Chilkoot Lake,2011,377,,220,4649
Chilkoot Lake,2011,1343,,221,5992
Chilkoot Lake,2011,1780,,222,7772
Chilkoot Lake,2011,948,,223,8720
Chilkoot Lake,2011,5302,,224,14022
Chilkoot Lake,2011,6236,,225,20258
Chilkoot Lake,2011,7026,,226,27284
Chilkoot Lake,2011,6574,,227,33858
Chilkoot Lake,2011,1710,,228,35568
Chilkoot Lake,2011,5941,,229,41509
Chilkoot Lake,2011,4682,,230,46191
Chilkoot Lake,2011,1365,,231,47556
Chilkoot Lake,2011,247,,232,47803
Chilkoot Lake,2011,34,,233,47837
Chilkoot Lake,2011,15,,234,47852
Chilkoot Lake,2011,27,,235,47879
Chilkoot Lake,2011,42,,236,47921
Chilkoot Lake,2011,908,,237,48829
Chilkoot Lake,2011,1699,,238,50528
Chilkoot Lake,2011,2261,,239,52789
Chilkoot Lake,2011,3127,,240,55916
Chilkoot Lake,2011,5189,,241,61105
Chilkoot Lake,2011,4235,,242,65340
Chilkoot Lake,2011,2513,,243,67853
Chilkoot Lake,2011,3093,,244,70946
Chilkoot Lake,2011,2500,,245,73446
Chilkoot Lake,2011,1300,,246,74746
Chilkoot Lake,2011,888,,247,75634
Chilkoot Lake,2011,610,,248,76244
Chilkoot Lake,2012,7,,186,7
Chilkoot Lake,2012,12,,187,19
Chilkoot Lake,2012,8,,188,27
Chilkoot Lake,2012,3,,189,30
Chilkoot Lake,2012,21,,190,51
Chilkoot Lake,2012,4,,191,55
Chilkoot Lake,2012,4,,192,59
Chilkoot Lake,2012,2,,193,61
Chilkoot Lake,2012,18,,194,79
Chilkoot Lake,2012,11,,195,90
Chilkoot Lake,2012,33,,196,123
Chilkoot Lake,2012,76,,197,199
Chilkoot Lake,2012,54,,198,253
Chilkoot Lake,2012,60,,199,313
Chilkoot Lake,2012,58,,200,371
Chilkoot Lake,2012,181,,201,552
Chilkoot Lake,2012,44,,202,596
Chilkoot Lake,2012,71,,203,667
Chilkoot Lake,2012,69,,204,736
Chilkoot Lake,2012,175,,205,911
Chilkoot Lake,2012,125,,206,1036
Chilkoot Lake,2012,63,,207,1099
Chilkoot Lake,2012,125,,208,1224
Chilkoot Lake,2012,45,,209,1269
Chilkoot Lake,2012,147,,210,1416
Chilkoot Lake,2012,228,,211,1644
Chilkoot Lake,2012,303,,212,1947
Chilkoot Lake,2012,376,,213,2323
Chilkoot Lake,2012,67,,214,2390
Chilkoot Lake,2012,197,,215,2587
Chilkoot Lake,2012,181,,216,2768
Chilkoot Lake,2012,289,,217,3057
Chilkoot Lake,2012,707,,218,3764
Chilkoot Lake,2012,889,,219,4653
Chilkoot Lake,2012,588,,220,5241
Chilkoot Lake,2012,338,,221,5579
Chilkoot Lake,2012,489,,222,6068
Chilkoot Lake,2012,663,,223,6731
Chilkoot Lake,2012,466,,224,7197
Chilkoot Lake,2012,571,,225,7768
Chilkoot Lake,2012,679,,226,8447
Chilkoot Lake,2012,2263,,227,10710
Chilkoot Lake,2012,2643,,228,13353
Chilkoot Lake,2012,2495,,229,15848
Chilkoot Lake,2012,1559,,230,17407
Chilkoot Lake,2012,1631,,231,19038
Chilkoot Lake,2012,1965,,232,21003
Chilkoot Lake,2012,1739,,233,22742
Chilkoot Lake,2012,1856,,234,24598
Chilkoot Lake,2012,2034,,235,26632
Chilkoot Lake,2012,1094,,236,27726
Chilkoot Lake,2012,808,,237,28534
Chilkoot Lake,2012,1290,,238,29824
Chilkoot Lake,2012,901,,239,30725
Chilkoot Lake,2012,666,,240,31391
Chilkoot Lake,2012,1193,,241,32584
Chilkoot Lake,2012,598,,242,33182
Chilkoot Lake,2012,436,,243,33618
Chilkoot Lake,2012,764,,244,34382
Chilkoot Lake,2012,623,,245,35005
Chilkoot Lake,2012,1378,,246,36383
Chilkoot Lake,2012,668,,247,37051
Chilkoot Lake,2012,521,,248,37572
Chilkoot Lake,2012,365,,249,37937
Chilkoot Lake,2012,441,,250,38378
Chilkoot Lake,2012,466,,251,38844
Chilkoot Lake,2012,629,,252,39473
Chilkoot Lake,2012,538,,253,40011
Chilkoot Lake,2012,505,,254,40516
Chilkoot Lake,2012,237,,255,40753
Auke Creek,1971,2,,224,2
Auke Creek,1971,7,,225,9
Auke Creek,1971,8,,226,17
Auke Creek,1971,53,,227,70
Auke Creek,1971,223,,228,293
Auke Creek,1971,41,,229,334
Auke Creek,1971,6,,230,340
Auke Creek,1971,13,,231,353
Auke Creek,1971,94,,232,447
Auke Creek,1971,9,,233,456
Auke Creek,1971,13,,235,469
Auke Creek,1971,6,,236,475
Auke Creek,1971,3,,237,478
Auke Creek,1971,20,,238,498
Auke Creek,1971,8,,240,506
Auke Creek,1971,9,,243,515
Auke Creek,1971,17,,244,532
Auke Creek,1971,41,,245,573
Auke Creek,1971,85,,246,658
Auke Creek,1971,61,,247,719
Auke Creek,1971,77,,248,796
Auke Creek,1971,50,,249,846
Auke Creek,1971,59,,250,905
Auke Creek,1971,91,,251,996
Auke Creek,1971,42,,253,1038
Auke Creek,1971,70,,254,1108
Auke Creek,1971,59,,256,1167
Auke Creek,1971,82,,257,1249
Auke Creek,1971,219,,258,1468
Auke Creek,1971,33,,259,1501
Auke Creek,1971,272,,260,1773
Auke Creek,1971,83,,261,1856
Auke Creek,1971,62,,262,1918
Auke Creek,1971,73,,263,1991
Auke Creek,1971,36,,264,2027
Auke Creek,1971,57,,265,2084
Auke Creek,1971,24,,266,2108
Auke Creek,1971,9,,267,2117
Auke Creek,1971,2,,268,2119
Auke Creek,1971,17,,269,2136
Auke Creek,1971,12,,271,2148
Auke Creek,1971,10,,272,2158
Auke Creek,1971,10,,273,2168
Auke Creek,1971,14,,274,2182
Auke Creek,1971,1,,275,2183
Auke Creek,1971,1,,277,2184
Auke Creek,1971,1,,278,2185
Auke Creek,1972,14,,216,14
Auke Creek,1972,4,,217,18
Auke Creek,1972,38,,218,56
Auke Creek,1972,16,,219,72
Auke Creek,1972,37,,220,109
Auke Creek,1972,24,,221,133
Auke Creek,1972,55,,222,188
Auke Creek,1972,18,,223,206
Auke Creek,1972,4,,224,210
Auke Creek,1972,2,,225,212
Auke Creek,1972,15,,226,227
Auke Creek,1972,18,,227,245
Auke Creek,1972,15,,228,260
Auke Creek,1972,27,,229,287
Auke Creek,1972,15,,230,302
Auke Creek,1972,2,,231,304
Auke Creek,1972,12,,232,316
Auke Creek,1972,9,,233,325
Auke Creek,1972,3,,234,328
Auke Creek,1972,12,,235,340
Auke Creek,1972,35,,236,375
Auke Creek,1972,41,,237,416
Auke Creek,1972,39,,238,455
Auke Creek,1972,29,,239,484
Auke Creek,1972,24,,240,508
Auke Creek,1972,35,,241,543
Auke Creek,1972,37,,242,580
Auke Creek,1972,73,,243,653
Auke Creek,1972,158,,244,811
Auke Creek,1972,99,,245,910
Auke Creek,1972,67,,246,977
Auke Creek,1972,50,,248,1027
Auke Creek,1972,26,,249,1053
Auke Creek,1972,356,,250,1409
Auke Creek,1972,27,,251,1436
Auke Creek,1972,29,,254,1465
Auke Creek,1972,25,,255,1490
Auke Creek,1972,90,,256,1580
Auke Creek,1972,113,,257,1693
Auke Creek,1972,14,,259,1707
Auke Creek,1972,19,,260,1726
Auke Creek,1972,4,,261,1730
Auke Creek,1972,6,,262,1736
Auke Creek,1972,1,,263,1737
Auke Creek,1972,1,,264,1738
Auke Creek,1972,1,,274,1739
Auke Creek,1973,57,,201,57
Auke Creek,1973,31,,202,88
Auke Creek,1973,2,,203,90
Auke Creek,1973,2,,208,92
Auke Creek,1973,2,,209,94
Auke Creek,1973,103,,211,197
Auke Creek,1973,304,,212,501
Auke Creek,1973,257,,213,758
Auke Creek,1973,17,,214,775
Auke Creek,1973,326,,215,1101
Auke Creek,1973,301,,216,1402
Auke Creek,1973,158,,217,1560
Auke Creek,1973,60,,218,1620
Auke Creek,1973,46,,219,1666
Auke Creek,1973,45,,220,1711
Auke Creek,1973,12,,221,1723
Auke Creek,1973,5,,222,1728
Auke Creek,1973,57,,223,1785
Auke Creek,1973,183,,224,1968
Auke Creek,1973,83,,225,2051
Auke Creek,1973,52,,226,2103
Auke Creek,1973,16,,227,2119
Auke Creek,1973,1,,228,2120
Auke Creek,1973,4,,229,2124
Auke Creek,1973,1,,233,2125
Auke Creek,1973,7,,236,2132
Auke Creek,1973,12,,237,2144
Auke Creek,1973,23,,238,2167
Auke Creek,1973,27,,239,2194
Auke Creek,1973,97,,240,2291
Auke Creek,1973,219,,241,2510
Auke Creek,1973,152,,242,2662
Auke Creek,1973,46,,243,2708
Auke Creek,1973,262,,244,2970
Auke Creek,1973,304,,245,3274
Auke Creek,1973,260,,246,3534
Auke Creek,1973,163,,247,3697
Auke Creek,1973,100,,248,3797
Auke Creek,1973,200,,249,3997
Auke Creek,1973,153,,250,4150
Auke Creek,1973,194,,251,4344
Auke Creek,1973,131,,252,4475
Auke Creek,1973,71,,253,4546
Auke Creek,1973,381,,254,4927
Auke Creek,1973,4,,255,4931
Auke Creek,1973,10,,256,4941
Auke Creek,1973,7,,257,4948
Auke Creek,1974,2,,205,2
Auke Creek,1974,1,,210,3
Auke Creek,1974,18,,217,21
Auke Creek,1974,73,,218,94
Auke Creek,1974,25,,219,119
Auke Creek,1974,30,,220,149
Auke Creek,1974,6,,221,155
Auke Creek,1974,1,,224,156
Auke Creek,1974,5,,225,161
Auke Creek,1974,4,,226,165
Auke Creek,1974,2,,227,167
Auke Creek,1974,170,,228,337
Auke Creek,1974,17,,231,354
Auke Creek,1974,2,,232,356
Auke Creek,1974,5,,234,361
Auke Creek,1974,137,,235,498
Auke Creek,1974,463,,236,961
Auke Creek,1974,554,,237,1515
Auke Creek,1974,101,,238,1616
Auke Creek,1974,103,,239,1719
Auke Creek,1974,77,,240,1796
Auke Creek,1974,341,,242,2137
Auke Creek,1974,49,,243,2186
Auke Creek,1974,2,,244,2188
Auke Creek,1974,13,,245,2201
Auke Creek,1974,1,,246,2202
Auke Creek,1974,7,,247,2209
Auke Creek,1974,2,,248,2211
Auke Creek,1974,22,,249,2233
Auke Creek,1974,29,,251,2262
Auke Creek,1974,236,,252,2498
Auke Creek,1974,26,,253,2524
Auke Creek,1974,50,,254,2574
Auke Creek,1974,210,,255,2784
Auke Creek,1974,1467,,256,4251
Auke Creek,1974,852,,257,5103
Auke Creek,1974,212,,258,5315
Auke Creek,1974,270,,259,5585
Auke Creek,1974,71,,260,5656
Auke Creek,1974,93,,261,5749
Auke Creek,1974,62,,263,5811
Auke Creek,1974,3,,264,5814
Auke Creek,1974,15,,265,5829
Auke Creek,1974,312,,266,6141
Auke Creek,1974,14,,268,6155
Auke Creek,1974,8,,269,6163
Auke Creek,1974,3,,270,6166
Auke Creek,1974,2,,275,6168
Auke Creek,1974,87,,353,6255
Auke Creek,1975,1,,183,1
Auke Creek,1975,1,,184,2
Auke Creek,1975,2,,207,4
Auke Creek,1975,69,,208,73
Auke Creek,1975,2,,209,75
Auke Creek,1975,69,,210,144
Auke Creek,1975,91,,211,235
Auke Creek,1975,153,,212,388
Auke Creek,1975,294,,213,682
Auke Creek,1975,95,,214,777
Auke Creek,1975,31,,215,808
Auke Creek,1975,64,,216,872
Auke Creek,1975,74,,217,946
Auke Creek,1975,123,,218,1069
Auke Creek,1975,53,,219,1122
Auke Creek,1975,751,,220,1873
Auke Creek,1975,34,,221,1907
Auke Creek,1975,70,,222,1977
Auke Creek,1975,87,,223,2064
Auke Creek,1975,87,,224,2151
Auke Creek,1975,42,,225,2193
Auke Creek,1975,472,,226,2665
Auke Creek,1975,37,,227,2702
Auke Creek,1975,23,,228,2725
Auke Creek,1975,28,,229,2753
Auke Creek,1975,10,,230,2763
Auke Creek,1975,24,,231,2787
Auke Creek,1975,459,,232,3246
Auke Creek,1975,207,,233,3453
Auke Creek,1975,57,,234,3510
Auke Creek,1975,19,,235,3529
Auke Creek,1975,8,,236,3537
Auke Creek,1975,19,,237,3556
Auke Creek,1975,4,,238,3560
Auke Creek,1975,3,,239,3563
Auke Creek,1975,6,,240,3569
Auke Creek,1975,33,,241,3602
Auke Creek,1975,13,,242,3615
Auke Creek,1975,13,,243,3628
Auke Creek,1975,383,,244,4011
Auke Creek,1975,1248,,245,5259
Auke Creek,1975,1545,,246,6804
Auke Creek,1975,946,,247,7750
Auke Creek,1975,1331,,248,9081
Auke Creek,1975,472,,249,9553
Auke Creek,1975,538,,250,10091
Auke Creek,1975,400,,251,10491
Auke Creek,1975,714,,252,11205
Auke Creek,1975,419,,253,11624
Auke Creek,1975,216,,254,11840
Auke Creek,1975,765,,255,12605
Auke Creek,1975,294,,256,12899
Auke Creek,1975,310,,257,13209
Auke Creek,1975,290,,258,13499
Auke Creek,1975,137,,259,13636
Auke Creek,1975,17,,260,13653
Auke Creek,1975,34,,261,13687
Auke Creek,1975,424,,262,14111
Auke Creek,1975,52,,263,14163
Auke Creek,1975,6,,265,14169
Auke Creek,1975,4,,266,14173
Auke Creek,1975,3,,267,14176
Auke Creek,1975,6,,268,14182
Auke Creek,1976,3,,223,3
Auke Creek,1976,3,,224,6
Auke Creek,1976,7,,225,13
Auke Creek,1976,2,,226,15
Auke Creek,1976,3,,227,18
Auke Creek,1976,4,,229,22
Auke Creek,1976,3,,230,25
Auke Creek,1976,14,,231,39
Auke Creek,1976,77,,232,116
Auke Creek,1976,55,,233,171
Auke Creek,1976,44,,234,215
Auke Creek,1976,30,,235,245
Auke Creek,1976,249,,236,494
Auke Creek,1976,46,,238,540
Auke Creek,1976,6,,239,546
Auke Creek,1976,87,,240,633
Auke Creek,1976,108,,241,741
Auke Creek,1976,182,,242,923
Auke Creek,1976,101,,244,1024
Auke Creek,1976,61,,245,1085
Auke Creek,1976,9,,247,1094
Auke Creek,1976,5,,248,1099
Auke Creek,1976,12,,249,1111
Auke Creek,1976,199,,250,1310
Auke Creek,1976,14,,251,1324
Auke Creek,1976,353,,252,1677
Auke Creek,1976,125,,253,1802
Auke Creek,1976,44,,254,1846
Auke Creek,1976,15,,255,1861
Auke Creek,1976,22,,256,1883
Auke Creek,1976,224,,257,2107
Auke Creek,1976,209,,258,2316
Auke Creek,1976,102,,259,2418
Auke Creek,1976,21,,260,2439
Auke Creek,1976,29,,261,2468
Auke Creek,1976,8,,262,2476
Auke Creek,1976,22,,263,2498
Auke Creek,1976,8,,264,2506
Auke Creek,1976,4,,265,2510
Auke Creek,1976,7,,266,2517
Auke Creek,1976,4,,269,2521
Auke Creek,1976,2,,270,2523
Auke Creek,1976,1,,273,2524
Auke Creek,1977,2,,196,2
Auke Creek,1977,17,,197,19
Auke Creek,1977,3,,198,22
Auke Creek,1977,1,,203,23
Auke Creek,1977,1,,206,24
Auke Creek,1977,63,,208,87
Auke Creek,1977,3,,209,90
Auke Creek,1977,2,,213,92
Auke Creek,1977,3,,214,95
Auke Creek,1977,15,,215,110
Auke Creek,1977,2,,216,112
Auke Creek,1977,12,,217,124
Auke Creek,1977,11,,218,135
Auke Creek,1977,14,,219,149
Auke Creek,1977,44,,220,193
Auke Creek,1977,27,,221,220
Auke Creek,1977,108,,222,328
Auke Creek,1977,286,,223,614
Auke Creek,1977,524,,224,1138
Auke Creek,1977,202,,225,1340
Auke Creek,1977,122,,226,1462
Auke Creek,1977,54,,227,1516
Auke Creek,1977,49,,228,1565
Auke Creek,1977,58,,229,1623
Auke Creek,1977,13,,230,1636
Auke Creek,1977,12,,231,1648
Auke Creek,1977,12,,232,1660
Auke Creek,1977,19,,233,1679
Auke Creek,1977,6,,234,1685
Auke Creek,1977,43,,235,1728
Auke Creek,1977,330,,236,2058
Auke Creek,1977,450,,237,2508
Auke Creek,1977,486,,238,2994
Auke Creek,1977,1380,,239,4374
Auke Creek,1977,792,,240,5166
Auke Creek,1977,606,,241,5772
Auke Creek,1977,349,,242,6121
Auke Creek,1977,152,,243,6273
Auke Creek,1977,109,,244,6382
Auke Creek,1977,78,,245,6460
Auke Creek,1977,62,,246,6522
Auke Creek,1977,130,,247,6652
Auke Creek,1977,24,,248,6676
Auke Creek,1977,223,,249,6899
Auke Creek,1977,279,,250,7178
Auke Creek,1977,3002,,251,10180
Auke Creek,1977,2137,,252,12317
Auke Creek,1977,1101,,253,13418
Auke Creek,1977,1402,,254,14820
Auke Creek,1977,247,,256,15067
Auke Creek,1977,320,,257,15387
Auke Creek,1977,70,,258,15457
Auke Creek,1977,68,,259,15525
Auke Creek,1977,57,,260,15582
Auke Creek,1977,43,,261,15625
Auke Creek,1977,104,,262,15729
Auke Creek,1977,27,,263,15756
Auke Creek,1977,16,,264,15772
Auke Creek,1977,92,,265,15864
Auke Creek,1977,12,,266,15876
Auke Creek,1977,3,,267,15879
Auke Creek,1977,2,,268,15881
Auke Creek,1977,1,,274,15882
Auke Creek,1978,3,,220,3
Auke Creek,1978,15,,222,18
Auke Creek,1978,25,,223,43
Auke Creek,1978,10,,224,53
Auke Creek,1978,17,,226,70
Auke Creek,1978,4,,227,74
Auke Creek,1978,4,,228,78
Auke Creek,1978,24,,229,102
Auke Creek,1978,106,,230,208
Auke Creek,1978,34,,231,242
Auke Creek,1978,23,,232,265
Auke Creek,1978,92,,233,357
Auke Creek,1978,133,,234,490
Auke Creek,1978,147,,235,637
Auke Creek,1978,178,,236,815
Auke Creek,1978,122,,237,937
Auke Creek,1978,166,,238,1103
Auke Creek,1978,19,,239,1122
Auke Creek,1978,17,,240,1139
Auke Creek,1978,23,,241,1162
Auke Creek,1978,34,,242,1196
Auke Creek,1978,51,,243,1247
Auke Creek,1978,89,,244,1336
Auke Creek,1978,171,,245,1507
Auke Creek,1978,174,,246,1681
Auke Creek,1978,116,,247,1797
Auke Creek,1978,337,,248,2134
Auke Creek,1978,1501,,249,3635
Auke Creek,1978,809,,250,4444
Auke Creek,1978,848,,251,5292
Auke Creek,1978,455,,252,5747
Auke Creek,1978,320,,253,6067
Auke Creek,1978,616,,254,6683
Auke Creek,1978,393,,255,7076
Auke Creek,1978,692,,256,7768
Auke Creek,1978,478,,257,8246
Auke Creek,1978,1280,,258,9526
Auke Creek,1978,2392,,259,11918
Auke Creek,1978,865,,260,12783
Auke Creek,1978,1005,,261,13788
Auke Creek,1978,3203,,262,16991
Auke Creek,1978,1277,,263,18268
Auke Creek,1978,40,,264,18308
Auke Creek,1978,26,,265,18334
Auke Creek,1978,21,,266,18355
Auke Creek,1978,32,,267,18387
Auke Creek,1978,9,,269,18396
Auke Creek,1978,9,,270,18405
Auke Creek,1979,1,,198,1
Auke Creek,1979,4,,199,5
Auke Creek,1979,1,,200,6
Auke Creek,1979,11,,201,17
Auke Creek,1979,160,,202,177
Auke Creek,1979,52,,203,229
Auke Creek,1979,31,,204,260
Auke Creek,1979,58,,205,318
Auke Creek,1979,52,,206,370
Auke Creek,1979,98,,207,468
Auke Creek,1979,12,,208,480
Auke Creek,1979,5,,212,485
Auke Creek,1979,1325,,213,1810
Auke Creek,1979,1256,,214,3066
Auke Creek,1979,279,,215,3345
Auke Creek,1979,225,,216,3570
Auke Creek,1979,88,,217,3658
Auke Creek,1979,171,,218,3829
Auke Creek,1979,98,,219,3927
Auke Creek,1979,71,,220,3998
Auke Creek,1979,59,,221,4057
Auke Creek,1979,67,,222,4124
Auke Creek,1979,25,,223,4149
Auke Creek,1979,26,,224,4175
Auke Creek,1979,29,,225,4204
Auke Creek,1979,53,,226,4257
Auke Creek,1979,23,,227,4280
Auke Creek,1979,49,,228,4329
Auke Creek,1979,47,,229,4376
Auke Creek,1979,37,,230,4413
Auke Creek,1979,21,,231,4434
Auke Creek,1979,65,,232,4499
Auke Creek,1979,18,,233,4517
Auke Creek,1979,26,,234,4543
Auke Creek,1979,249,,235,4792
Auke Creek,1979,70,,236,4862
Auke Creek,1979,39,,237,4901
Auke Creek,1979,13,,238,4914
Auke Creek,1979,30,,239,4944
Auke Creek,1979,74,,240,5018
Auke Creek,1979,102,,241,5120
Auke Creek,1979,57,,242,5177
Auke Creek,1979,150,,243,5327
Auke Creek,1979,138,,244,5465
Auke Creek,1979,106,,245,5571
Auke Creek,1979,262,,246,5833
Auke Creek,1979,250,,247,6083
Auke Creek,1979,296,,248,6379
Auke Creek,1979,346,,249,6725
Auke Creek,1979,254,,250,6979
Auke Creek,1979,246,,251,7225
Auke Creek,1979,209,,252,7434
Auke Creek,1979,68,,253,7502
Auke Creek,1979,1680,,254,9182
Auke Creek,1979,3114,,255,12296
Auke Creek,1979,3345,,256,15641
Auke Creek,1979,884,,257,16525
Auke Creek,1979,278,,258,16803
Auke Creek,1979,147,,259,16950
Auke Creek,1979,252,,260,17202
Auke Creek,1979,113,,261,17315
Auke Creek,1979,390,,262,17705
Auke Creek,1979,47,,263,17752
Auke Creek,1979,24,,264,17776
Auke Creek,1979,197,,265,17973
Auke Creek,1979,5,,266,17978
Auke Creek,1979,111,,267,18089
Auke Creek,1979,58,,268,18147
Auke Creek,1979,4,,269,18151
Auke Creek,1980,193,,196,193
Auke Creek,1980,3,,205,196
Auke Creek,1980,3,,211,199
Auke Creek,1980,13,,213,212
Auke Creek,1980,38,,225,250
Auke Creek,1980,76,,226,326
Auke Creek,1980,135,,227,461
Auke Creek,1980,40,,228,501
Auke Creek,1980,194,,229,695
Auke Creek,1980,504,,230,1199
Auke Creek,1980,654,,231,1853
Auke Creek,1980,95,,232,1948
Auke Creek,1980,98,,233,2046
Auke Creek,1980,13,,234,2059
Auke Creek,1980,109,,235,2168
Auke Creek,1980,140,,236,2308
Auke Creek,1980,105,,237,2413
Auke Creek,1980,34,,238,2447
Auke Creek,1980,25,,239,2472
Auke Creek,1980,27,,240,2499
Auke Creek,1980,54,,241,2553
Auke Creek,1980,88,,243,2641
Auke Creek,1980,122,,244,2763
Auke Creek,1980,533,,245,3296
Auke Creek,1980,1733,,246,5029
Auke Creek,1980,4423,,247,9452
Auke Creek,1980,2225,,248,11677
Auke Creek,1980,658,,249,12335
Auke Creek,1980,317,,250,12652
Auke Creek,1980,1153,,251,13805
Auke Creek,1980,2332,,252,16137
Auke Creek,1980,957,,253,17094
Auke Creek,1980,405,,254,17499
Auke Creek,1980,205,,255,17704
Auke Creek,1980,272,,256,17976
Auke Creek,1980,415,,257,18391
Auke Creek,1980,315,,258,18706
Auke Creek,1980,535,,259,19241
Auke Creek,1980,726,,260,19967
Auke Creek,1980,218,,261,20185
Auke Creek,1980,73,,262,20258
Auke Creek,1980,35,,264,20293
Auke Creek,1980,48,,265,20341
Auke Creek,1980,31,,266,20372
Auke Creek,1980,6,,267,20378
Auke Creek,1980,2,,268,20380
Auke Creek,1980,1,,269,20381
Auke Creek,1981,278,,208,278
Auke Creek,1981,128,,209,406
Auke Creek,1981,79,,210,485
Auke Creek,1981,62,,211,547
Auke Creek,1981,8,,212,555
Auke Creek,1981,94,,215,649
Auke Creek,1981,705,,216,1354
Auke Creek,1981,389,,217,1743
Auke Creek,1981,177,,218,1920
Auke Creek,1981,69,,219,1989
Auke Creek,1981,26,,220,2015
Auke Creek,1981,22,,228,2037
Auke Creek,1981,30,,229,2067
Auke Creek,1981,50,,230,2117
Auke Creek,1981,117,,232,2234
Auke Creek,1981,350,,233,2584
Auke Creek,1981,243,,234,2827
Auke Creek,1981,134,,235,2961
Auke Creek,1981,94,,236,3055
Auke Creek,1981,57,,237,3112
Auke Creek,1981,46,,238,3158
Auke Creek,1981,61,,239,3219
Auke Creek,1981,77,,240,3296
Auke Creek,1981,79,,241,3375
Auke Creek,1981,60,,242,3435
Auke Creek,1981,168,,243,3603
Auke Creek,1981,35,,244,3638
Auke Creek,1981,40,,245,3678
Auke Creek,1981,98,,246,3776
Auke Creek,1981,174,,247,3950
Auke Creek,1981,1164,,248,5114
Auke Creek,1981,2131,,249,7245
Auke Creek,1981,2807,,250,10052
Auke Creek,1981,1581,,251,11633
Auke Creek,1981,751,,252,12384
Auke Creek,1981,706,,253,13090
Auke Creek,1981,411,,254,13501
Auke Creek,1981,359,,255,13860
Auke Creek,1981,239,,256,14099
Auke Creek,1981,99,,257,14198
Auke Creek,1981,103,,258,14301
Auke Creek,1981,109,,259,14410
Auke Creek,1981,49,,260,14459
Auke Creek,1981,54,,261,14513
Auke Creek,1981,53,,262,14566
Auke Creek,1981,42,,264,14608
Auke Creek,1981,42,,265,14650
Auke Creek,1981,9,,266,14659
Auke Creek,1981,1,,274,14660
Auke Creek,1982,73,,222,73
Auke Creek,1982,17,,223,90
Auke Creek,1982,13,,224,103
Auke Creek,1982,125,,228,228
Auke Creek,1982,22,,229,250
Auke Creek,1982,118,,230,368
Auke Creek,1982,59,,231,427
Auke Creek,1982,58,,232,485
Auke Creek,1982,195,,235,680
Auke Creek,1982,380,,236,1060
Auke Creek,1982,545,,237,1605
Auke Creek,1982,1375,,238,2980
Auke Creek,1982,1720,,239,4700
Auke Creek,1982,526,,240,5226
Auke Creek,1982,13,,241,5239
Auke Creek,1982,567,,242,5806
Auke Creek,1982,588,,243,6394
Auke Creek,1982,634,,244,7028
Auke Creek,1982,1191,,245,8219
Auke Creek,1982,401,,246,8620
Auke Creek,1982,224,,250,8844
Auke Creek,1982,143,,251,8987
Auke Creek,1982,80,,252,9067
Auke Creek,1982,96,,253,9163
Auke Creek,1982,157,,254,9320
Auke Creek,1982,116,,255,9436
Auke Creek,1982,69,,256,9505
Auke Creek,1982,161,,257,9666
Auke Creek,1982,579,,258,10245
Auke Creek,1982,79,,259,10324
Auke Creek,1982,68,,260,10392
Auke Creek,1982,101,,262,10493
Auke Creek,1982,38,,263,10531
Auke Creek,1982,40,,264,10571
Auke Creek,1982,28,,265,10599
Auke Creek,1982,32,,266,10631
Auke Creek,1982,25,,267,10656
Auke Creek,1982,6,,268,10662
Auke Creek,1982,2,,271,10664
Auke Creek,1982,1,,272,10665
Auke Creek,1983,1,,202,1
Auke Creek,1983,2,,203,3
Auke Creek,1983,1,,205,4
Auke Creek,1983,3,,209,7
Auke Creek,1983,4,,210,11
Auke Creek,1983,10,,211,21
Auke Creek,1983,7,,212,28
Auke Creek,1983,45,,213,73
Auke Creek,1983,296,,214,369
Auke Creek,1983,147,,215,516
Auke Creek,1983,301,,216,817
Auke Creek,1983,118,,217,935
Auke Creek,1983,251,,218,1186
Auke Creek,1983,796,,219,1982
Auke Creek,1983,1434,,220,3416
Auke Creek,1983,595,,221,4011
Auke Creek,1983,718,,222,4729
Auke Creek,1983,2460,,223,7189
Auke Creek,1983,1042,,224,8231
Auke Creek,1983,358,,225,8589
Auke Creek,1983,233,,226,8822
Auke Creek,1983,2280,,227,11102
Auke Creek,1983,374,,228,11476
Auke Creek,1983,924,,229,12400
Auke Creek,1983,218,,230,12618
Auke Creek,1983,558,,231,13176
Auke Creek,1983,160,,233,13336
Auke Creek,1983,1125,,234,14461
Auke Creek,1983,1296,,235,15757
Auke Creek,1983,1159,,236,16916
Auke Creek,1983,253,,237,17169
Auke Creek,1983,446,,238,17615
Auke Creek,1983,42,,239,17657
Auke Creek,1983,564,,241,18221
Auke Creek,1983,257,,242,18478
Auke Creek,1983,105,,243,18583
Auke Creek,1983,116,,244,18699
Auke Creek,1983,387,,245,19086
Auke Creek,1983,1328,,246,20414
Auke Creek,1983,357,,247,20771
Auke Creek,1983,75,,248,20846
Auke Creek,1983,325,,249,21171
Auke Creek,1983,213,,250,21384
Auke Creek,1983,469,,251,21853
Auke Creek,1983,246,,252,22099
Auke Creek,1983,121,,253,22220
Auke Creek,1983,141,,254,22361
Auke Creek,1983,140,,255,22501
Auke Creek,1983,158,,256,22659
Auke Creek,1983,163,,257,22822
Auke Creek,1983,330,,258,23152
Auke Creek,1983,278,,259,23430
Auke Creek,1983,227,,260,23657
Auke Creek,1983,216,,261,23873
Auke Creek,1983,140,,262,24013
Auke Creek,1983,601,,263,24614
Auke Creek,1983,117,,264,24731
Auke Creek,1983,48,,265,24779
Auke Creek,1983,28,,266,24807
Auke Creek,1983,14,,267,24821
Auke Creek,1983,3,,268,24824
Auke Creek,1983,1,,269,24825
Auke Creek,1983,2,,270,24827
Auke Creek,1984,45,,221,45
Auke Creek,1984,63,,222,108
Auke Creek,1984,59,,223,167
Auke Creek,1984,72,,224,239
Auke Creek,1984,115,,225,354
Auke Creek,1984,68,,226,422
Auke Creek,1984,34,,227,456
Auke Creek,1984,17,,228,473
Auke Creek,1984,38,,229,511
Auke Creek,1984,6,,230,517
Auke Creek,1984,6,,231,523
Auke Creek,1984,178,,232,701
Auke Creek,1984,529,,233,1230
Auke Creek,1984,166,,234,1396
Auke Creek,1984,64,,235,1460
Auke Creek,1984,168,,236,1628
Auke Creek,1984,1068,,237,2696
Auke Creek,1984,697,,238,3393
Auke Creek,1984,425,,239,3818
Auke Creek,1984,149,,240,3967
Auke Creek,1984,98,,241,4065
Auke Creek,1984,42,,242,4107
Auke Creek,1984,76,,243,4183
Auke Creek,1984,76,,244,4259
Auke Creek,1984,38,,245,4297
Auke Creek,1984,52,,246,4349
Auke Creek,1984,108,,247,4457
Auke Creek,1984,96,,248,4553
Auke Creek,1984,51,,249,4604
Auke Creek,1984,43,,250,4647
Auke Creek,1984,39,,251,4686
Auke Creek,1984,28,,252,4714
Auke Creek,1984,60,,253,4774
Auke Creek,1984,32,,254,4806
Auke Creek,1984,32,,255,4838
Auke Creek,1984,26,,256,4864
Auke Creek,1984,37,,257,4901
Auke Creek,1984,70,,258,4971
Auke Creek,1984,96,,259,5067
Auke Creek,1984,76,,260,5143
Auke Creek,1984,72,,261,5215
Auke Creek,1984,31,,262,5246
Auke Creek,1984,9,,263,5255
Auke Creek,1984,10,,264,5265
Auke Creek,1984,3,,265,5268
Auke Creek,1984,2,,270,5270
Auke Creek,1984,1,,273,5271
Auke Creek,1985,34,,206,34
Auke Creek,1985,94,,207,128
Auke Creek,1985,207,,208,335
Auke Creek,1985,88,,209,423
Auke Creek,1985,94,,210,517
Auke Creek,1985,63,,211,580
Auke Creek,1985,90,,212,670
Auke Creek,1985,50,,213,720
Auke Creek,1985,152,,214,872
Auke Creek,1985,153,,215,1025
Auke Creek,1985,134,,216,1159
Auke Creek,1985,73,,217,1232
Auke Creek,1985,144,,218,1376
Auke Creek,1985,132,,219,1508
Auke Creek,1985,86,,220,1594
Auke Creek,1985,287,,221,1881
Auke Creek,1985,243,,222,2124
Auke Creek,1985,392,,223,2516
Auke Creek,1985,500,,224,3016
Auke Creek,1985,304,,225,3320
Auke Creek,1985,563,,226,3883
Auke Creek,1985,901,,227,4784
Auke Creek,1985,986,,228,5770
Auke Creek,1985,668,,229,6438
Auke Creek,1985,248,,230,6686
Auke Creek,1985,245,,231,6931
Auke Creek,1985,315,,232,7246
Auke Creek,1985,896,,233,8142
Auke Creek,1985,4249,,234,12391
Auke Creek,1985,1261,,235,13652
Auke Creek,1985,421,,236,14073
Auke Creek,1985,432,,237,14505
Auke Creek,1985,399,,238,14904
Auke Creek,1985,333,,239,15237
Auke Creek,1985,277,,240,15514
Auke Creek,1985,251,,241,15765
Auke Creek,1985,229,,242,15994
Auke Creek,1985,322,,243,16316
Auke Creek,1985,355,,244,16671
Auke Creek,1985,351,,245,17022
Auke Creek,1985,1208,,246,18230
Auke Creek,1985,1373,,247,19603
Auke Creek,1985,1248,,248,20851
Auke Creek,1985,617,,249,21468
Auke Creek,1985,118,,250,21586
Auke Creek,1985,160,,251,21746
Auke Creek,1985,235,,252,21981
Auke Creek,1985,169,,253,22150
Auke Creek,1985,684,,254,22834
Auke Creek,1985,278,,255,23112
Auke Creek,1985,239,,256,23351
Auke Creek,1985,219,,257,23570
Auke Creek,1985,1099,,258,24669
Auke Creek,1985,1104,,259,25773
Auke Creek,1985,192,,260,25965
Auke Creek,1985,36,,261,26001
Auke Creek,1985,34,,262,26035
Auke Creek,1985,73,,263,26108
Auke Creek,1985,46,,264,26154
Auke Creek,1985,12,,265,26166
Auke Creek,1985,115,,266,26281
Auke Creek,1985,32,,267,26313
Auke Creek,1985,3,,268,26316
Auke Creek,1985,3,,269,26319
Auke Creek,1985,2,,270,26321
Auke Creek,1986,1,,210,1
Auke Creek,1986,4,,216,5
Auke Creek,1986,27,,217,32
Auke Creek,1986,33,,218,65
Auke Creek,1986,39,,219,104
Auke Creek,1986,14,,220,118
Auke Creek,1986,6,,221,124
Auke Creek,1986,2,,222,126
Auke Creek,1986,93,,223,219
Auke Creek,1986,130,,224,349
Auke Creek,1986,129,,225,478
Auke Creek,1986,89,,226,567
Auke Creek,1986,39,,227,606
Auke Creek,1986,11,,228,617
Auke Creek,1986,55,,229,672
Auke Creek,1986,33,,230,705
Auke Creek,1986,59,,231,764
Auke Creek,1986,24,,232,788
Auke Creek,1986,25,,233,813
Auke Creek,1986,22,,234,835
Auke Creek,1986,46,,235,881
Auke Creek,1986,89,,236,970
Auke Creek,1986,64,,237,1034
Auke Creek,1986,54,,238,1088
Auke Creek,1986,45,,239,1133
Auke Creek,1986,81,,240,1214
Auke Creek,1986,311,,241,1525
Auke Creek,1986,108,,242,1633
Auke Creek,1986,46,,243,1679
Auke Creek,1986,123,,244,1802
Auke Creek,1986,105,,245,1907
Auke Creek,1986,109,,246,2016
Auke Creek,1986,40,,247,2056
Auke Creek,1986,15,,248,2071
Auke Creek,1986,11,,249,2082
Auke Creek,1986,29,,250,2111
Auke Creek,1986,12,,251,2123
Auke Creek,1986,38,,252,2161
Auke Creek,1986,20,,253,2181
Auke Creek,1986,10,,254,2191
Auke Creek,1986,16,,255,2207
Auke Creek,1986,9,,256,2216
Auke Creek,1986,3,,257,2219
Auke Creek,1986,28,,258,2247
Auke Creek,1986,12,,259,2259
Auke Creek,1986,4,,260,2263
Auke Creek,1986,8,,261,2271
Auke Creek,1986,9,,262,2280
Auke Creek,1986,7,,263,2287
Auke Creek,1986,2,,264,2289
Auke Creek,1986,5,,265,2294
Auke Creek,1986,7,,266,2301
Auke Creek,1986,2,,268,2303
Auke Creek,1986,2,,269,2305
Auke Creek,1987,1,,205,1
Auke Creek,1987,80,,211,81
Auke Creek,1987,39,,212,120
Auke Creek,1987,14,,213,134
Auke Creek,1987,42,,214,176
Auke Creek,1987,34,,215,210
Auke Creek,1987,28,,216,238
Auke Creek,1987,95,,217,333
Auke Creek,1987,19,,218,352
Auke Creek,1987,131,,219,483
Auke Creek,1987,254,,220,737
Auke Creek,1987,135,,221,872
Auke Creek,1987,131,,222,1003
Auke Creek,1987,61,,223,1064
Auke Creek,1987,33,,224,1097
Auke Creek,1987,66,,225,1163
Auke Creek,1987,72,,226,1235
Auke Creek,1987,123,,227,1358
Auke Creek,1987,93,,228,1451
Auke Creek,1987,65,,229,1516
Auke Creek,1987,283,,230,1799
Auke Creek,1987,197,,231,1996
Auke Creek,1987,278,,232,2274
Auke Creek,1987,465,,233,2739
Auke Creek,1987,244,,234,2983
Auke Creek,1987,143,,235,3126
Auke Creek,1987,193,,236,3319
Auke Creek,1987,118,,237,3437
Auke Creek,1987,103,,238,3540
Auke Creek,1987,831,,239,4371
Auke Creek,1987,328,,240,4699
Auke Creek,1987,75,,241,4774
Auke Creek,1987,134,,242,4908
Auke Creek,1987,1261,,243,6169
Auke Creek,1987,618,,244,6787
Auke Creek,1987,181,,245,6968
Auke Creek,1987,50,,246,7018
Auke Creek,1987,86,,247,7104
Auke Creek,1987,108,,248,7212
Auke Creek,1987,127,,249,7339
Auke Creek,1987,50,,250,7389
Auke Creek,1987,54,,251,7443
Auke Creek,1987,28,,252,7471
Auke Creek,1987,59,,253,7530
Auke Creek,1987,71,,254,7601
Auke Creek,1987,33,,255,7634
Auke Creek,1987,25,,256,7659
Auke Creek,1987,27,,257,7686
Auke Creek,1987,16,,258,7702
Auke Creek,1987,16,,259,7718
Auke Creek,1987,14,,260,7732
Auke Creek,1987,13,,261,7745
Auke Creek,1987,8,,262,7753
Auke Creek,1987,5,,263,7758
Auke Creek,1987,1,,264,7759
Auke Creek,1987,4,,265,7763
Auke Creek,1987,7,,266,7770
Auke Creek,1987,2,,267,7772
Auke Creek,1988,1,,206,1
Auke Creek,1988,3,,207,4
Auke Creek,1988,7,,208,11
Auke Creek,1988,6,,209,17
Auke Creek,1988,3,,210,20
Auke Creek,1988,14,,211,34
Auke Creek,1988,48,,212,82
Auke Creek,1988,18,,213,100
Auke Creek,1988,12,,214,112
Auke Creek,1988,24,,215,136
Auke Creek,1988,148,,216,284
Auke Creek,1988,75,,217,359
Auke Creek,1988,44,,218,403
Auke Creek,1988,47,,219,450
Auke Creek,1988,162,,220,612
Auke Creek,1988,232,,222,844
Auke Creek,1988,89,,223,933
Auke Creek,1988,42,,224,975
Auke Creek,1988,39,,225,1014
Auke Creek,1988,29,,226,1043
Auke Creek,1988,45,,227,1088
Auke Creek,1988,31,,228,1119
Auke Creek,1988,29,,229,1148
Auke Creek,1988,25,,230,1173
Auke Creek,1988,38,,231,1211
Auke Creek,1988,20,,232,1231
Auke Creek,1988,36,,233,1267
Auke Creek,1988,34,,234,1301
Auke Creek,1988,707,,235,2008
Auke Creek,1988,315,,236,2323
Auke Creek,1988,887,,237,3210
Auke Creek,1988,432,,238,3642
Auke Creek,1988,168,,239,3810
Auke Creek,1988,181,,240,3991
Auke Creek,1988,557,,241,4548
Auke Creek,1988,590,,242,5138
Auke Creek,1988,375,,243,5513
Auke Creek,1988,467,,244,5980
Auke Creek,1988,253,,245,6233
Auke Creek,1988,116,,246,6349
Auke Creek,1988,74,,247,6423
Auke Creek,1988,96,,248,6519
Auke Creek,1988,100,,249,6619
Auke Creek,1988,56,,250,6675
Auke Creek,1988,700,,251,7375
Auke Creek,1988,65,,252,7440
Auke Creek,1988,49,,253,7489
Auke Creek,1988,362,,254,7851
Auke Creek,1988,362,,255,8213
Auke Creek,1988,45,,256,8258
Auke Creek,1988,46,,257,8304
Auke Creek,1988,16,,258,8320
Auke Creek,1988,10,,259,8330
Auke Creek,1988,2,,263,8332
Auke Creek,1988,9,,264,8341
Auke Creek,1988,9,,265,8350
Auke Creek,1988,2,,266,8352
Auke Creek,1988,3,,267,8355
Auke Creek,1988,1,,272,8356
Auke Creek,1988,1,,285,8357
Auke Creek,1989,3,,202,3
Auke Creek,1989,1,,203,4
Auke Creek,1989,4,,204,8
Auke Creek,1989,4,,205,12
Auke Creek,1989,2,,206,14
Auke Creek,1989,6,,212,20
Auke Creek,1989,1,,213,21
Auke Creek,1989,5,,214,26
Auke Creek,1989,4,,215,30
Auke Creek,1989,713,,216,743
Auke Creek,1989,125,,217,868
Auke Creek,1989,113,,218,981
Auke Creek,1989,47,,219,1028
Auke Creek,1989,24,,220,1052
Auke Creek,1989,13,,221,1065
Auke Creek,1989,7,,222,1072
Auke Creek,1989,9,,223,1081
Auke Creek,1989,9,,224,1090
Auke Creek,1989,11,,225,1101
Auke Creek,1989,8,,226,1109
Auke Creek,1989,3,,227,1112
Auke Creek,1989,5,,228,1117
Auke Creek,1989,14,,229,1131
Auke Creek,1989,6,,230,1137
Auke Creek,1989,28,,231,1165
Auke Creek,1989,13,,232,1178
Auke Creek,1989,56,,233,1234
Auke Creek,1989,61,,234,1295
Auke Creek,1989,182,,235,1477
Auke Creek,1989,119,,236,1596
Auke Creek,1989,96,,237,1692
Auke Creek,1989,97,,238,1789
Auke Creek,1989,68,,239,1857
Auke Creek,1989,83,,240,1940
Auke Creek,1989,107,,241,2047
Auke Creek,1989,89,,242,2136
Auke Creek,1989,86,,243,2222
Auke Creek,1989,27,,244,2249
Auke Creek,1989,29,,245,2278
Auke Creek,1989,273,,246,2551
Auke Creek,1989,667,,247,3218
Auke Creek,1989,376,,248,3594
Auke Creek,1989,178,,249,3772
Auke Creek,1989,134,,250,3906
Auke Creek,1989,124,,251,4030
Auke Creek,1989,57,,252,4087
Auke Creek,1989,82,,253,4169
Auke Creek,1989,124,,254,4293
Auke Creek,1989,65,,255,4358
Auke Creek,1989,24,,256,4382
Auke Creek,1989,148,,257,4530
Auke Creek,1989,93,,258,4623
Auke Creek,1989,132,,259,4755
Auke Creek,1989,86,,260,4841
Auke Creek,1989,40,,261,4881
Auke Creek,1989,47,,262,4928
Auke Creek,1989,25,,263,4953
Auke Creek,1989,29,,264,4982
Auke Creek,1989,19,,265,5001
Auke Creek,1989,10,,266,5011
Auke Creek,1989,3,,267,5014
Auke Creek,1989,1,,268,5015
Auke Creek,1989,1,,272,5016
Auke Creek,1990,6,,182,6
Auke Creek,1990,13,,183,19
Auke Creek,1990,1,,191,20
Auke Creek,1990,1,,199,21
Auke Creek,1990,8,,212,29
Auke Creek,1990,31,,213,60
Auke Creek,1990,181,,214,241
Auke Creek,1990,262,,215,503
Auke Creek,1990,1088,,216,1591
Auke Creek,1990,682,,217,2273
Auke Creek,1990,844,,218,3117
Auke Creek,1990,690,,219,3807
Auke Creek,1990,240,,220,4047
Auke Creek,1990,312,,221,4359
Auke Creek,1990,619,,222,4978
Auke Creek,1990,508,,223,5486
Auke Creek,1990,195,,224,5681
Auke Creek,1990,169,,225,5850
Auke Creek,1990,105,,226,5955
Auke Creek,1990,76,,227,6031
Auke Creek,1990,59,,228,6090
Auke Creek,1990,30,,229,6120
Auke Creek,1990,67,,230,6187
Auke Creek,1990,27,,231,6214
Auke Creek,1990,720,,232,6934
Auke Creek,1990,561,,233,7495
Auke Creek,1990,436,,234,7931
Auke Creek,1990,312,,235,8243
Auke Creek,1990,334,,236,8577
Auke Creek,1990,381,,237,8958
Auke Creek,1990,277,,238,9235
Auke Creek,1990,471,,239,9706
Auke Creek,1990,498,,240,10204
Auke Creek,1990,964,,241,11168
Auke Creek,1990,491,,242,11659
Auke Creek,1990,428,,243,12087
Auke Creek,1990,637,,244,12724
Auke Creek,1990,1339,,245,14063
Auke Creek,1990,1198,,246,15261
Auke Creek,1990,3137,,247,18398
Auke Creek,1990,1525,,248,19923
Auke Creek,1990,298,,249,20221
Auke Creek,1990,210,,250,20431
Auke Creek,1990,164,,251,20595
Auke Creek,1990,122,,252,20717
Auke Creek,1990,134,,253,20851
Auke Creek,1990,99,,254,20950
Auke Creek,1990,131,,255,21081
Auke Creek,1990,106,,256,21187
Auke Creek,1990,175,,257,21362
Auke Creek,1990,174,,258,21536
Auke Creek,1990,88,,259,21624
Auke Creek,1990,62,,260,21686
Auke Creek,1990,44,,261,21730
Auke Creek,1990,30,,262,21760
Auke Creek,1990,37,,263,21797
Auke Creek,1990,13,,264,21810
Auke Creek,1990,9,,265,21819
Auke Creek,1990,2,,266,21821
Auke Creek,1990,2,,267,21823
Auke Creek,1990,2,,268,21825
Auke Creek,1991,1,,207,1
Auke Creek,1991,5,,209,6
Auke Creek,1991,31,,210,37
Auke Creek,1991,18,,211,55
Auke Creek,1991,7,,212,62
Auke Creek,1991,15,,213,77
Auke Creek,1991,52,,214,129
Auke Creek,1991,74,,215,203
Auke Creek,1991,125,,216,328
Auke Creek,1991,70,,217,398
Auke Creek,1991,105,,218,503
Auke Creek,1991,56,,219,559
Auke Creek,1991,76,,220,635
Auke Creek,1991,55,,221,690
Auke Creek,1991,38,,222,728
Auke Creek,1991,25,,223,753
Auke Creek,1991,49,,224,802
Auke Creek,1991,73,,225,875
Auke Creek,1991,67,,226,942
Auke Creek,1991,66,,227,1008
Auke Creek,1991,27,,228,1035
Auke Creek,1991,44,,229,1079
Auke Creek,1991,64,,230,1143
Auke Creek,1991,202,,231,1345
Auke Creek,1991,886,,232,2231
Auke Creek,1991,487,,233,2718
Auke Creek,1991,381,,234,3099
Auke Creek,1991,796,,235,3895
Auke Creek,1991,339,,236,4234
Auke Creek,1991,269,,237,4503
Auke Creek,1991,360,,238,4863
Auke Creek,1991,195,,239,5058
Auke Creek,1991,180,,240,5238
Auke Creek,1991,109,,241,5347
Auke Creek,1991,77,,242,5424
Auke Creek,1991,111,,243,5535
Auke Creek,1991,109,,244,5644
Auke Creek,1991,81,,245,5725
Auke Creek,1991,76,,246,5801
Auke Creek,1991,162,,247,5963
Auke Creek,1991,242,,248,6205
Auke Creek,1991,133,,249,6338
Auke Creek,1991,64,,250,6402
Auke Creek,1991,148,,251,6550
Auke Creek,1991,111,,252,6661
Auke Creek,1991,67,,253,6728
Auke Creek,1991,50,,254,6778
Auke Creek,1991,19,,255,6797
Auke Creek,1991,24,,256,6821
Auke Creek,1991,2,,257,6823
Auke Creek,1991,2,,258,6825
Auke Creek,1991,22,,259,6847
Auke Creek,1991,12,,260,6859
Auke Creek,1991,10,,261,6869
Auke Creek,1991,2,,262,6871
Auke Creek,1991,5,,263,6876
Auke Creek,1991,1,,267,6877
Auke Creek,1991,1,,268,6878
Auke Creek,1992,12,,195,12
Auke Creek,1992,11,,196,23
Auke Creek,1992,2,,197,25
Auke Creek,1992,4,,198,29
Auke Creek,1992,2,,199,31
Auke Creek,1992,1,,200,32
Auke Creek,1992,1,,201,33
Auke Creek,1992,2,,202,35
Auke Creek,1992,2,,203,37
Auke Creek,1992,1,,207,38
Auke Creek,1992,11,,208,49
Auke Creek,1992,309,,209,358
Auke Creek,1992,689,,210,1047
Auke Creek,1992,302,,211,1349
Auke Creek,1992,174,,212,1523
Auke Creek,1992,115,,213,1638
Auke Creek,1992,160,,214,1798
Auke Creek,1992,114,,215,1912
Auke Creek,1992,515,,216,2427
Auke Creek,1992,232,,217,2659
Auke Creek,1992,628,,218,3287
Auke Creek,1992,520,,219,3807
Auke Creek,1992,265,,220,4072
Auke Creek,1992,198,,221,4270
Auke Creek,1992,112,,222,4382
Auke Creek,1992,104,,223,4486
Auke Creek,1992,90,,224,4576
Auke Creek,1992,240,,225,4816
Auke Creek,1992,212,,226,5028
Auke Creek,1992,659,,227,5687
Auke Creek,1992,1989,,228,7676
Auke Creek,1992,3381,,229,11057
Auke Creek,1992,831,,230,11888
Auke Creek,1992,374,,231,12262
Auke Creek,1992,110,,232,12372
Auke Creek,1992,71,,233,12443
Auke Creek,1992,61,,234,12504
Auke Creek,1992,139,,235,12643
Auke Creek,1992,70,,236,12713
Auke Creek,1992,207,,237,12920
Auke Creek,1992,260,,238,13180
Auke Creek,1992,511,,239,13691
Auke Creek,1992,444,,240,14135
Auke Creek,1992,198,,241,14333
Auke Creek,1992,377,,242,14710
Auke Creek,1992,496,,243,15206
Auke Creek,1992,970,,244,16176
Auke Creek,1992,1164,,245,17340
Auke Creek,1992,859,,246,18199
Auke Creek,1992,239,,247,18438
Auke Creek,1992,327,,249,18765
Auke Creek,1992,428,,250,19193
Auke Creek,1992,813,,251,20006
Auke Creek,1992,615,,252,20621
Auke Creek,1992,605,,253,21226
Auke Creek,1992,272,,254,21498
Auke Creek,1992,94,,255,21592
Auke Creek,1992,85,,256,21677
Auke Creek,1992,24,,257,21701
Auke Creek,1992,30,,258,21731
Auke Creek,1992,87,,259,21818
Auke Creek,1992,77,,260,21895
Auke Creek,1992,74,,261,21969
Auke Creek,1992,14,,262,21983
Auke Creek,1992,8,,263,21991
Auke Creek,1992,5,,264,21996
Auke Creek,1992,1,,265,21997
Auke Creek,1992,1,,268,21998
Auke Creek,1993,1,,213,1
Auke Creek,1993,36,,228,37
Auke Creek,1993,51,,229,88
Auke Creek,1993,38,,230,126
Auke Creek,1993,23,,231,149
Auke Creek,1993,23,,232,172
Auke Creek,1993,14,,233,186
Auke Creek,1993,257,,234,443
Auke Creek,1993,139,,235,582
Auke Creek,1993,70,,236,652
Auke Creek,1993,4,,237,656
Auke Creek,1993,4,,238,660
Auke Creek,1993,33,,239,693
Auke Creek,1993,16,,240,709
Auke Creek,1993,18,,241,727
Auke Creek,1993,28,,242,755
Auke Creek,1993,36,,243,791
Auke Creek,1993,70,,244,861
Auke Creek,1993,179,,245,1040
Auke Creek,1993,124,,246,1164
Auke Creek,1993,15,,247,1179
Auke Creek,1993,37,,248,1216
Auke Creek,1993,41,,249,1257
Auke Creek,1993,194,,250,1451
Auke Creek,1993,109,,251,1560
Auke Creek,1993,42,,252,1602
Auke Creek,1993,28,,253,1630
Auke Creek,1993,14,,254,1644
Auke Creek,1993,10,,255,1654
Auke Creek,1993,16,,256,1670
Auke Creek,1993,11,,257,1681
Auke Creek,1993,1,,259,1682
Auke Creek,1993,2,,260,1684
Auke Creek,1993,8,,261,1692
Auke Creek,1993,3,,262,1695
Auke Creek,1994,2,,200,2
Auke Creek,1994,8,,201,10
Auke Creek,1994,5,,202,15
Auke Creek,1994,4,,203,19
Auke Creek,1994,1,,204,20
Auke Creek,1994,2,,207,22
Auke Creek,1994,4,,212,26
Auke Creek,1994,10,,213,36
Auke Creek,1994,20,,214,56
Auke Creek,1994,4,,215,60
Auke Creek,1994,23,,216,83
Auke Creek,1994,14,,217,97
Auke Creek,1994,374,,234,471
Auke Creek,1994,5195,,235,5666
Auke Creek,1994,2830,,236,8496
Auke Creek,1994,1078,,237,9574
Auke Creek,1994,636,,238,10210
Auke Creek,1994,310,,239,10520
Auke Creek,1994,312,,240,10832
Auke Creek,1994,298,,241,11130
Auke Creek,1994,282,,242,11412
Auke Creek,1994,349,,243,11761
Auke Creek,1994,403,,244,12164
Auke Creek,1994,545,,245,12709
Auke Creek,1994,672,,246,13381
Auke Creek,1994,579,,247,13960
Auke Creek,1994,673,,248,14633
Auke Creek,1994,1501,,249,16134
Auke Creek,1994,822,,250,16956
Auke Creek,1994,595,,251,17551
Auke Creek,1994,322,,252,17873
Auke Creek,1994,289,,253,18162
Auke Creek,1994,255,,254,18417
Auke Creek,1994,735,,255,19152
Auke Creek,1994,2009,,256,21161
Auke Creek,1994,610,,257,21771
Auke Creek,1994,229,,258,22000
Auke Creek,1994,176,,259,22176
Auke Creek,1994,60,,260,22236
Auke Creek,1994,218,,261,22454
Auke Creek,1994,47,,262,22501
Auke Creek,1994,29,,263,22530
Auke Creek,1994,24,,264,22554
Auke Creek,1994,34,,266,22588
Auke Creek,1994,6,,267,22594
Auke Creek,1994,3,,268,22597
Auke Creek,1994,4,,269,22601
Auke Creek,1995,2,,213,2
Auke Creek,1995,3,,214,5
Auke Creek,1995,10,,215,15
Auke Creek,1995,22,,216,37
Auke Creek,1995,17,,217,54
Auke Creek,1995,9,,218,63
Auke Creek,1995,10,,219,73
Auke Creek,1995,6,,220,79
Auke Creek,1995,16,,221,95
Auke Creek,1995,11,,222,106
Auke Creek,1995,2,,223,108
Auke Creek,1995,4,,224,112
Auke Creek,1995,5,,225,117
Auke Creek,1995,26,,227,143
Auke Creek,1995,17,,228,160
Auke Creek,1995,13,,229,173
Auke Creek,1995,14,,230,187
Auke Creek,1995,14,,231,201
Auke Creek,1995,14,,232,215
Auke Creek,1995,22,,233,237
Auke Creek,1995,18,,234,255
Auke Creek,1995,40,,235,295
Auke Creek,1995,46,,236,341
Auke Creek,1995,25,,237,366
Auke Creek,1995,23,,238,389
Auke Creek,1995,42,,239,431
Auke Creek,1995,65,,240,496
Auke Creek,1995,29,,241,525
Auke Creek,1995,27,,242,552
Auke Creek,1995,28,,243,580
Auke Creek,1995,288,,244,868
Auke Creek,1995,280,,245,1148
Auke Creek,1995,107,,246,1255
Auke Creek,1995,12,,249,1267
Auke Creek,1995,21,,250,1288
Auke Creek,1995,15,,251,1303
Auke Creek,1995,36,,252,1339
Auke Creek,1995,22,,253,1361
Auke Creek,1995,5,,255,1366
Auke Creek,1995,2,,256,1368
Auke Creek,1995,3,,257,1371
Auke Creek,1995,1,,258,1372
Auke Creek,1995,1,,259,1373
Auke Creek,1995,1,,260,1374
Auke Creek,1995,1,,262,1375
Auke Creek,1995,1,,270,1376
Auke Creek,1996,1,,193,1
Auke Creek,1996,4,,205,5
Auke Creek,1996,2,,212,7
Auke Creek,1996,2,,213,9
Auke Creek,1996,1,,214,10
Auke Creek,1996,1,,215,11
Auke Creek,1996,28,,216,39
Auke Creek,1996,54,,217,93
Auke Creek,1996,16,,218,109
Auke Creek,1996,147,,219,256
Auke Creek,1996,243,,220,499
Auke Creek,1996,195,,221,694
Auke Creek,1996,173,,222,867
Auke Creek,1996,49,,223,916
Auke Creek,1996,247,,224,1163
Auke Creek,1996,400,,225,1563
Auke Creek,1996,205,,226,1768
Auke Creek,1996,83,,227,1851
Auke Creek,1996,25,,229,1876
Auke Creek,1996,17,,230,1893
Auke Creek,1996,10,,231,1903
Auke Creek,1996,18,,232,1921
Auke Creek,1996,13,,233,1934
Auke Creek,1996,56,,234,1990
Auke Creek,1996,446,,235,2436
Auke Creek,1996,291,,236,2727
Auke Creek,1996,187,,237,2914
Auke Creek,1996,199,,238,3113
Auke Creek,1996,135,,239,3248
Auke Creek,1996,314,,240,3562
Auke Creek,1996,100,,241,3662
Auke Creek,1996,61,,242,3723
Auke Creek,1996,56,,243,3779
Auke Creek,1996,33,,244,3812
Auke Creek,1996,72,,245,3884
Auke Creek,1996,77,,246,3961
Auke Creek,1996,38,,247,3999
Auke Creek,1996,33,,248,4032
Auke Creek,1996,21,,249,4053
Auke Creek,1996,7,,250,4060
Auke Creek,1996,13,,251,4073
Auke Creek,1996,25,,252,4098
Auke Creek,1996,20,,253,4118
Auke Creek,1996,66,,254,4184
Auke Creek,1996,53,,255,4237
Auke Creek,1996,32,,256,4269
Auke Creek,1996,12,,257,4281
Auke Creek,1996,11,,258,4292
Auke Creek,1996,7,,259,4299
Auke Creek,1996,7,,260,4306
Auke Creek,1996,6,,261,4312
Auke Creek,1996,4,,262,4316
Auke Creek,1996,1,,263,4317
Auke Creek,1996,4,,266,4321
Auke Creek,1997,1,,196,1
Auke Creek,1997,1,,203,2
Auke Creek,1997,3,,206,5
Auke Creek,1997,15,,207,20
Auke Creek,1997,23,,208,43
Auke Creek,1997,5,,209,48
Auke Creek,1997,1,,210,49
Auke Creek,1997,1,,213,50
Auke Creek,1997,2,,215,52
Auke Creek,1997,2,,216,54
Auke Creek,1997,3,,218,57
Auke Creek,1997,2,,219,59
Auke Creek,1997,2,,220,61
Auke Creek,1997,1,,221,62
Auke Creek,1997,2,,222,64
Auke Creek,1997,2,,224,66
Auke Creek,1997,35,,225,101
Auke Creek,1997,497,,226,598
Auke Creek,1997,207,,227,805
Auke Creek,1997,105,,228,910
Auke Creek,1997,54,,229,964
Auke Creek,1997,28,,230,992
Auke Creek,1997,22,,231,1014
Auke Creek,1997,7,,232,1021
Auke Creek,1997,14,,233,1035
Auke Creek,1997,30,,234,1065
Auke Creek,1997,230,,235,1295
Auke Creek,1997,333,,236,1628
Auke Creek,1997,104,,237,1732
Auke Creek,1997,130,,238,1862
Auke Creek,1997,89,,239,1951
Auke Creek,1997,56,,240,2007
Auke Creek,1997,56,,241,2063
Auke Creek,1997,46,,242,2109
Auke Creek,1997,69,,243,2178
Auke Creek,1997,10,,244,2188
Auke Creek,1997,9,,245,2197
Auke Creek,1997,52,,247,2249
Auke Creek,1997,15,,248,2264
Auke Creek,1997,53,,249,2317
Auke Creek,1997,9,,250,2326
Auke Creek,1997,7,,251,2333
Auke Creek,1997,287,,252,2620
Auke Creek,1997,67,,253,2687
Auke Creek,1997,35,,254,2722
Auke Creek,1997,12,,255,2734
Auke Creek,1997,9,,256,2743
Auke Creek,1997,6,,257,2749
Auke Creek,1997,3,,258,2752
Auke Creek,1997,2,,259,2754
Auke Creek,1997,6,,262,2760
Auke Creek,1997,1,,263,2761
Auke Creek,1997,2,,265,2763
Auke Creek,1998,1,,203,1
Auke Creek,1998,1,,204,2
Auke Creek,1998,1,,206,3
Auke Creek,1998,40,,220,43
Auke Creek,1998,75,,221,118
Auke Creek,1998,92,,222,210
Auke Creek,1998,16,,223,226
Auke Creek,1998,8,,224,234
Auke Creek,1998,7,,225,241
Auke Creek,1998,5,,226,246
Auke Creek,1998,8,,227,254
Auke Creek,1998,11,,228,265
Auke Creek,1998,17,,229,282
Auke Creek,1998,61,,230,343
Auke Creek,1998,129,,231,472
Auke Creek,1998,73,,232,545
Auke Creek,1998,70,,233,615
Auke Creek,1998,48,,234,663
Auke Creek,1998,217,,235,880
Auke Creek,1998,195,,236,1075
Auke Creek,1998,508,,237,1583
Auke Creek,1998,257,,238,1840
Auke Creek,1998,263,,239,2103
Auke Creek,1998,168,,240,2271
Auke Creek,1998,158,,241,2429
Auke Creek,1998,71,,242,2500
Auke Creek,1998,34,,243,2534
Auke Creek,1998,73,,244,2607
Auke Creek,1998,63,,245,2670
Auke Creek,1998,46,,246,2716
Auke Creek,1998,21,,247,2737
Auke Creek,1998,25,,248,2762
Auke Creek,1998,36,,249,2798
Auke Creek,1998,11,,250,2809
Auke Creek,1998,21,,251,2830
Auke Creek,1998,11,,252,2841
Auke Creek,1998,7,,253,2848
Auke Creek,1998,2,,254,2850
Auke Creek,1998,11,,255,2861
Auke Creek,1998,11,,256,2872
Auke Creek,1998,4,,257,2876
Auke Creek,1998,2,,258,2878
Auke Creek,1998,2,,259,2880
Auke Creek,1998,1,,263,2881
Auke Creek,1999,190,,199,190
Auke Creek,1999,1,,208,191
Auke Creek,1999,2,,209,193
Auke Creek,1999,21,,210,214
Auke Creek,1999,9,,211,223
Auke Creek,1999,9,,212,232
Auke Creek,1999,2,,213,234
Auke Creek,1999,1,,214,235
Auke Creek,1999,1,,215,236
Auke Creek,1999,1,,217,237
Auke Creek,1999,4,,218,241
Auke Creek,1999,194,,221,435
Auke Creek,1999,329,,222,764
Auke Creek,1999,88,,223,852
Auke Creek,1999,84,,224,936
Auke Creek,1999,78,,225,1014
Auke Creek,1999,836,,226,1850
Auke Creek,1999,245,,227,2095
Auke Creek,1999,217,,228,2312
Auke Creek,1999,166,,229,2478
Auke Creek,1999,284,,230,2762
Auke Creek,1999,148,,231,2910
Auke Creek,1999,257,,232,3167
Auke Creek,1999,193,,233,3360
Auke Creek,1999,1231,,234,4591
Auke Creek,1999,1099,,235,5690
Auke Creek,1999,796,,236,6486
Auke Creek,1999,2401,,237,8887
Auke Creek,1999,1459,,238,10346
Auke Creek,1999,582,,239,10928
Auke Creek,1999,438,,240,11366
Auke Creek,1999,921,,241,12287
Auke Creek,1999,1075,,242,13362
Auke Creek,1999,450,,243,13812
Auke Creek,1999,561,,244,14373
Auke Creek,1999,571,,245,14944
Auke Creek,1999,1600,,246,16544
Auke Creek,1999,2128,,247,18672
Auke Creek,1999,1043,,248,19715
Auke Creek,1999,687,,249,20402
Auke Creek,1999,852,,250,21254
Auke Creek,1999,1430,,251,22684
Auke Creek,1999,1855,,252,24539
Auke Creek,1999,1912,,253,26451
Auke Creek,1999,937,,254,27388
Auke Creek,1999,623,,255,28011
Auke Creek,1999,332,,256,28343
Auke Creek,1999,216,,257,28559
Auke Creek,1999,491,,258,29050
Auke Creek,1999,520,,259,29570
Auke Creek,1999,378,,260,29948
Auke Creek,1999,190,,261,30138
Auke Creek,1999,77,,263,30215
Auke Creek,1999,33,,264,30248
Auke Creek,1999,12,,265,30260
Auke Creek,1999,15,,266,30275
Auke Creek,1999,1,,267,30276
Auke Creek,1999,2,,268,30278
Auke Creek,1999,4,,269,30282
Auke Creek,1999,3,,270,30285
Auke Creek,1999,1,,272,30286
Auke Creek,2000,1,,202,1
Auke Creek,2000,1,,204,2
Auke Creek,2000,4,,205,6
Auke Creek,2000,7,,206,13
Auke Creek,2000,9,,207,22
Auke Creek,2000,13,,208,35
Auke Creek,2000,4,,209,39
Auke Creek,2000,3,,210,42
Auke Creek,2000,5,,211,47
Auke Creek,2000,13,,212,60
Auke Creek,2000,7,,213,67
Auke Creek,2000,8,,214,75
Auke Creek,2000,3,,215,78
Auke Creek,2000,2,,217,80
Auke Creek,2000,1,,218,81
Auke Creek,2000,30,,219,111
Auke Creek,2000,2,,220,113
Auke Creek,2000,2,,221,115
Auke Creek,2000,3,,222,118
Auke Creek,2000,1,,223,119
Auke Creek,2000,4,,224,123
Auke Creek,2000,5,,225,128
Auke Creek,2000,8,,226,136
Auke Creek,2000,46,,227,182
Auke Creek,2000,47,,228,229
Auke Creek,2000,37,,229,266
Auke Creek,2000,26,,230,292
Auke Creek,2000,50,,231,342
Auke Creek,2000,76,,232,418
Auke Creek,2000,322,,233,740
Auke Creek,2000,496,,234,1236
Auke Creek,2000,275,,235,1511
Auke Creek,2000,102,,236,1613
Auke Creek,2000,56,,237,1669
Auke Creek,2000,50,,238,1719
Auke Creek,2000,41,,239,1760
Auke Creek,2000,47,,240,1807
Auke Creek,2000,27,,241,1834
Auke Creek,2000,46,,242,1880
Auke Creek,2000,93,,243,1973
Auke Creek,2000,68,,244,2041
Auke Creek,2000,45,,245,2086
Auke Creek,2000,33,,246,2119
Auke Creek,2000,74,,247,2193
Auke Creek,2000,200,,248,2393
Auke Creek,2000,44,,249,2437
Auke Creek,2000,41,,250,2478
Auke Creek,2000,10,,251,2488
Auke Creek,2000,10,,252,2498
Auke Creek,2000,3,,253,2501
Auke Creek,2000,4,,254,2505
Auke Creek,2000,3,,255,2508
Auke Creek,2000,3,,256,2511
Auke Creek,2000,2,,257,2513
Auke Creek,2000,2,,258,2515
Auke Creek,2000,1,,260,2516
Auke Creek,2000,1,,261,2517
Auke Creek,2000,1,,263,2518
Auke Creek,2001,3,,198,3
Auke Creek,2001,1,,200,4
Auke Creek,2001,4,,204,8
Auke Creek,2001,4,,205,12
Auke Creek,2001,11,,206,23
Auke Creek,2001,22,,207,45
Auke Creek,2001,41,,208,86
Auke Creek,2001,20,,209,106
Auke Creek,2001,40,,210,146
Auke Creek,2001,21,,211,167
Auke Creek,2001,34,,212,201
Auke Creek,2001,4,,213,205
Auke Creek,2001,25,,214,230
Auke Creek,2001,10,,215,240
Auke Creek,2001,13,,216,253
Auke Creek,2001,21,,217,274
Auke Creek,2001,12,,218,286
Auke Creek,2001,12,,219,298
Auke Creek,2001,7,,220,305
Auke Creek,2001,8,,221,313
Auke Creek,2001,12,,222,325
Auke Creek,2001,17,,223,342
Auke Creek,2001,36,,224,378
Auke Creek,2001,23,,225,401
Auke Creek,2001,16,,226,417
Auke Creek,2001,32,,227,449
Auke Creek,2001,30,,228,479
Auke Creek,2001,27,,229,506
Auke Creek,2001,33,,230,539
Auke Creek,2001,59,,231,598
Auke Creek,2001,183,,232,781
Auke Creek,2001,375,,233,1156
Auke Creek,2001,207,,234,1363
Auke Creek,2001,100,,235,1463
Auke Creek,2001,117,,236,1580
Auke Creek,2001,115,,237,1695
Auke Creek,2001,137,,238,1832
Auke Creek,2001,1298,,239,3130
Auke Creek,2001,1074,,240,4204
Auke Creek,2001,633,,241,4837
Auke Creek,2001,809,,242,5646
Auke Creek,2001,641,,243,6287
Auke Creek,2001,301,,244,6588
Auke Creek,2001,268,,245,6856
Auke Creek,2001,276,,246,7132
Auke Creek,2001,172,,247,7304
Auke Creek,2001,133,,248,7437
Auke Creek,2001,339,,249,7776
Auke Creek,2001,171,,250,7947
Auke Creek,2001,110,,251,8057
Auke Creek,2001,66,,252,8123
Auke Creek,2001,42,,253,8165
Auke Creek,2001,20,,254,8185
Auke Creek,2001,15,,255,8200
Auke Creek,2001,35,,256,8235
Auke Creek,2001,38,,257,8273
Auke Creek,2001,12,,258,8285
Auke Creek,2001,11,,259,8296
Auke Creek,2001,14,,260,8310
Auke Creek,2001,6,,261,8316
Auke Creek,2001,4,,262,8320
Auke Creek,2001,3,,263,8323
Auke Creek,2002,2,,205,2
Auke Creek,2002,8,,206,10
Auke Creek,2002,6,,207,16
Auke Creek,2002,4,,208,20
Auke Creek,2002,5,,209,25
Auke Creek,2002,7,,210,32
Auke Creek,2002,7,,211,39
Auke Creek,2002,4,,212,43
Auke Creek,2002,7,,213,50
Auke Creek,2002,1,,214,51
Auke Creek,2002,5,,215,56
Auke Creek,2002,3,,216,59
Auke Creek,2002,17,,217,76
Auke Creek,2002,1,,218,77
Auke Creek,2002,104,,219,181
Auke Creek,2002,411,,220,592
Auke Creek,2002,476,,221,1068
Auke Creek,2002,125,,222,1193
Auke Creek,2002,95,,223,1288
Auke Creek,2002,195,,224,1483
Auke Creek,2002,372,,225,1855
Auke Creek,2002,226,,226,2081
Auke Creek,2002,74,,227,2155
Auke Creek,2002,74,,228,2229
Auke Creek,2002,27,,229,2256
Auke Creek,2002,39,,230,2295
Auke Creek,2002,31,,231,2326
Auke Creek,2002,78,,232,2404
Auke Creek,2002,121,,233,2525
Auke Creek,2002,443,,234,2968
Auke Creek,2002,254,,235,3222
Auke Creek,2002,172,,236,3394
Auke Creek,2002,73,,237,3467
Auke Creek,2002,48,,238,3515
Auke Creek,2002,54,,239,3569
Auke Creek,2002,170,,240,3739
Auke Creek,2002,241,,241,3980
Auke Creek,2002,181,,242,4161
Auke Creek,2002,125,,243,4286
Auke Creek,2002,111,,244,4397
Auke Creek,2002,127,,245,4524
Auke Creek,2002,101,,246,4625
Auke Creek,2002,34,,247,4659
Auke Creek,2002,55,,248,4714
Auke Creek,2002,42,,249,4756
Auke Creek,2002,75,,250,4831
Auke Creek,2002,47,,251,4878
Auke Creek,2002,18,,252,4896
Auke Creek,2002,10,,253,4906
Auke Creek,2002,7,,254,4913
Auke Creek,2002,5,,255,4918
Auke Creek,2002,5,,256,4923
Auke Creek,2002,1,,257,4924
Auke Creek,2002,3,,258,4927
Auke Creek,2002,1,,260,4928
Auke Creek,2003,9,,208,9
Auke Creek,2003,38,,209,47
Auke Creek,2003,63,,210,110
Auke Creek,2003,102,,211,212
Auke Creek,2003,74,,212,286
Auke Creek,2003,28,,213,314
Auke Creek,2003,37,,214,351
Auke Creek,2003,20,,215,371
Auke Creek,2003,36,,216,407
Auke Creek,2003,18,,217,425
Auke Creek,2003,22,,218,447
Auke Creek,2003,25,,219,472
Auke Creek,2003,17,,220,489
Auke Creek,2003,11,,221,500
Auke Creek,2003,41,,222,541
Auke Creek,2003,65,,223,606
Auke Creek,2003,39,,224,645
Auke Creek,2003,36,,225,681
Auke Creek,2003,53,,226,734
Auke Creek,2003,95,,227,829
Auke Creek,2003,83,,228,912
Auke Creek,2003,342,,229,1254
Auke Creek,2003,511,,230,1765
Auke Creek,2003,187,,231,1952
Auke Creek,2003,247,,232,2199
Auke Creek,2003,1153,,233,3352
Auke Creek,2003,740,,234,4092
Auke Creek,2003,252,,235,4344
Auke Creek,2003,166,,236,4510
Auke Creek,2003,200,,237,4710
Auke Creek,2003,248,,238,4958
Auke Creek,2003,175,,239,5133
Auke Creek,2003,160,,240,5293
Auke Creek,2003,243,,241,5536
Auke Creek,2003,255,,242,5791
Auke Creek,2003,593,,243,6384
Auke Creek,2003,534,,244,6918
Auke Creek,2003,2062,,245,8980
Auke Creek,2003,700,,246,9680
Auke Creek,2003,243,,247,9923
Auke Creek,2003,87,,248,10010
Auke Creek,2003,70,,249,10080
Auke Creek,2003,46,,250,10126
Auke Creek,2003,249,,251,10375
Auke Creek,2003,114,,252,10489
Auke Creek,2003,33,,253,10522
Auke Creek,2003,9,,254,10531
Auke Creek,2003,17,,255,10548
Auke Creek,2003,8,,256,10556
Auke Creek,2003,14,,257,10570
Auke Creek,2003,5,,258,10575
Auke Creek,2003,1,,259,10576
Auke Creek,2003,1,,262,10577
Auke Creek,2003,1,,263,10578
Auke Creek,2003,1,,264,10579
Auke Creek,2003,1,,265,10580
Auke Creek,2004,12,,209,12
Auke Creek,2004,11,,210,23
Auke Creek,2004,9,,211,32
Auke Creek,2004,4,,212,36
Auke Creek,2004,13,,214,49
Auke Creek,2004,3,,216,52
Auke Creek,2004,1,,219,53
Auke Creek,2004,1,,225,54
Auke Creek,2004,12,,237,66
Auke Creek,2004,447,,239,513
Auke Creek,2004,496,,240,1009
Auke Creek,2004,517,,241,1526
Auke Creek,2004,438,,242,1964
Auke Creek,2004,270,,243,2234
Auke Creek,2004,133,,244,2367
Auke Creek,2004,178,,245,2545
Auke Creek,2004,1500,,246,4045
Auke Creek,2004,1270,,247,5315
Auke Creek,2004,342,,248,5657
Auke Creek,2004,386,,249,6043
Auke Creek,2004,206,,250,6249
Auke Creek,2004,85,,251,6334
Auke Creek,2004,53,,252,6387
Auke Creek,2004,44,,253,6431
Auke Creek,2004,39,,254,6470
Auke Creek,2004,69,,255,6539
Auke Creek,2004,74,,256,6613
Auke Creek,2004,53,,257,6666
Auke Creek,2004,83,,258,6749
Auke Creek,2004,24,,259,6773
Auke Creek,2004,11,,260,6784
Auke Creek,2004,6,,261,6790
Auke Creek,2004,6,,262,6796
Auke Creek,2004,2,,263,6798
Auke Creek,2004,4,,264,6802
Auke Creek,2005,3,,198,3
Auke Creek,2005,1,,204,4
Auke Creek,2005,1,,205,5
Auke Creek,2005,2,,206,7
Auke Creek,2005,63,,209,70
Auke Creek,2005,27,,210,97
Auke Creek,2005,110,,211,207
Auke Creek,2005,315,,212,522
Auke Creek,2005,235,,213,757
Auke Creek,2005,124,,214,881
Auke Creek,2005,108,,215,989
Auke Creek,2005,180,,216,1169
Auke Creek,2005,831,,217,2000
Auke Creek,2005,664,,218,2664
Auke Creek,2005,339,,219,3003
Auke Creek,2005,222,,220,3225
Auke Creek,2005,60,,221,3285
Auke Creek,2005,32,,222,3317
Auke Creek,2005,38,,223,3355
Auke Creek,2005,32,,224,3387
Auke Creek,2005,22,,225,3409
Auke Creek,2005,61,,226,3470
Auke Creek,2005,10,,227,3480
Auke Creek,2005,26,,228,3506
Auke Creek,2005,31,,229,3537
Auke Creek,2005,40,,230,3577
Auke Creek,2005,726,,231,4303
Auke Creek,2005,623,,232,4926
Auke Creek,2005,468,,233,5394
Auke Creek,2005,446,,234,5840
Auke Creek,2005,423,,235,6263
Auke Creek,2005,88,,236,6351
Auke Creek,2005,121,,237,6472
Auke Creek,2005,526,,238,6998
Auke Creek,2005,603,,239,7601
Auke Creek,2005,112,,240,7713
Auke Creek,2005,122,,241,7835
Auke Creek,2005,385,,242,8220
Auke Creek,2005,652,,243,8872
Auke Creek,2005,329,,244,9201
Auke Creek,2005,165,,245,9366
Auke Creek,2005,59,,246,9425
Auke Creek,2005,76,,247,9501
Auke Creek,2005,73,,248,9574
Auke Creek,2005,53,,249,9627
Auke Creek,2005,207,,250,9834
Auke Creek,2005,79,,251,9913
Auke Creek,2005,20,,252,9933
Auke Creek,2005,11,,253,9944
Auke Creek,2005,15,,254,9959
Auke Creek,2005,9,,255,9968
Auke Creek,2005,5,,256,9973
Auke Creek,2005,7,,257,9980
Auke Creek,2005,11,,258,9991
Auke Creek,2005,8,,259,9999
Auke Creek,2005,6,,260,10005
Auke Creek,2005,3,,261,10008
Auke Creek,2005,1,,262,10009
Auke Creek,2005,1,,264,10010
Auke Creek,2006,1,,204,1
Auke Creek,2006,43,,207,44
Auke Creek,2006,49,,208,93
Auke Creek,2006,5,,209,98
Auke Creek,2006,1,,210,99
Auke Creek,2006,6,,211,105
Auke Creek,2006,14,,212,119
Auke Creek,2006,20,,213,139
Auke Creek,2006,28,,215,167
Auke Creek,2006,68,,216,235
Auke Creek,2006,286,,217,521
Auke Creek,2006,756,,218,1277
Auke Creek,2006,949,,219,2226
Auke Creek,2006,471,,220,2697
Auke Creek,2006,360,,221,3057
Auke Creek,2006,623,,222,3680
Auke Creek,2006,297,,223,3977
Auke Creek,2006,151,,224,4128
Auke Creek,2006,270,,225,4398
Auke Creek,2006,1164,,226,5562
Auke Creek,2006,321,,227,5883
Auke Creek,2006,167,,228,6050
Auke Creek,2006,182,,229,6232
Auke Creek,2006,541,,230,6773
Auke Creek,2006,580,,231,7353
Auke Creek,2006,258,,232,7611
Auke Creek,2006,309,,233,7920
Auke Creek,2006,74,,234,7994
Auke Creek,2006,165,,235,8159
Auke Creek,2006,274,,236,8433
Auke Creek,2006,535,,237,8968
Auke Creek,2006,801,,238,9769
Auke Creek,2006,373,,239,10142
Auke Creek,2006,247,,240,10389
Auke Creek,2006,131,,241,10520
Auke Creek,2006,61,,242,10581
Auke Creek,2006,104,,243,10685
Auke Creek,2006,818,,244,11503
Auke Creek,2006,662,,245,12165
Auke Creek,2006,474,,246,12639
Auke Creek,2006,116,,247,12755
Auke Creek,2006,109,,248,12864
Auke Creek,2006,64,,249,12928
Auke Creek,2006,49,,250,12977
Auke Creek,2006,85,,251,13062
Auke Creek,2006,49,,252,13111
Auke Creek,2006,16,,254,13127
Auke Creek,2006,23,,255,13150
Auke Creek,2006,13,,256,13163
Auke Creek,2006,18,,257,13181
Auke Creek,2006,11,,258,13192
Auke Creek,2006,2,,259,13194
Auke Creek,2006,2,,261,13196
Auke Creek,2006,1,,263,13197
Auke Creek,2006,1,,264,13198
Auke Creek,2007,1,,216,1
Auke Creek,2007,1,,218,2
Auke Creek,2007,16,,219,18
Auke Creek,2007,33,,220,51
Auke Creek,2007,21,,221,72
Auke Creek,2007,19,,222,91
Auke Creek,2007,19,,223,110
Auke Creek,2007,17,,224,127
Auke Creek,2007,21,,225,148
Auke Creek,2007,5,,226,153
Auke Creek,2007,17,,227,170
Auke Creek,2007,5,,228,175
Auke Creek,2007,3,,229,178
Auke Creek,2007,5,,230,183
Auke Creek,2007,5,,231,188
Auke Creek,2007,3,,232,191
Auke Creek,2007,2,,233,193
Auke Creek,2007,3,,234,196
Auke Creek,2007,5,,235,201
Auke Creek,2007,7,,236,208
Auke Creek,2007,280,,237,488
Auke Creek,2007,274,,238,762
Auke Creek,2007,196,,239,958
Auke Creek,2007,168,,240,1126
Auke Creek,2007,137,,241,1263
Auke Creek,2007,113,,242,1376
Auke Creek,2007,78,,243,1454
Auke Creek,2007,53,,244,1507
Auke Creek,2007,77,,245,1584
Auke Creek,2007,127,,246,1711
Auke Creek,2007,52,,247,1763
Auke Creek,2007,404,,248,2167
Auke Creek,2007,617,,249,2784
Auke Creek,2007,138,,250,2922
Auke Creek,2007,24,,251,2946
Auke Creek,2007,37,,252,2983
Auke Creek,2007,52,,253,3035
Auke Creek,2007,23,,254,3058
Auke Creek,2007,22,,255,3080
Auke Creek,2007,11,,256,3091
Auke Creek,2007,5,,257,3096
Auke Creek,2007,6,,258,3102
Auke Creek,2007,9,,259,3111
Auke Creek,2007,10,,260,3121
Auke Creek,2007,1,,262,3122
Auke Creek,2007,1,,265,3123
Auke Creek,2008,1,,200,1
Auke Creek,2008,1,,202,2
Auke Creek,2008,6,,207,8
Auke Creek,2008,2,,208,10
Auke Creek,2008,6,,210,16
Auke Creek,2008,16,,211,32
Auke Creek,2008,12,,212,44
Auke Creek,2008,39,,213,83
Auke Creek,2008,11,,214,94
Auke Creek,2008,22,,215,116
Auke Creek,2008,17,,216,133
Auke Creek,2008,10,,218,143
Auke Creek,2008,7,,219,150
Auke Creek,2008,17,,220,167
Auke Creek,2008,18,,221,185
Auke Creek,2008,69,,222,254
Auke Creek,2008,102,,223,356
Auke Creek,2008,41,,224,397
Auke Creek,2008,142,,225,539
Auke Creek,2008,92,,226,631
Auke Creek,2008,100,,228,731
Auke Creek,2008,131,,229,862
Auke Creek,2008,88,,230,950
Auke Creek,2008,60,,231,1010
Auke Creek,2008,64,,232,1074
Auke Creek,2008,35,,233,1109
Auke Creek,2008,156,,234,1265
Auke Creek,2008,198,,235,1463
Auke Creek,2008,125,,236,1588
Auke Creek,2008,86,,237,1674
Auke Creek,2008,397,,238,2071
Auke Creek,2008,175,,239,2246
Auke Creek,2008,137,,240,2383
Auke Creek,2008,78,,241,2461
Auke Creek,2008,63,,242,2524
Auke Creek,2008,96,,243,2620
Auke Creek,2008,96,,244,2716
Auke Creek,2008,101,,245,2817
Auke Creek,2008,79,,246,2896
Auke Creek,2008,28,,247,2924
Auke Creek,2008,77,,248,3001
Auke Creek,2008,87,,249,3088
Auke Creek,2008,33,,250,3121
Auke Creek,2008,66,,251,3187
Auke Creek,2008,7,,252,3194
Auke Creek,2008,4,,253,3198
Auke Creek,2008,11,,254,3209
Auke Creek,2008,1,,255,3210
Auke Creek,2008,4,,256,3214
Auke Creek,2008,1,,258,3215
Auke Creek,2009,1,,202,1
Auke Creek,2009,1,,204,2
Auke Creek,2009,3,,205,5
Auke Creek,2009,1,,206,6
Auke Creek,2009,1,,207,7
Auke Creek,2009,1,,209,8
Auke Creek,2009,2,,210,10
Auke Creek,2009,1,,211,11
Auke Creek,2009,3,,214,14
Auke Creek,2009,3,,215,17
Auke Creek,2009,7,,216,24
Auke Creek,2009,1,,217,25
Auke Creek,2009,7,,218,32
Auke Creek,2009,3,,219,35
Auke Creek,2009,4,,220,39
Auke Creek,2009,3,,221,42
Auke Creek,2009,24,,222,66
Auke Creek,2009,44,,223,110
Auke Creek,2009,27,,224,137
Auke Creek,2009,41,,225,178
Auke Creek,2009,22,,226,200
Auke Creek,2009,49,,227,249
Auke Creek,2009,1325,,228,1574
Auke Creek,2009,53,,230,1627
Auke Creek,2009,1146,,231,2773
Auke Creek,2009,951,,232,3724
Auke Creek,2009,485,,233,4209
Auke Creek,2009,224,,234,4433
Auke Creek,2009,285,,235,4718
Auke Creek,2009,444,,236,5162
Auke Creek,2009,425,,237,5587
Auke Creek,2009,129,,238,5716
Auke Creek,2009,209,,239,5925
Auke Creek,2009,236,,240,6161
Auke Creek,2009,196,,241,6357
Auke Creek,2009,457,,242,6814
Auke Creek,2009,380,,243,7194
Auke Creek,2009,194,,244,7388
Auke Creek,2009,141,,245,7529
Auke Creek,2009,115,,246,7644
Auke Creek,2009,108,,247,7752
Auke Creek,2009,120,,248,7872
Auke Creek,2009,71,,249,7943
Auke Creek,2009,125,,250,8068
Auke Creek,2009,116,,251,8184
Auke Creek,2009,81,,252,8265
Auke Creek,2009,125,,253,8390
Auke Creek,2009,223,,254,8613
Auke Creek,2009,37,,255,8650
Auke Creek,2009,32,,256,8682
Auke Creek,2009,18,,257,8700
Auke Creek,2009,7,,258,8707
Auke Creek,2009,7,,259,8714
Auke Creek,2009,5,,260,8719
Auke Creek,2010,1,,205,1
Auke Creek,2010,1,,207,2
Auke Creek,2010,1,,208,3
Auke Creek,2010,2,,211,5
Auke Creek,2010,2,,213,7
Auke Creek,2010,11,,215,18
Auke Creek,2010,6,,216,24
Auke Creek,2010,2,,218,26
Auke Creek,2010,51,,219,77
Auke Creek,2010,98,,220,175
Auke Creek,2010,104,,221,279
Auke Creek,2010,77,,222,356
Auke Creek,2010,123,,223,479
Auke Creek,2010,232,,224,711
Auke Creek,2010,89,,225,800
Auke Creek,2010,103,,226,903
Auke Creek,2010,78,,227,981
Auke Creek,2010,34,,228,1015
Auke Creek,2010,103,,229,1118
Auke Creek,2010,183,,230,1301
Auke Creek,2010,1159,,231,2460
Auke Creek,2010,426,,232,2886
Auke Creek,2010,94,,233,2980
Auke Creek,2010,114,,234,3094
Auke Creek,2010,168,,235,3262
Auke Creek,2010,464,,236,3726
Auke Creek,2010,552,,237,4278
Auke Creek,2010,295,,238,4573
Auke Creek,2010,89,,239,4662
Auke Creek,2010,113,,240,4775
Auke Creek,2010,65,,241,4840
Auke Creek,2010,78,,242,4918
Auke Creek,2010,69,,243,4987
Auke Creek,2010,59,,244,5046
Auke Creek,2010,207,,245,5253
Auke Creek,2010,346,,246,5599
Auke Creek,2010,91,,247,5690
Auke Creek,2010,35,,248,5725
Auke Creek,2010,45,,249,5770
Auke Creek,2010,17,,250,5787
Auke Creek,2010,26,,251,5813
Auke Creek,2010,14,,252,5827
Auke Creek,2010,7,,253,5834
Auke Creek,2010,7,,254,5841
Auke Creek,2010,8,,255,5849
Auke Creek,2010,2,,256,5851
Auke Creek,2011,1,,206,1
Auke Creek,2011,25,,207,26
Auke Creek,2011,33,,208,59
Auke Creek,2011,66,,209,125
Auke Creek,2011,58,,210,183
Auke Creek,2011,33,,211,216
Auke Creek,2011,53,,212,269
Auke Creek,2011,10,,213,279
Auke Creek,2011,43,,214,322
Auke Creek,2011,30,,215,352
Auke Creek,2011,33,,216,385
Auke Creek,2011,67,,217,452
Auke Creek,2011,71,,218,523
Auke Creek,2011,44,,219,567
Auke Creek,2011,80,,220,647
Auke Creek,2011,124,,221,771
Auke Creek,2011,158,,222,929
Auke Creek,2011,228,,223,1157
Auke Creek,2011,274,,224,1431
Auke Creek,2011,403,,225,1834
Auke Creek,2011,320,,226,2154
Auke Creek,2011,342,,227,2496
Auke Creek,2011,4407,,228,6903
Auke Creek,2011,3705,,229,10608
Auke Creek,2011,1378,,230,11986
Auke Creek,2011,757,,231,12743
Auke Creek,2011,953,,232,13696
Auke Creek,2011,2439,,234,16135
Auke Creek,2011,1287,,235,17422
Auke Creek,2011,982,,236,18404
Auke Creek,2011,865,,237,19269
Auke Creek,2011,392,,238,19661
Auke Creek,2011,412,,239,20073
Auke Creek,2011,476,,240,20549
Auke Creek,2011,398,,241,20947
Auke Creek,2011,526,,242,21473
Auke Creek,2011,438,,243,21911
Auke Creek,2011,414,,244,22325
Auke Creek,2011,388,,245,22713
Auke Creek,2011,511,,246,23224
Auke Creek,2011,477,,247,23701
Auke Creek,2011,433,,248,24134
Auke Creek,2011,601,,249,24735
Auke Creek,2011,686,,250,25421
Auke Creek,2011,224,,251,25645
Auke Creek,2011,221,,252,25866
Auke Creek,2011,234,,253,26100
Auke Creek,2011,90,,254,26190
Auke Creek,2011,108,,255,26298
Auke Creek,2011,113,,256,26411
Auke Creek,2011,103,,257,26514
Auke Creek,2011,229,,258,26743
Auke Creek,2011,101,,259,26844
Auke Creek,2011,54,,260,26898
Auke Creek,2011,40,,261,26938
Auke Creek,2011,19,,262,26957
Auke Creek,2011,17,,263,26974
Auke Creek,2011,9,,264,26983
Auke Creek,2011,13,,265,26996
Auke Creek,2011,1,,266,26997
Auke Creek,2011,1,,270,26998
Auke Creek,2011,1,,272,26999
Hugh Smith,1967,1,,185,1
Hugh Smith,1967,1,,207,2
Hugh Smith,1967,3,,211,5
Hugh Smith,1967,5,,215,10
Hugh Smith,1967,3,,216,13
Hugh Smith,1967,1,,217,14
Hugh Smith,1967,1,,219,15
Hugh Smith,1967,6,,221,21
Hugh Smith,1967,10,,222,31
Hugh Smith,1967,1,,224,32
Hugh Smith,1967,7,,225,39
Hugh Smith,1967,4,,228,43
Hugh Smith,1967,2,,229,45
Hugh Smith,1967,14,,232,59
Hugh Smith,1967,42,,233,101
Hugh Smith,1967,2,,235,103
Hugh Smith,1967,1,,236,104
Hugh Smith,1967,2,,237,106
Hugh Smith,1967,200,,239,306
Hugh Smith,1967,3,,242,309
Hugh Smith,1967,11,,243,320
Hugh Smith,1967,25,,244,345
Hugh Smith,1967,16,,245,361
Hugh Smith,1967,70,,246,431
Hugh Smith,1968,1,,226,1
Hugh Smith,1968,1,,227,2
Hugh Smith,1968,2,,228,4
Hugh Smith,1968,1,,229,5
Hugh Smith,1968,2,,230,7
Hugh Smith,1968,3,,231,10
Hugh Smith,1968,6,,232,16
Hugh Smith,1968,8,,233,24
Hugh Smith,1969,10,,215,10
Hugh Smith,1969,2,,216,12
Hugh Smith,1969,15,,219,27
Hugh Smith,1969,6,,220,33
Hugh Smith,1969,90,,221,123
Hugh Smith,1969,62,,222,185
Hugh Smith,1969,10,,223,195
Hugh Smith,1969,132,,224,327
Hugh Smith,1969,70,,225,397
Hugh Smith,1969,50,,226,447
Hugh Smith,1970,2,,192,2
Hugh Smith,1970,8,,195,10
Hugh Smith,1970,4,,196,14
Hugh Smith,1970,4,,198,18
Hugh Smith,1970,4,,199,22
Hugh Smith,1970,1,,201,23
Hugh Smith,1970,2,,202,25
Hugh Smith,1970,2,,203,27
Hugh Smith,1970,9,,204,36
Hugh Smith,1970,11,,205,47
Hugh Smith,1970,1,,206,48
Hugh Smith,1970,2,,207,50
Hugh Smith,1970,48,,208,98
Hugh Smith,1970,18,,209,116
Hugh Smith,1970,5,,211,121
Hugh Smith,1970,20,,212,141
Hugh Smith,1970,1,,213,142
Hugh Smith,1970,1,,214,143
Hugh Smith,1970,1,,216,144
Hugh Smith,1970,1,,219,145
Hugh Smith,1970,1,,220,146
Hugh Smith,1970,1,,221,147
Hugh Smith,1970,26,,222,173
Hugh Smith,1970,4,,223,177
Hugh Smith,1970,3,,224,180
Hugh Smith,1970,2,,225,182
Hugh Smith,1970,25,,226,207
Hugh Smith,1970,15,,227,222
Hugh Smith,1970,12,,228,234
Hugh Smith,1970,14,,229,248
Hugh Smith,1970,10,,230,258
Hugh Smith,1970,3,,232,261
Hugh Smith,1970,2,,234,263
Hugh Smith,1970,5,,235,268
Hugh Smith,1970,2,,236,270
Hugh Smith,1970,11,,237,281
Hugh Smith,1970,4,,238,285
Hugh Smith,1970,2,,239,287
Hugh Smith,1970,12,,240,299
Hugh Smith,1970,1,,241,300
Hugh Smith,1970,70,,243,370
Hugh Smith,1970,159,,244,529
Hugh Smith,1971,7,,200,7
Hugh Smith,1971,13,,202,20
Hugh Smith,1971,2,,204,22
Hugh Smith,1971,3,,205,25
Hugh Smith,1971,11,,207,36
Hugh Smith,1971,6,,208,42
Hugh Smith,1971,1,,209,43
Hugh Smith,1971,2,,210,45
Hugh Smith,1971,10,,211,55
Hugh Smith,1971,3,,212,58
Hugh Smith,1971,1,,215,59
Hugh Smith,1971,3,,217,62
Hugh Smith,1971,3,,218,65
Hugh Smith,1971,2,,219,67
Hugh Smith,1971,1,,222,68
Hugh Smith,1971,5,,223,73
Hugh Smith,1971,26,,224,99
Hugh Smith,1971,1,,225,100
Hugh Smith,1971,57,,226,157
Hugh Smith,1971,1,,227,158
Hugh Smith,1971,1,,228,159
Hugh Smith,1971,1,,229,160
Hugh Smith,1971,70,,230,230
Hugh Smith,1971,632,,231,862
Hugh Smith,1971,336,,232,1198
Hugh Smith,1971,72,,233,1270
Hugh Smith,1980,2,,201,2
Hugh Smith,1980,2,,204,4
Hugh Smith,1980,2,,205,6
Hugh Smith,1980,3,,206,9
Hugh Smith,1980,1,,207,10
Hugh Smith,1980,2,,208,12
Hugh Smith,1980,3,,209,15
Hugh Smith,1980,4,,210,19
Hugh Smith,1980,4,,211,23
Hugh Smith,1980,7,,214,30
Hugh Smith,1980,14,,215,44
Hugh Smith,1980,3,,216,47
Hugh Smith,1980,15,,217,62
Hugh Smith,1980,80,,218,142
Hugh Smith,1980,81,,219,223
Hugh Smith,1980,82,,220,305
Hugh Smith,1980,96,,221,401
Hugh Smith,1980,12,,222,413
Hugh Smith,1980,15,,223,428
Hugh Smith,1980,36,,224,464
Hugh Smith,1980,3,,225,467
Hugh Smith,1980,2,,226,469
Hugh Smith,1980,5,,227,474
Hugh Smith,1980,143,,228,617
Hugh Smith,1980,1273,,229,1890
Hugh Smith,1980,126,,230,2016
Hugh Smith,1980,18,,231,2034
Hugh Smith,1980,32,,232,2066
Hugh Smith,1980,13,,233,2079
Hugh Smith,1980,2,,234,2081
Hugh Smith,1980,27,,235,2108
Hugh Smith,1980,12,,236,2120
Hugh Smith,1980,8,,237,2128
Hugh Smith,1980,28,,238,2156
Hugh Smith,1980,25,,239,2181
Hugh Smith,1980,18,,240,2199
Hugh Smith,1980,57,,241,2256
Hugh Smith,1980,231,,242,2487
Hugh Smith,1980,48,,243,2535
Hugh Smith,1980,107,,244,2642
Hugh Smith,1980,33,,245,2675
Hugh Smith,1980,26,,246,2701
Hugh Smith,1980,82,,247,2783
Hugh Smith,1980,53,,248,2836
Hugh Smith,1980,124,,249,2960
Hugh Smith,1980,29,,250,2989
Hugh Smith,1980,45,,251,3034
Hugh Smith,1980,123,,252,3157
Hugh Smith,1980,130,,253,3287
Hugh Smith,1980,42,,254,3329
Hugh Smith,1980,27,,255,3356
Hugh Smith,1980,14,,256,3370
Hugh Smith,1980,18,,257,3388
Hugh Smith,1980,10,,258,3398
Hugh Smith,1980,5,,259,3403
Hugh Smith,1980,5,,260,3408
Hugh Smith,1980,3,,261,3411
Hugh Smith,1980,133,,262,3544
Hugh Smith,1980,49,,263,3593
Hugh Smith,1980,19,,264,3612
Hugh Smith,1980,47,,265,3659
Hugh Smith,1980,9,,266,3668
Hugh Smith,1980,3,,267,3671
Hugh Smith,1980,1,,268,3672
Hugh Smith,1980,1,,269,3673
Hugh Smith,1980,2,,270,3675
Hugh Smith,1980,3,,271,3678
Hugh Smith,1980,6,,272,3684
Hugh Smith,1980,1,,273,3685
Hugh Smith,1980,2,,274,3687
Hugh Smith,1981,1,,108,1
Hugh Smith,1981,1,,109,2
Hugh Smith,1981,2,,115,4
Hugh Smith,1981,25,,116,29
Hugh Smith,1981,4,,117,33
Hugh Smith,1981,8,,119,41
Hugh Smith,1981,29,,120,70
Hugh Smith,1981,5,,121,75
Hugh Smith,1981,1,,124,76
Hugh Smith,1981,1,,126,77
Hugh Smith,1981,1,,129,78
Hugh Smith,1981,44,,190,122
Hugh Smith,1981,2,,191,124
Hugh Smith,1981,7,,192,131
Hugh Smith,1981,30,,193,161
Hugh Smith,1981,10,,195,171
Hugh Smith,1981,2,,197,173
Hugh Smith,1981,12,,205,185
Hugh Smith,1981,1,,214,186
Hugh Smith,1981,170,,217,356
Hugh Smith,1981,40,,218,396
Hugh Smith,1981,64,,219,460
Hugh Smith,1981,44,,220,504
Hugh Smith,1981,120,,221,624
Hugh Smith,1981,40,,222,664
Hugh Smith,1981,6,,224,670
Hugh Smith,1981,29,,226,699
Hugh Smith,1981,13,,227,712
Hugh Smith,1981,2,,230,714
Hugh Smith,1981,9,,231,723
Hugh Smith,1981,158,,232,881
Hugh Smith,1981,813,,233,1694
Hugh Smith,1981,727,,234,2421
Hugh Smith,1981,95,,235,2516
Hugh Smith,1981,33,,236,2549
Hugh Smith,1981,22,,237,2571
Hugh Smith,1981,55,,238,2626
Hugh Smith,1981,4,,239,2630
Hugh Smith,1981,75,,240,2705
Hugh Smith,1981,7,,241,2712
Hugh Smith,1981,57,,242,2769
Hugh Smith,1981,112,,243,2881
Hugh Smith,1981,44,,244,2925
Hugh Smith,1981,128,,245,3053
Hugh Smith,1981,45,,246,3098
Hugh Smith,1981,224,,247,3322
Hugh Smith,1981,541,,248,3863
Hugh Smith,1981,1276,,249,5139
Hugh Smith,1981,192,,250,5331
Hugh Smith,1981,811,,251,6142
Hugh Smith,1982,1,,125,1
Hugh Smith,1982,341,,148,342
Hugh Smith,1982,2,,184,344
Hugh Smith,1982,1,,195,345
Hugh Smith,1982,1,,196,346
Hugh Smith,1982,1,,197,347
Hugh Smith,1982,7,,198,354
Hugh Smith,1982,17,,199,371
Hugh Smith,1982,2,,200,373
Hugh Smith,1982,5,,201,378
Hugh Smith,1982,1,,202,379
Hugh Smith,1982,10,,203,389
Hugh Smith,1982,2,,204,391
Hugh Smith,1982,4,,207,395
Hugh Smith,1982,15,,209,410
Hugh Smith,1982,27,,210,437
Hugh Smith,1982,26,,211,463
Hugh Smith,1982,100,,212,563
Hugh Smith,1982,50,,213,613
Hugh Smith,1982,66,,214,679
Hugh Smith,1982,45,,215,724
Hugh Smith,1982,49,,216,773
Hugh Smith,1982,39,,217,812
Hugh Smith,1982,22,,218,834
Hugh Smith,1982,69,,219,903
Hugh Smith,1982,26,,220,929
Hugh Smith,1982,27,,221,956
Hugh Smith,1982,164,,222,1120
Hugh Smith,1982,75,,223,1195
Hugh Smith,1982,236,,224,1431
Hugh Smith,1982,204,,225,1635
Hugh Smith,1982,116,,226,1751
Hugh Smith,1982,86,,227,1837
Hugh Smith,1982,96,,228,1933
Hugh Smith,1982,43,,229,1976
Hugh Smith,1982,133,,230,2109
Hugh Smith,1982,23,,231,2132
Hugh Smith,1982,22,,232,2154
Hugh Smith,1982,37,,234,2191
Hugh Smith,1982,2,,235,2193
Hugh Smith,1982,54,,236,2247
Hugh Smith,1982,6,,237,2253
Hugh Smith,1982,25,,238,2278
Hugh Smith,1982,43,,239,2321
Hugh Smith,1982,61,,240,2382
Hugh Smith,1982,117,,241,2499
Hugh Smith,1982,83,,242,2582
Hugh Smith,1982,95,,243,2677
Hugh Smith,1982,956,,244,3633
Hugh Smith,1982,1016,,245,4649
Hugh Smith,1982,456,,246,5105
Hugh Smith,1982,144,,247,5249
Hugh Smith,1982,184,,248,5433
Hugh Smith,1982,943,,249,6376
Hugh Smith,1982,1212,,250,7588
Hugh Smith,1982,250,,251,7838
Hugh Smith,1982,157,,252,7995
Hugh Smith,1982,38,,253,8033
Hugh Smith,1982,78,,254,8111
Hugh Smith,1982,76,,255,8187
Hugh Smith,1982,34,,256,8221
Hugh Smith,1982,47,,257,8268
Hugh Smith,1982,52,,258,8320
Hugh Smith,1982,71,,259,8391
Hugh Smith,1982,57,,260,8448
Hugh Smith,1982,45,,261,8493
Hugh Smith,1982,46,,262,8539
Hugh Smith,1982,39,,263,8578
Hugh Smith,1982,64,,264,8642
Hugh Smith,1982,45,,265,8687
Hugh Smith,1982,35,,266,8722
Hugh Smith,1982,107,,267,8829
Hugh Smith,1982,43,,268,8872
Hugh Smith,1982,58,,269,8930
Hugh Smith,1982,56,,270,8986
Hugh Smith,1982,36,,271,9022
Hugh Smith,1982,66,,272,9088
Hugh Smith,1982,97,,273,9185
Hugh Smith,1982,84,,274,9269
Hugh Smith,1982,65,,275,9334
Hugh Smith,1982,26,,276,9360
Hugh Smith,1982,73,,277,9433
Hugh Smith,1982,19,,278,9452
Hugh Smith,1982,33,,279,9485
Hugh Smith,1982,17,,280,9502
Hugh Smith,1982,11,,281,9513
Hugh Smith,1982,7,,282,9520
Hugh Smith,1982,1,,289,9521
Hugh Smith,1983,3,,194,3
Hugh Smith,1983,5,,195,8
Hugh Smith,1983,1,,196,9
Hugh Smith,1983,3,,197,12
Hugh Smith,1983,1,,198,13
Hugh Smith,1983,2,,199,15
Hugh Smith,1983,1,,201,16
Hugh Smith,1983,2,,202,18
Hugh Smith,1983,1,,203,19
Hugh Smith,1983,5,,205,24
Hugh Smith,1983,1,,206,25
Hugh Smith,1983,5,,208,30
Hugh Smith,1983,1,,209,31
Hugh Smith,1983,1,,210,32
Hugh Smith,1983,9,,211,41
Hugh Smith,1983,26,,212,67
Hugh Smith,1983,63,,213,130
Hugh Smith,1983,68,,214,198
Hugh Smith,1983,77,,215,275
Hugh Smith,1983,56,,216,331
Hugh Smith,1983,33,,217,364
Hugh Smith,1983,33,,218,397
Hugh Smith,1983,36,,219,433
Hugh Smith,1983,67,,220,500
Hugh Smith,1983,40,,221,540
Hugh Smith,1983,94,,222,634
Hugh Smith,1983,251,,223,885
Hugh Smith,1983,326,,224,1211
Hugh Smith,1983,1518,,225,2729
Hugh Smith,1983,537,,226,3266
Hugh Smith,1983,852,,227,4118
Hugh Smith,1983,538,,228,4656
Hugh Smith,1983,310,,229,4966
Hugh Smith,1983,89,,230,5055
Hugh Smith,1983,208,,231,5263
Hugh Smith,1983,256,,232,5519
Hugh Smith,1983,238,,233,5757
Hugh Smith,1983,101,,234,5858
Hugh Smith,1983,118,,235,5976
Hugh Smith,1983,98,,236,6074
Hugh Smith,1983,174,,237,6248
Hugh Smith,1983,84,,238,6332
Hugh Smith,1983,177,,239,6509
Hugh Smith,1983,346,,240,6855
Hugh Smith,1983,55,,241,6910
Hugh Smith,1983,56,,242,6966
Hugh Smith,1983,46,,243,7012
Hugh Smith,1983,106,,244,7118
Hugh Smith,1983,45,,245,7163
Hugh Smith,1983,125,,246,7288
Hugh Smith,1983,138,,247,7426
Hugh Smith,1983,215,,248,7641
Hugh Smith,1983,159,,249,7800
Hugh Smith,1983,67,,250,7867
Hugh Smith,1983,81,,251,7948
Hugh Smith,1983,94,,252,8042
Hugh Smith,1983,101,,253,8143
Hugh Smith,1983,31,,254,8174
Hugh Smith,1983,66,,255,8240
Hugh Smith,1983,77,,256,8317
Hugh Smith,1983,47,,257,8364
Hugh Smith,1983,39,,258,8403
Hugh Smith,1983,58,,259,8461
Hugh Smith,1983,55,,260,8516
Hugh Smith,1983,63,,261,8579
Hugh Smith,1983,85,,262,8664
Hugh Smith,1983,75,,263,8739
Hugh Smith,1983,24,,264,8763
Hugh Smith,1983,46,,265,8809
Hugh Smith,1983,46,,266,8855
Hugh Smith,1983,97,,267,8952
Hugh Smith,1983,4,,268,8956
Hugh Smith,1983,10,,270,8966
Hugh Smith,1983,37,,271,9003
Hugh Smith,1983,23,,272,9026
Hugh Smith,1983,8,,273,9034
Hugh Smith,1983,2,,274,9036
Hugh Smith,1983,3,,276,9039
Hugh Smith,1983,2,,277,9041
Hugh Smith,1983,4,,278,9045
Hugh Smith,1983,3,,279,9048
Hugh Smith,1983,2,,280,9050
Hugh Smith,1983,3,,281,9053
Hugh Smith,1983,1,,282,9054
Hugh Smith,1984,1,,192,1
Hugh Smith,1984,1,,202,2
Hugh Smith,1984,1,,205,3
Hugh Smith,1984,2,,206,5
Hugh Smith,1984,1,,207,6
Hugh Smith,1984,2,,208,8
Hugh Smith,1984,4,,209,12
Hugh Smith,1984,2,,210,14
Hugh Smith,1984,3,,211,17
Hugh Smith,1984,7,,212,24
Hugh Smith,1984,2,,213,26
Hugh Smith,1984,4,,214,30
Hugh Smith,1984,1,,215,31
Hugh Smith,1984,6,,216,37
Hugh Smith,1984,3,,217,40
Hugh Smith,1984,2,,218,42
Hugh Smith,1984,4,,219,46
Hugh Smith,1984,12,,220,58
Hugh Smith,1984,7,,221,65
Hugh Smith,1984,12,,222,77
Hugh Smith,1984,16,,223,93
Hugh Smith,1984,5,,224,98
Hugh Smith,1984,5,,225,103
Hugh Smith,1984,5,,226,108
Hugh Smith,1984,4,,227,112
Hugh Smith,1984,11,,228,123
Hugh Smith,1984,6,,229,129
Hugh Smith,1984,9,,230,138
Hugh Smith,1984,23,,231,161
Hugh Smith,1984,13,,232,174
Hugh Smith,1984,15,,233,189
Hugh Smith,1984,5,,234,194
Hugh Smith,1984,5,,235,199
Hugh Smith,1984,29,,236,228
Hugh Smith,1984,45,,237,273
Hugh Smith,1984,121,,238,394
Hugh Smith,1984,30,,239,424
Hugh Smith,1984,29,,240,453
Hugh Smith,1984,57,,241,510
Hugh Smith,1984,33,,242,543
Hugh Smith,1984,26,,243,569
Hugh Smith,1984,36,,244,605
Hugh Smith,1984,23,,245,628
Hugh Smith,1984,32,,246,660
Hugh Smith,1984,17,,247,677
Hugh Smith,1984,10,,248,687
Hugh Smith,1984,7,,249,694
Hugh Smith,1984,18,,250,712
Hugh Smith,1984,6,,251,718
Hugh Smith,1984,21,,252,739
Hugh Smith,1984,173,,253,912
Hugh Smith,1984,27,,254,939
Hugh Smith,1984,19,,255,958
Hugh Smith,1984,16,,256,974
Hugh Smith,1984,11,,257,985
Hugh Smith,1984,10,,258,995
Hugh Smith,1984,38,,259,1033
Hugh Smith,1984,25,,260,1058
Hugh Smith,1984,7,,261,1065
Hugh Smith,1984,2,,262,1067
Hugh Smith,1984,7,,263,1074
Hugh Smith,1984,10,,264,1084
Hugh Smith,1984,11,,265,1095
Hugh Smith,1984,5,,266,1100
Hugh Smith,1984,5,,267,1105
Hugh Smith,1984,7,,268,1112
Hugh Smith,1984,2,,269,1114
Hugh Smith,1984,5,,270,1119
Hugh Smith,1984,4,,271,1123
Hugh Smith,1984,3,,273,1126
Hugh Smith,1984,3,,274,1129
Hugh Smith,1984,3,,275,1132
Hugh Smith,1984,2,,276,1134
Hugh Smith,1984,3,,277,1137
Hugh Smith,1984,2,,279,1139
Hugh Smith,1984,2,,281,1141
Hugh Smith,1984,1,,282,1142
Hugh Smith,1984,2,,283,1144
Hugh Smith,1984,2,,284,1146
Hugh Smith,1985,1,,193,1
Hugh Smith,1985,1,,197,2
Hugh Smith,1985,1,,202,3
Hugh Smith,1985,1,,204,4
Hugh Smith,1985,1,,205,5
Hugh Smith,1985,3,,206,8
Hugh Smith,1985,2,,207,10
Hugh Smith,1985,3,,209,13
Hugh Smith,1985,1,,210,14
Hugh Smith,1985,1,,211,15
Hugh Smith,1985,2,,212,17
Hugh Smith,1985,1,,213,18
Hugh Smith,1985,1,,214,19
Hugh Smith,1985,1,,215,20
Hugh Smith,1985,2,,218,22
Hugh Smith,1985,10,,219,32
Hugh Smith,1985,10,,220,42
Hugh Smith,1985,5,,221,47
Hugh Smith,1985,5,,222,52
Hugh Smith,1985,8,,223,60
Hugh Smith,1985,16,,224,76
Hugh Smith,1985,6,,225,82
Hugh Smith,1985,5,,226,87
Hugh Smith,1985,7,,227,94
Hugh Smith,1985,8,,228,102
Hugh Smith,1985,4,,229,106
Hugh Smith,1985,6,,230,112
Hugh Smith,1985,11,,231,123
Hugh Smith,1985,66,,232,189
Hugh Smith,1985,168,,233,357
Hugh Smith,1985,212,,234,569
Hugh Smith,1985,385,,235,954
Hugh Smith,1985,144,,236,1098
Hugh Smith,1985,294,,237,1392
Hugh Smith,1985,178,,238,1570
Hugh Smith,1985,277,,239,1847
Hugh Smith,1985,186,,240,2033
Hugh Smith,1985,68,,241,2101
Hugh Smith,1985,69,,242,2170
Hugh Smith,1985,54,,243,2224
Hugh Smith,1985,91,,244,2315
Hugh Smith,1985,84,,245,2399
Hugh Smith,1985,80,,246,2479
Hugh Smith,1985,207,,247,2686
Hugh Smith,1985,90,,248,2776
Hugh Smith,1985,154,,249,2930
Hugh Smith,1985,15,,250,2945
Hugh Smith,1985,23,,251,2968
Hugh Smith,1985,14,,252,2982
Hugh Smith,1985,27,,253,3009
Hugh Smith,1985,20,,254,3029
Hugh Smith,1985,29,,255,3058
Hugh Smith,1985,86,,256,3144
Hugh Smith,1985,30,,257,3174
Hugh Smith,1985,71,,258,3245
Hugh Smith,1985,180,,259,3425
Hugh Smith,1985,41,,260,3466
Hugh Smith,1985,9,,261,3475
Hugh Smith,1985,21,,262,3496
Hugh Smith,1985,212,,263,3708
Hugh Smith,1985,23,,264,3731
Hugh Smith,1985,10,,265,3741
Hugh Smith,1985,9,,266,3750
Hugh Smith,1985,2,,267,3752
Hugh Smith,1985,5,,268,3757
Hugh Smith,1985,6,,269,3763
Hugh Smith,1985,5,,270,3768
Hugh Smith,1985,6,,271,3774
Hugh Smith,1985,1,,272,3775
Hugh Smith,1985,1,,273,3776
Hugh Smith,1985,4,,274,3780
Hugh Smith,1985,7,,275,3787
Hugh Smith,1985,10,,276,3797
Hugh Smith,1985,7,,277,3804
Hugh Smith,1985,1,,278,3805
Hugh Smith,1985,3,,279,3808
Hugh Smith,1985,8,,280,3816
Hugh Smith,1985,4,,281,3820
Hugh Smith,1985,3,,282,3823
Hugh Smith,1985,4,,283,3827
Hugh Smith,1985,2,,284,3829
Hugh Smith,1985,3,,285,3832
Hugh Smith,1985,1,,286,3833
Hugh Smith,1985,2,,287,3835
Hugh Smith,1986,1,,206,1
Hugh Smith,1986,1,,218,2
Hugh Smith,1986,1,,221,3
Hugh Smith,1986,1,,228,4
Hugh Smith,1986,6,,229,10
Hugh Smith,1986,10,,230,20
Hugh Smith,1986,3,,231,23
Hugh Smith,1986,5,,232,28
Hugh Smith,1986,10,,233,38
Hugh Smith,1986,5,,234,43
Hugh Smith,1986,8,,235,51
Hugh Smith,1986,178,,236,229
Hugh Smith,1986,201,,237,430
Hugh Smith,1986,220,,238,650
Hugh Smith,1986,20,,239,670
Hugh Smith,1986,50,,240,720
Hugh Smith,1986,9,,241,729
Hugh Smith,1986,51,,242,780
Hugh Smith,1986,35,,244,815
Hugh Smith,1986,18,,245,833
Hugh Smith,1986,9,,246,842
Hugh Smith,1986,7,,247,849
Hugh Smith,1986,1,,248,850
Hugh Smith,1986,7,,249,857
Hugh Smith,1986,4,,250,861
Hugh Smith,1986,4,,251,865
Hugh Smith,1986,8,,252,873
Hugh Smith,1986,16,,254,889
Hugh Smith,1986,21,,255,910
Hugh Smith,1986,9,,256,919
Hugh Smith,1986,12,,257,931
Hugh Smith,1986,8,,258,939
Hugh Smith,1986,37,,259,976
Hugh Smith,1986,18,,260,994
Hugh Smith,1986,38,,261,1032
Hugh Smith,1986,40,,262,1072
Hugh Smith,1986,81,,263,1153
Hugh Smith,1986,82,,264,1235
Hugh Smith,1986,412,,265,1647
Hugh Smith,1986,416,,266,2063
Hugh Smith,1986,65,,267,2128
Hugh Smith,1986,36,,268,2164
Hugh Smith,1986,23,,269,2187
Hugh Smith,1986,11,,270,2198
Hugh Smith,1986,9,,271,2207
Hugh Smith,1986,13,,272,2220
Hugh Smith,1986,10,,273,2230
Hugh Smith,1986,12,,274,2242
Hugh Smith,1986,12,,275,2254
Hugh Smith,1986,13,,276,2267
Hugh Smith,1986,10,,277,2277
Hugh Smith,1986,2,,281,2279
Hugh Smith,1986,1,,282,2280
Hugh Smith,1987,1079,,130,1079
Hugh Smith,1987,2019,,137,3098
Hugh Smith,1987,1733,,145,4831
Hugh Smith,1987,134,,150,4965
Hugh Smith,1987,1,,194,4966
Hugh Smith,1987,1,,196,4967
Hugh Smith,1987,1,,200,4968
Hugh Smith,1987,6,,201,4974
Hugh Smith,1987,4,,202,4978
Hugh Smith,1987,2,,203,4980
Hugh Smith,1987,1,,204,4981
Hugh Smith,1987,1,,205,4982
Hugh Smith,1987,2,,210,4984
Hugh Smith,1987,2,,211,4986
Hugh Smith,1987,2,,216,4988
Hugh Smith,1987,2,,217,4990
Hugh Smith,1987,5,,220,4995
Hugh Smith,1987,1,,221,4996
Hugh Smith,1987,4,,222,5000
Hugh Smith,1987,70,,224,5070
Hugh Smith,1987,24,,225,5094
Hugh Smith,1987,3,,226,5097
Hugh Smith,1987,2,,227,5099
Hugh Smith,1987,3,,230,5102
Hugh Smith,1987,18,,231,5120
Hugh Smith,1987,19,,232,5139
Hugh Smith,1987,11,,233,5150
Hugh Smith,1987,12,,234,5162
Hugh Smith,1987,39,,235,5201
Hugh Smith,1987,25,,236,5226
Hugh Smith,1987,84,,237,5310
Hugh Smith,1987,22,,238,5332
Hugh Smith,1987,66,,239,5398
Hugh Smith,1987,156,,241,5554
Hugh Smith,1987,1077,,242,6631
Hugh Smith,1987,1793,,243,8424
Hugh Smith,1987,986,,244,9410
Hugh Smith,1987,516,,245,9926
Hugh Smith,1987,147,,246,10073
Hugh Smith,1987,106,,247,10179
Hugh Smith,1987,36,,248,10215
Hugh Smith,1987,110,,249,10325
Hugh Smith,1987,78,,250,10403
Hugh Smith,1987,79,,251,10482
Hugh Smith,1987,83,,252,10565
Hugh Smith,1987,91,,253,10656
Hugh Smith,1987,5,,254,10661
Hugh Smith,1987,16,,255,10677
Hugh Smith,1987,43,,256,10720
Hugh Smith,1987,18,,257,10738
Hugh Smith,1987,107,,258,10845
Hugh Smith,1987,65,,259,10910
Hugh Smith,1987,54,,260,10964
Hugh Smith,1987,106,,261,11070
Hugh Smith,1987,31,,262,11101
Hugh Smith,1987,71,,263,11172
Hugh Smith,1987,28,,264,11200
Hugh Smith,1987,17,,265,11217
Hugh Smith,1987,10,,266,11227
Hugh Smith,1987,8,,267,11235
Hugh Smith,1987,7,,268,11242
Hugh Smith,1987,31,,269,11273
Hugh Smith,1987,10,,270,11283
Hugh Smith,1987,9,,272,11292
Hugh Smith,1987,3,,273,11295
Hugh Smith,1987,3,,275,11298
Hugh Smith,1987,3,,276,11301
Hugh Smith,1987,2,,278,11303
Hugh Smith,1987,2,,279,11305
Hugh Smith,1987,1,,282,11306
Hugh Smith,1988,2,,201,2
Hugh Smith,1988,2,,203,4
Hugh Smith,1988,7,,205,11
Hugh Smith,1988,1,,206,12
Hugh Smith,1988,4,,207,16
Hugh Smith,1988,9,,208,25
Hugh Smith,1988,6,,209,31
Hugh Smith,1988,22,,210,53
Hugh Smith,1988,18,,211,71
Hugh Smith,1988,23,,212,94
Hugh Smith,1988,19,,213,113
Hugh Smith,1988,61,,214,174
Hugh Smith,1988,38,,215,212
Hugh Smith,1988,31,,216,243
Hugh Smith,1988,23,,217,266
Hugh Smith,1988,22,,218,288
Hugh Smith,1988,10,,219,298
Hugh Smith,1988,212,,220,510
Hugh Smith,1988,140,,221,650
Hugh Smith,1988,55,,222,705
Hugh Smith,1988,61,,223,766
Hugh Smith,1988,102,,224,868
Hugh Smith,1988,300,,225,1168
Hugh Smith,1988,172,,226,1340
Hugh Smith,1988,131,,227,1471
Hugh Smith,1988,80,,228,1551
Hugh Smith,1988,231,,230,1782
Hugh Smith,1988,105,,231,1887
Hugh Smith,1988,248,,232,2135
Hugh Smith,1988,297,,233,2432
Hugh Smith,1988,156,,234,2588
Hugh Smith,1988,246,,235,2834
Hugh Smith,1988,304,,236,3138
Hugh Smith,1988,104,,237,3242
Hugh Smith,1988,310,,238,3552
Hugh Smith,1988,216,,239,3768
Hugh Smith,1988,312,,240,4080
Hugh Smith,1988,3093,,241,7173
Hugh Smith,1988,101,,242,7274
Hugh Smith,1988,285,,243,7559
Hugh Smith,1988,550,,244,8109
Hugh Smith,1988,1000,,245,9109
Hugh Smith,1988,300,,246,9409
Hugh Smith,1988,251,,247,9660
Hugh Smith,1988,86,,248,9746
Hugh Smith,1988,113,,249,9859
Hugh Smith,1988,87,,250,9946
Hugh Smith,1988,152,,251,10098
Hugh Smith,1988,116,,252,10214
Hugh Smith,1988,128,,253,10342
Hugh Smith,1988,66,,254,10408
Hugh Smith,1988,137,,255,10545
Hugh Smith,1988,180,,256,10725
Hugh Smith,1988,71,,257,10796
Hugh Smith,1988,9,,258,10805
Hugh Smith,1988,87,,259,10892
Hugh Smith,1988,51,,260,10943
Hugh Smith,1988,50,,261,10993
Hugh Smith,1988,50,,262,11043
Hugh Smith,1988,50,,263,11093
Hugh Smith,1988,82,,267,11175
Hugh Smith,1988,81,,269,11256
Hugh Smith,1988,16,,275,11272
Hugh Smith,1988,6,,276,11278
Hugh Smith,1988,7,,277,11285
Hugh Smith,1988,7,,279,11292
Hugh Smith,1988,3,,282,11295
Hugh Smith,1988,5,,284,11300
Hugh Smith,1988,4,,286,11304
Hugh Smith,1988,3,,289,11307
Hugh Smith,1989,4,,214,4
Hugh Smith,1989,3,,216,7
Hugh Smith,1989,3,,217,10
Hugh Smith,1989,124,,218,134
Hugh Smith,1989,2,,219,136
Hugh Smith,1989,1,,220,137
Hugh Smith,1989,36,,221,173
Hugh Smith,1989,184,,222,357
Hugh Smith,1989,216,,223,573
Hugh Smith,1989,289,,224,862
Hugh Smith,1989,16,,225,878
Hugh Smith,1989,741,,226,1619
Hugh Smith,1989,454,,227,2073
Hugh Smith,1989,535,,228,2608
Hugh Smith,1989,64,,229,2672
Hugh Smith,1989,74,,230,2746
Hugh Smith,1989,95,,231,2841
Hugh Smith,1989,89,,232,2930
Hugh Smith,1989,901,,233,3831
Hugh Smith,1989,457,,234,4288
Hugh Smith,1989,31,,235,4319
Hugh Smith,1989,35,,236,4354
Hugh Smith,1989,398,,237,4752
Hugh Smith,1989,469,,238,5221
Hugh Smith,1989,553,,239,5774
Hugh Smith,1989,200,,240,5974
Hugh Smith,1989,520,,241,6494
Hugh Smith,1989,326,,242,6820
Hugh Smith,1989,1034,,243,7854
Hugh Smith,1989,175,,244,8029
Hugh Smith,1989,621,,245,8650
Hugh Smith,1989,468,,246,9118
Hugh Smith,1989,522,,247,9640
Hugh Smith,1989,232,,248,9872
Hugh Smith,1989,35,,249,9907
Hugh Smith,1989,57,,250,9964
Hugh Smith,1989,89,,251,10053
Hugh Smith,1989,34,,252,10087
Hugh Smith,1989,68,,253,10155
Hugh Smith,1989,54,,255,10209
Hugh Smith,1989,18,,256,10227
Hugh Smith,1989,79,,257,10306
Hugh Smith,1989,51,,258,10357
Hugh Smith,1989,45,,259,10402
Hugh Smith,1989,21,,260,10423
Hugh Smith,1989,200,,261,10623
Hugh Smith,1989,159,,262,10782
Hugh Smith,1989,192,,263,10974
Hugh Smith,1989,47,,264,11021
Hugh Smith,1989,25,,265,11046
Hugh Smith,1989,41,,266,11087
Hugh Smith,1989,19,,267,11106
Hugh Smith,1989,39,,268,11145
Hugh Smith,1989,37,,269,11182
Hugh Smith,1989,18,,270,11200
Hugh Smith,1989,16,,271,11216
Hugh Smith,1989,22,,272,11238
Hugh Smith,1989,22,,273,11260
Hugh Smith,1989,15,,274,11275
Hugh Smith,1989,17,,275,11292
Hugh Smith,1989,15,,276,11307
Hugh Smith,1989,9,,277,11316
Hugh Smith,1989,3,,278,11319
Hugh Smith,1989,1,,279,11320
Hugh Smith,1989,1,,280,11321
Hugh Smith,1989,2,,281,11323
Hugh Smith,1989,3,,284,11326
Hugh Smith,1989,1,,285,11327
Hugh Smith,1990,4,,219,4
Hugh Smith,1990,3,,221,7
Hugh Smith,1990,3,,222,10
Hugh Smith,1990,124,,223,134
Hugh Smith,1990,2,,224,136
Hugh Smith,1990,1,,225,137
Hugh Smith,1990,36,,226,173
Hugh Smith,1990,184,,227,357
Hugh Smith,1990,216,,228,573
Hugh Smith,1990,289,,229,862
Hugh Smith,1990,16,,230,878
Hugh Smith,1990,741,,231,1619
Hugh Smith,1990,454,,232,2073
Hugh Smith,1990,535,,233,2608
Hugh Smith,1990,64,,234,2672
Hugh Smith,1990,74,,235,2746
Hugh Smith,1990,95,,236,2841
Hugh Smith,1990,89,,237,2930
Hugh Smith,1990,901,,238,3831
Hugh Smith,1990,457,,239,4288
Hugh Smith,1990,31,,240,4319
Hugh Smith,1990,35,,241,4354
Hugh Smith,1990,398,,242,4752
Hugh Smith,1990,469,,243,5221
Hugh Smith,1990,553,,244,5774
Hugh Smith,1990,200,,245,5974
Hugh Smith,1990,520,,246,6494
Hugh Smith,1990,326,,247,6820
Hugh Smith,1990,1039,,248,7859
Hugh Smith,1990,175,,249,8034
Hugh Smith,1990,621,,250,8655
Hugh Smith,1990,468,,251,9123
Hugh Smith,1990,522,,252,9645
Hugh Smith,1990,232,,253,9877
Hugh Smith,1990,35,,254,9912
Hugh Smith,1990,57,,255,9969
Hugh Smith,1990,89,,256,10058
Hugh Smith,1990,34,,257,10092
Hugh Smith,1990,68,,258,10160
Hugh Smith,1990,54,,260,10214
Hugh Smith,1990,18,,261,10232
Hugh Smith,1990,79,,262,10311
Hugh Smith,1990,51,,263,10362
Hugh Smith,1990,45,,264,10407
Hugh Smith,1990,21,,265,10428
Hugh Smith,1990,200,,266,10628
Hugh Smith,1990,159,,267,10787
Hugh Smith,1990,192,,268,10979
Hugh Smith,1990,47,,269,11026
Hugh Smith,1990,25,,270,11051
Hugh Smith,1990,41,,271,11092
Hugh Smith,1990,19,,272,11111
Hugh Smith,1990,39,,273,11150
Hugh Smith,1990,37,,274,11187
Hugh Smith,1990,18,,275,11205
Hugh Smith,1990,16,,276,11221
Hugh Smith,1990,22,,277,11243
Hugh Smith,1990,22,,278,11265
Hugh Smith,1990,15,,279,11280
Hugh Smith,1990,17,,280,11297
Hugh Smith,1990,15,,281,11312
Hugh Smith,1990,9,,282,11321
Hugh Smith,1990,3,,283,11324
Hugh Smith,1990,1,,284,11325
Hugh Smith,1990,1,,285,11326
Hugh Smith,1990,2,,286,11328
Hugh Smith,1990,3,,289,11331
Hugh Smith,1990,1,,290,11332
Hugh Smith,1991,1,,209,1
Hugh Smith,1991,4,,210,5
Hugh Smith,1991,4,,211,9
Hugh Smith,1991,1,,212,10
Hugh Smith,1991,1,,213,11
Hugh Smith,1991,1,,214,12
Hugh Smith,1991,11,,215,23
Hugh Smith,1991,14,,216,37
Hugh Smith,1991,125,,217,162
Hugh Smith,1991,5,,218,167
Hugh Smith,1991,13,,219,180
Hugh Smith,1991,31,,220,211
Hugh Smith,1991,14,,221,225
Hugh Smith,1991,9,,222,234
Hugh Smith,1991,14,,223,248
Hugh Smith,1991,7,,224,255
Hugh Smith,1991,16,,225,271
Hugh Smith,1991,29,,226,300
Hugh Smith,1991,18,,227,318
Hugh Smith,1991,18,,228,336
Hugh Smith,1991,21,,229,357
Hugh Smith,1991,5,,230,362
Hugh Smith,1991,40,,231,402
Hugh Smith,1991,105,,232,507
Hugh Smith,1991,253,,233,760
Hugh Smith,1991,50,,234,810
Hugh Smith,1991,54,,235,864
Hugh Smith,1991,48,,236,912
Hugh Smith,1991,258,,237,1170
Hugh Smith,1991,330,,238,1500
Hugh Smith,1991,70,,239,1570
Hugh Smith,1991,45,,240,1615
Hugh Smith,1991,75,,241,1690
Hugh Smith,1991,90,,242,1780
Hugh Smith,1991,90,,243,1870
Hugh Smith,1991,90,,244,1960
Hugh Smith,1991,115,,245,2075
Hugh Smith,1991,60,,246,2135
Hugh Smith,1991,5,,247,2140
Hugh Smith,1991,20,,248,2160
Hugh Smith,1991,50,,249,2210
Hugh Smith,1991,55,,250,2265
Hugh Smith,1991,50,,251,2315
Hugh Smith,1991,35,,252,2350
Hugh Smith,1991,140,,253,2490
Hugh Smith,1991,180,,254,2670
Hugh Smith,1991,107,,255,2777
Hugh Smith,1991,175,,256,2952
Hugh Smith,1991,112,,257,3064
Hugh Smith,1991,120,,258,3184
Hugh Smith,1991,125,,259,3309
Hugh Smith,1991,156,,260,3465
Hugh Smith,1991,118,,261,3583
Hugh Smith,1991,241,,262,3824
Hugh Smith,1991,93,,263,3917
Hugh Smith,1991,48,,264,3965
Hugh Smith,1991,51,,265,4016
Hugh Smith,1991,44,,266,4060
Hugh Smith,1991,50,,267,4110
Hugh Smith,1991,7,,268,4117
Hugh Smith,1991,15,,269,4132
Hugh Smith,1991,29,,270,4161
Hugh Smith,1991,42,,271,4203
Hugh Smith,1991,28,,272,4231
Hugh Smith,1991,24,,273,4255
Hugh Smith,1991,9,,274,4264
Hugh Smith,1991,12,,275,4276
Hugh Smith,1991,13,,276,4289
Hugh Smith,1991,7,,277,4296
Hugh Smith,1991,1,,278,4297
Hugh Smith,1991,4,,279,4301
Hugh Smith,1991,5,,280,4306
Hugh Smith,1991,1,,281,4307
Hugh Smith,1991,2,,282,4309
Hugh Smith,1991,3,,283,4312
Hugh Smith,1992,1,,181,1
Hugh Smith,1992,1,,190,2
Hugh Smith,1992,1,,196,3
Hugh Smith,1992,1,,199,4
Hugh Smith,1992,5,,207,9
Hugh Smith,1992,17,,208,26
Hugh Smith,1992,84,,209,110
Hugh Smith,1992,8,,210,118
Hugh Smith,1992,6,,211,124
Hugh Smith,1992,1,,213,125
Hugh Smith,1992,2,,218,127
Hugh Smith,1992,1,,219,128
Hugh Smith,1992,12,,220,140
Hugh Smith,1992,5,,221,145
Hugh Smith,1992,5,,222,150
Hugh Smith,1992,16,,224,166
Hugh Smith,1992,16,,225,182
Hugh Smith,1992,13,,226,195
Hugh Smith,1992,33,,227,228
Hugh Smith,1992,23,,228,251
Hugh Smith,1992,15,,229,266
Hugh Smith,1992,50,,230,316
Hugh Smith,1992,60,,231,376
Hugh Smith,1992,54,,232,430
Hugh Smith,1992,34,,233,464
Hugh Smith,1992,20,,234,484
Hugh Smith,1992,7,,235,491
Hugh Smith,1992,19,,236,510
Hugh Smith,1992,40,,237,550
Hugh Smith,1992,73,,238,623
Hugh Smith,1992,77,,239,700
Hugh Smith,1992,144,,240,844
Hugh Smith,1992,105,,241,949
Hugh Smith,1992,421,,242,1370
Hugh Smith,1992,465,,243,1835
Hugh Smith,1992,396,,244,2231
Hugh Smith,1992,330,,245,2561
Hugh Smith,1992,303,,246,2864
Hugh Smith,1992,151,,247,3015
Hugh Smith,1992,118,,248,3133
Hugh Smith,1992,42,,249,3175
Hugh Smith,1992,486,,250,3661
Hugh Smith,1992,164,,251,3825
Hugh Smith,1992,46,,252,3871
Hugh Smith,1992,19,,253,3890
Hugh Smith,1992,17,,254,3907
Hugh Smith,1992,28,,255,3935
Hugh Smith,1992,35,,256,3970
Hugh Smith,1992,30,,257,4000
Hugh Smith,1992,19,,258,4019
Hugh Smith,1992,31,,259,4050
Hugh Smith,1992,127,,260,4177
Hugh Smith,1992,92,,261,4269
Hugh Smith,1992,41,,262,4310
Hugh Smith,1992,18,,263,4328
Hugh Smith,1992,21,,264,4349
Hugh Smith,1992,15,,265,4364
Hugh Smith,1992,11,,266,4375
Hugh Smith,1992,10,,267,4385
Hugh Smith,1992,1,,268,4386
Hugh Smith,1992,2,,269,4388
Hugh Smith,1992,12,,270,4400
Hugh Smith,1992,2,,271,4402
Hugh Smith,1992,1,,274,4403
Hugh Smith,1992,1,,275,4404
Hugh Smith,1992,1,,279,4405
Hugh Smith,1993,1,,198,1
Hugh Smith,1993,1,,199,2
Hugh Smith,1993,1,,203,3
Hugh Smith,1993,11,,211,14
Hugh Smith,1993,9,,212,23
Hugh Smith,1993,2,,213,25
Hugh Smith,1993,15,,214,40
Hugh Smith,1993,8,,215,48
Hugh Smith,1993,7,,216,55
Hugh Smith,1993,5,,217,60
Hugh Smith,1993,7,,219,67
Hugh Smith,1993,3,,220,70
Hugh Smith,1993,1,,221,71
Hugh Smith,1993,2,,222,73
Hugh Smith,1993,1,,223,74
Hugh Smith,1993,2,,225,76
Hugh Smith,1993,17,,226,93
Hugh Smith,1993,14,,227,107
Hugh Smith,1993,9,,228,116
Hugh Smith,1993,20,,229,136
Hugh Smith,1993,58,,230,194
Hugh Smith,1993,50,,231,244
Hugh Smith,1993,49,,232,293
Hugh Smith,1993,299,,233,592
Hugh Smith,1993,47,,234,639
Hugh Smith,1993,211,,235,850
Hugh Smith,1993,327,,236,1177
Hugh Smith,1993,56,,237,1233
Hugh Smith,1993,220,,238,1453
Hugh Smith,1993,247,,239,1700
Hugh Smith,1993,288,,240,1988
Hugh Smith,1993,244,,241,2232
Hugh Smith,1993,318,,242,2550
Hugh Smith,1993,247,,243,2797
Hugh Smith,1993,129,,244,2926
Hugh Smith,1993,57,,245,2983
Hugh Smith,1993,267,,246,3250
Hugh Smith,1993,180,,247,3430
Hugh Smith,1993,159,,248,3589
Hugh Smith,1993,225,,249,3814
Hugh Smith,1993,108,,250,3922
Hugh Smith,1993,176,,251,4098
Hugh Smith,1993,294,,252,4392
Hugh Smith,1993,202,,253,4594
Hugh Smith,1993,152,,254,4746
Hugh Smith,1993,219,,255,4965
Hugh Smith,1993,379,,256,5344
Hugh Smith,1993,407,,257,5751
Hugh Smith,1993,631,,258,6382
Hugh Smith,1993,696,,259,7078
Hugh Smith,1993,563,,260,7641
Hugh Smith,1993,602,,261,8243
Hugh Smith,1993,365,,262,8608
Hugh Smith,1993,302,,263,8910
Hugh Smith,1993,416,,264,9326
Hugh Smith,1993,385,,265,9711
Hugh Smith,1993,1181,,266,10892
Hugh Smith,1993,509,,267,11401
Hugh Smith,1993,117,,268,11518
Hugh Smith,1993,122,,269,11640
Hugh Smith,1993,94,,270,11734
Hugh Smith,1993,121,,271,11855
Hugh Smith,1993,39,,272,11894
Hugh Smith,1993,36,,273,11930
Hugh Smith,1993,14,,274,11944
Hugh Smith,1993,23,,275,11967
Hugh Smith,1993,26,,276,11993
Hugh Smith,1993,34,,277,12027
Hugh Smith,1993,33,,278,12060
Hugh Smith,1993,7,,279,12067
Hugh Smith,1993,3,,280,12070
Hugh Smith,1993,7,,281,12077
Hugh Smith,1993,2,,282,12079
Hugh Smith,1993,6,,283,12085
Hugh Smith,1993,3,,284,12088
Hugh Smith,1993,2,,285,12090
Hugh Smith,1993,1,,286,12091
Hugh Smith,1993,3,,287,12094
Hugh Smith,1993,1,,288,12095
Hugh Smith,1993,1,,289,12096
Hugh Smith,1993,2,,291,12098
Hugh Smith,1994,4,,218,4
Hugh Smith,1994,3,,219,7
Hugh Smith,1994,1,,222,8
Hugh Smith,1994,1,,227,9
Hugh Smith,1994,1,,231,10
Hugh Smith,1994,3,,232,13
Hugh Smith,1994,7,,233,20
Hugh Smith,1994,146,,234,166
Hugh Smith,1994,275,,235,441
Hugh Smith,1994,130,,236,571
Hugh Smith,1994,110,,237,681
Hugh Smith,1994,274,,238,955
Hugh Smith,1994,258,,239,1213
Hugh Smith,1994,276,,240,1489
Hugh Smith,1994,355,,241,1844
Hugh Smith,1994,369,,242,2213
Hugh Smith,1994,326,,243,2539
Hugh Smith,1994,167,,244,2706
Hugh Smith,1994,119,,245,2825
Hugh Smith,1994,116,,246,2941
Hugh Smith,1994,616,,247,3557
Hugh Smith,1994,400,,248,3957
Hugh Smith,1994,210,,249,4167
Hugh Smith,1994,83,,250,4250
Hugh Smith,1994,41,,251,4291
Hugh Smith,1994,189,,252,4480
Hugh Smith,1994,90,,253,4570
Hugh Smith,1994,30,,254,4600
Hugh Smith,1994,67,,255,4667
Hugh Smith,1994,3,,256,4670
Hugh Smith,1994,8,,259,4678
Hugh Smith,1994,6,,260,4684
Hugh Smith,1994,1,,262,4685
Hugh Smith,1994,6,,263,4691
Hugh Smith,1994,10,,264,4701
Hugh Smith,1994,7,,265,4708
Hugh Smith,1994,3,,266,4711
Hugh Smith,1994,1,,267,4712
Hugh Smith,1994,4,,268,4716
Hugh Smith,1994,4,,269,4720
Hugh Smith,1994,5,,270,4725
Hugh Smith,1994,1,,271,4726
Hugh Smith,1994,1,,273,4727
Hugh Smith,1994,1,,275,4728
Hugh Smith,1994,1,,283,4729
Hugh Smith,1995,1,,200,1
Hugh Smith,1995,1,,209,2
Hugh Smith,1995,1,,210,3
Hugh Smith,1995,1,,211,4
Hugh Smith,1995,3,,215,7
Hugh Smith,1995,27,,217,34
Hugh Smith,1995,12,,218,46
Hugh Smith,1995,31,,219,77
Hugh Smith,1995,100,,220,177
Hugh Smith,1995,89,,221,266
Hugh Smith,1995,36,,222,302
Hugh Smith,1995,69,,223,371
Hugh Smith,1995,30,,224,401
Hugh Smith,1995,16,,225,417
Hugh Smith,1995,51,,226,468
Hugh Smith,1995,316,,227,784
Hugh Smith,1995,165,,228,949
Hugh Smith,1995,575,,229,1524
Hugh Smith,1995,371,,230,1895
Hugh Smith,1995,247,,231,2142
Hugh Smith,1995,300,,232,2442
Hugh Smith,1995,260,,233,2702
Hugh Smith,1995,278,,234,2980
Hugh Smith,1995,500,,235,3480
Hugh Smith,1995,350,,236,3830
Hugh Smith,1995,270,,237,4100
Hugh Smith,1995,284,,238,4384
Hugh Smith,1995,214,,239,4598
Hugh Smith,1995,570,,240,5168
Hugh Smith,1995,540,,241,5708
Hugh Smith,1995,355,,242,6063
Hugh Smith,1995,1010,,243,7073
Hugh Smith,1995,600,,244,7673
Hugh Smith,1995,708,,245,8381
Hugh Smith,1995,560,,246,8941
Hugh Smith,1995,471,,247,9412
Hugh Smith,1995,459,,248,9871
Hugh Smith,1995,623,,249,10494
Hugh Smith,1995,1136,,250,11630
Hugh Smith,1995,500,,251,12130
Hugh Smith,1995,430,,252,12560
Hugh Smith,1995,1140,,253,13700
Hugh Smith,1995,840,,254,14540
Hugh Smith,1995,420,,255,14960
Hugh Smith,1995,220,,256,15180
Hugh Smith,1995,500,,257,15680
Hugh Smith,1995,234,,258,15914
Hugh Smith,1995,137,,259,16051
Hugh Smith,1995,284,,260,16335
Hugh Smith,1995,167,,261,16502
Hugh Smith,1995,196,,262,16698
Hugh Smith,1995,69,,263,16767
Hugh Smith,1995,83,,264,16850
Hugh Smith,1995,783,,265,17633
Hugh Smith,1995,96,,266,17729
Hugh Smith,1995,54,,267,17783
Hugh Smith,1995,736,,268,18519
Hugh Smith,1995,277,,269,18796
Hugh Smith,1995,54,,270,18850
Hugh Smith,1995,50,,271,18900
Hugh Smith,1995,74,,272,18974
Hugh Smith,1995,66,,273,19040
Hugh Smith,1995,41,,274,19081
Hugh Smith,1995,78,,275,19159
Hugh Smith,1995,25,,276,19184
Hugh Smith,1995,9,,277,19193
Hugh Smith,1995,7,,278,19200
Hugh Smith,1995,5,,279,19205
Hugh Smith,1995,4,,280,19209
Hugh Smith,1995,5,,281,19214
Hugh Smith,1996,3,,220,3
Hugh Smith,1996,1,,221,4
Hugh Smith,1996,1,,222,5
Hugh Smith,1996,16,,223,21
Hugh Smith,1996,47,,224,68
Hugh Smith,1996,19,,225,87
Hugh Smith,1996,3,,226,90
Hugh Smith,1996,38,,227,128
Hugh Smith,1996,19,,228,147
Hugh Smith,1996,143,,229,290
Hugh Smith,1996,662,,230,952
Hugh Smith,1996,1164,,231,2116
Hugh Smith,1996,2028,,232,4144
Hugh Smith,1996,2249,,233,6393
Hugh Smith,1996,2065,,234,8458
Hugh Smith,1996,1522,,235,9980
Hugh Smith,1996,3399,,236,13379
Hugh Smith,1996,2322,,237,15701
Hugh Smith,1996,2849,,238,18550
Hugh Smith,1996,1480,,239,20030
Hugh Smith,1996,1453,,240,21483
Hugh Smith,1996,1716,,241,23199
Hugh Smith,1996,2356,,242,25555
Hugh Smith,1996,3193,,243,28748
Hugh Smith,1996,1001,,244,29749
Hugh Smith,1996,923,,245,30672
Hugh Smith,1996,2132,,246,32804
Hugh Smith,1996,1183,,247,33987
Hugh Smith,1996,1154,,248,35141
Hugh Smith,1996,1260,,249,36401
Hugh Smith,1996,2653,,250,39054
Hugh Smith,1996,1601,,251,40655
Hugh Smith,1996,2617,,252,43272
Hugh Smith,1996,1018,,253,44290
Hugh Smith,1996,963,,254,45253
Hugh Smith,1996,662,,255,45915
Hugh Smith,1996,937,,256,46852
Hugh Smith,1996,1181,,257,48033
Hugh Smith,1996,593,,258,48626
Hugh Smith,1996,292,,259,48918
Hugh Smith,1996,322,,260,49240
Hugh Smith,1996,670,,261,49910
Hugh Smith,1996,386,,262,50296
Hugh Smith,1996,48,,263,50344
Hugh Smith,1996,37,,264,50381
Hugh Smith,1996,32,,265,50413
Hugh Smith,1996,74,,266,50487
Hugh Smith,1996,31,,267,50518
Hugh Smith,1996,9,,268,50527
Hugh Smith,1996,64,,269,50591
Hugh Smith,1996,73,,270,50664
Hugh Smith,1996,28,,271,50692
Hugh Smith,1996,9,,272,50701
Hugh Smith,1996,7,,273,50708
Hugh Smith,1996,2,,274,50710
Hugh Smith,1996,3,,275,50713
Hugh Smith,1996,3,,277,50716
Hugh Smith,1996,2,,278,50718
Hugh Smith,1996,1,,280,50719
Hugh Smith,1997,2,,205,2
Hugh Smith,1997,2,,206,4
Hugh Smith,1997,12,,207,16
Hugh Smith,1997,4,,208,20
Hugh Smith,1997,6,,209,26
Hugh Smith,1997,16,,210,42
Hugh Smith,1997,4,,211,46
Hugh Smith,1997,2,,212,48
Hugh Smith,1997,4,,213,52
Hugh Smith,1997,19,,214,71
Hugh Smith,1997,33,,215,104
Hugh Smith,1997,23,,216,127
Hugh Smith,1997,10,,217,137
Hugh Smith,1997,4,,218,141
Hugh Smith,1997,4,,220,145
Hugh Smith,1997,6,,221,151
Hugh Smith,1997,3,,222,154
Hugh Smith,1997,4,,223,158
Hugh Smith,1997,11,,224,169
Hugh Smith,1997,4,,225,173
Hugh Smith,1997,17,,226,190
Hugh Smith,1997,130,,227,320
Hugh Smith,1997,166,,228,486
Hugh Smith,1997,86,,229,572
Hugh Smith,1997,69,,230,641
Hugh Smith,1997,71,,231,712
Hugh Smith,1997,113,,232,825
Hugh Smith,1997,37,,233,862
Hugh Smith,1997,140,,234,1002
Hugh Smith,1997,207,,235,1209
Hugh Smith,1997,119,,236,1328
Hugh Smith,1997,278,,237,1606
Hugh Smith,1997,375,,238,1981
Hugh Smith,1997,654,,239,2635
Hugh Smith,1997,337,,240,2972
Hugh Smith,1997,343,,241,3315
Hugh Smith,1997,339,,242,3654
Hugh Smith,1997,178,,243,3832
Hugh Smith,1997,128,,244,3960
Hugh Smith,1997,52,,245,4012
Hugh Smith,1997,70,,246,4082
Hugh Smith,1997,158,,247,4240
Hugh Smith,1997,88,,248,4328
Hugh Smith,1997,73,,249,4401
Hugh Smith,1997,129,,250,4530
Hugh Smith,1997,92,,251,4622
Hugh Smith,1997,82,,252,4704
Hugh Smith,1997,61,,253,4765
Hugh Smith,1997,33,,254,4798
Hugh Smith,1997,14,,255,4812
Hugh Smith,1997,43,,256,4855
Hugh Smith,1997,49,,257,4904
Hugh Smith,1997,26,,258,4930
Hugh Smith,1997,4,,260,4934
Hugh Smith,1997,7,,262,4941
Hugh Smith,1997,4,,263,4945
Hugh Smith,1997,4,,265,4949
Hugh Smith,1997,1,,267,4950
Hugh Smith,1997,4,,268,4954
Hugh Smith,1997,2,,269,4956
Hugh Smith,1997,2,,271,4958
Hugh Smith,1997,2,,272,4960
Hugh Smith,1997,4,,273,4964
Hugh Smith,1997,1,,275,4965
Hugh Smith,1997,1,,280,4966
Hugh Smith,1998,395,,221,395
Hugh Smith,1998,398,,222,793
Hugh Smith,1998,160,,223,953
Hugh Smith,1998,32,,224,985
Hugh Smith,1998,457,,225,1442
Hugh Smith,1998,306,,226,1748
Hugh Smith,1998,129,,227,1877
Hugh Smith,1998,350,,228,2227
Hugh Smith,1998,247,,229,2474
Hugh Smith,1998,600,,230,3074
Hugh Smith,1998,425,,231,3499
Hugh Smith,1998,342,,232,3841
Hugh Smith,1998,150,,233,3991
Hugh Smith,1998,101,,234,4092
Hugh Smith,1998,110,,235,4202
Hugh Smith,1998,51,,236,4253
Hugh Smith,1998,32,,237,4285
Hugh Smith,1998,71,,238,4356
Hugh Smith,1998,36,,239,4392
Hugh Smith,1998,69,,240,4461
Hugh Smith,1998,80,,242,4541
Hugh Smith,1998,565,,243,5106
Hugh Smith,1998,118,,244,5224
Hugh Smith,1998,111,,245,5335
Hugh Smith,1998,22,,246,5357
Hugh Smith,1998,49,,247,5406
Hugh Smith,1998,53,,248,5459
Hugh Smith,1998,68,,249,5527
Hugh Smith,1998,80,,250,5607
Hugh Smith,1998,82,,253,5689
Hugh Smith,1998,34,,254,5723
Hugh Smith,1998,26,,257,5749
Hugh Smith,1998,27,,259,5776
Hugh Smith,1998,17,,260,5793
Hugh Smith,1998,30,,261,5823
Hugh Smith,1998,4,,262,5827
Hugh Smith,1998,6,,264,5833
Hugh Smith,1998,11,,265,5844
Hugh Smith,1998,6,,266,5850
Hugh Smith,1998,5,,268,5855
Hugh Smith,1998,2,,271,5857
Hugh Smith,1998,13,,273,5870
Hugh Smith,1998,2,,274,5872
Hugh Smith,1998,2,,275,5874
Hugh Smith,1998,1,,276,5875
Hugh Smith,1999,3,,203,3
Hugh Smith,1999,1,,208,4
Hugh Smith,1999,2,,209,6
Hugh Smith,1999,4,,210,10
Hugh Smith,1999,26,,211,36
Hugh Smith,1999,28,,212,64
Hugh Smith,1999,4,,213,68
Hugh Smith,1999,9,,214,77
Hugh Smith,1999,11,,216,88
Hugh Smith,1999,3,,217,91
Hugh Smith,1999,12,,218,103
Hugh Smith,1999,11,,219,114
Hugh Smith,1999,5,,220,119
Hugh Smith,1999,3,,221,122
Hugh Smith,1999,30,,222,152
Hugh Smith,1999,9,,223,161
Hugh Smith,1999,104,,224,265
Hugh Smith,1999,3,,225,268
Hugh Smith,1999,11,,226,279
Hugh Smith,1999,89,,227,368
Hugh Smith,1999,81,,228,449
Hugh Smith,1999,93,,229,542
Hugh Smith,1999,585,,230,1127
Hugh Smith,1999,504,,231,1631
Hugh Smith,1999,485,,232,2116
Hugh Smith,1999,275,,233,2391
Hugh Smith,1999,502,,234,2893
Hugh Smith,1999,674,,235,3567
Hugh Smith,1999,348,,236,3915
Hugh Smith,1999,105,,237,4020
Hugh Smith,1999,430,,238,4450
Hugh Smith,1999,300,,239,4750
Hugh Smith,1999,20,,240,4770
Hugh Smith,1999,255,,241,5025
Hugh Smith,1999,1296,,242,6321
Hugh Smith,1999,782,,243,7103
Hugh Smith,1999,529,,244,7632
Hugh Smith,1999,470,,245,8102
Hugh Smith,1999,653,,246,8755
Hugh Smith,1999,529,,247,9284
Hugh Smith,1999,719,,248,10003
Hugh Smith,1999,402,,249,10405
Hugh Smith,1999,729,,250,11134
Hugh Smith,1999,218,,251,11352
Hugh Smith,1999,301,,252,11653
Hugh Smith,1999,624,,253,12277
Hugh Smith,1999,606,,254,12883
Hugh Smith,1999,555,,255,13438
Hugh Smith,1999,720,,256,14158
Hugh Smith,1999,652,,257,14810
Hugh Smith,1999,217,,258,15027
Hugh Smith,1999,415,,259,15442
Hugh Smith,1999,79,,260,15521
Hugh Smith,1999,46,,261,15567
Hugh Smith,1999,193,,262,15760
Hugh Smith,1999,37,,263,15797
Hugh Smith,1999,27,,264,15824
Hugh Smith,1999,104,,265,15928
Hugh Smith,1999,25,,266,15953
Hugh Smith,1999,25,,267,15978
Hugh Smith,1999,26,,268,16004
Hugh Smith,1999,22,,270,16026
Hugh Smith,1999,15,,271,16041
Hugh Smith,1999,17,,272,16058
Hugh Smith,1999,8,,273,16066
Hugh Smith,1999,2,,276,16068
Hugh Smith,1999,6,,277,16074
Hugh Smith,1999,1,,278,16075
Hugh Smith,1999,3,,279,16078
Hugh Smith,1999,9,,280,16087
Hugh Smith,1999,1,,281,16088
Hugh Smith,2000,1,,193,1
Hugh Smith,2000,1,,202,2
Hugh Smith,2000,1,,204,3
Hugh Smith,2000,1,,208,4
Hugh Smith,2000,3,,211,7
Hugh Smith,2000,2,,213,9
Hugh Smith,2000,3,,214,12
Hugh Smith,2000,1,,215,13
Hugh Smith,2000,1,,216,14
Hugh Smith,2000,5,,217,19
Hugh Smith,2000,1,,218,20
Hugh Smith,2000,6,,219,26
Hugh Smith,2000,7,,220,33
Hugh Smith,2000,1,,221,34
Hugh Smith,2000,2,,222,36
Hugh Smith,2000,11,,226,47
Hugh Smith,2000,10,,227,57
Hugh Smith,2000,25,,228,82
Hugh Smith,2000,108,,229,190
Hugh Smith,2000,143,,230,333
Hugh Smith,2000,55,,231,388
Hugh Smith,2000,55,,232,443
Hugh Smith,2000,73,,239,516
Hugh Smith,2000,20,,240,536
Hugh Smith,2000,106,,241,642
Hugh Smith,2000,186,,242,828
Hugh Smith,2000,124,,243,952
Hugh Smith,2000,275,,244,1227
Hugh Smith,2000,191,,245,1418
Hugh Smith,2000,120,,246,1538
Hugh Smith,2000,105,,247,1643
Hugh Smith,2000,17,,248,1660
Hugh Smith,2000,3,,250,1663
Hugh Smith,2000,8,,254,1671
Hugh Smith,2000,2,,255,1673
Hugh Smith,2000,3,,256,1676
Hugh Smith,2000,8,,257,1684
Hugh Smith,2000,3,,262,1687
Hugh Smith,2000,4,,263,1691
Hugh Smith,2000,1,,264,1692
Hugh Smith,2000,4,,266,1696
Hugh Smith,2000,2,,267,1698
Hugh Smith,2000,2,,275,1700
Hugh Smith,2000,1,,278,1701
Hugh Smith,2001,1,,191,1
Hugh Smith,2001,2,,201,3
Hugh Smith,2001,2,,202,5
Hugh Smith,2001,3,,203,8
Hugh Smith,2001,7,,204,15
Hugh Smith,2001,1,,205,16
Hugh Smith,2001,2,,206,18
Hugh Smith,2001,1,,209,19
Hugh Smith,2001,3,,210,22
Hugh Smith,2001,3,,211,25
Hugh Smith,2001,3,,212,28
Hugh Smith,2001,3,,213,31
Hugh Smith,2001,7,,214,38
Hugh Smith,2001,5,,215,43
Hugh Smith,2001,3,,216,46
Hugh Smith,2001,2,,217,48
Hugh Smith,2001,2,,218,50
Hugh Smith,2001,9,,220,59
Hugh Smith,2001,12,,221,71
Hugh Smith,2001,8,,222,79
Hugh Smith,2001,3,,223,82
Hugh Smith,2001,11,,224,93
Hugh Smith,2001,18,,225,111
Hugh Smith,2001,66,,226,177
Hugh Smith,2001,35,,227,212
Hugh Smith,2001,26,,228,238
Hugh Smith,2001,400,,229,638
Hugh Smith,2001,194,,230,832
Hugh Smith,2001,522,,231,1354
Hugh Smith,2001,378,,232,1732
Hugh Smith,2001,341,,233,2073
Hugh Smith,2001,611,,234,2684
Hugh Smith,2001,338,,235,3022
Hugh Smith,2001,913,,236,3935
Hugh Smith,2001,715,,237,4650
Hugh Smith,2001,561,,241,5211
Hugh Smith,2001,376,,242,5587
Hugh Smith,2001,268,,243,5855
Hugh Smith,2001,324,,244,6179
Hugh Smith,2001,186,,251,6365
Hugh Smith,2001,904,,252,7269
Hugh Smith,2001,506,,253,7775
Hugh Smith,2001,434,,254,8209
Hugh Smith,2001,604,,255,8813
Hugh Smith,2001,504,,256,9317
Hugh Smith,2001,708,,257,10025
Hugh Smith,2001,492,,258,10517
Hugh Smith,2001,2261,,259,12778
Hugh Smith,2001,831,,260,13609
Hugh Smith,2001,694,,261,14303
Hugh Smith,2001,376,,262,14679
Hugh Smith,2001,232,,263,14911
Hugh Smith,2001,115,,264,15026
Hugh Smith,2001,71,,268,15097
Hugh Smith,2001,8,,269,15105
Hugh Smith,2001,9,,270,15114
Hugh Smith,2001,2,,272,15116
Hugh Smith,2001,3,,273,15119
Hugh Smith,2001,1,,274,15120
Hugh Smith,2001,1,,277,15121
Hugh Smith,2001,3,,280,15124
Hugh Smith,2002,1,,204,1
Hugh Smith,2002,1,,205,2
Hugh Smith,2002,1,,216,3
Hugh Smith,2002,2,,217,5
Hugh Smith,2002,1,,218,6
Hugh Smith,2002,9,,219,15
Hugh Smith,2002,7,,220,22
Hugh Smith,2002,158,,221,180
Hugh Smith,2002,169,,222,349
Hugh Smith,2002,147,,223,496
Hugh Smith,2002,118,,224,614
Hugh Smith,2002,125,,225,739
Hugh Smith,2002,184,,226,923
Hugh Smith,2002,67,,227,990
Hugh Smith,2002,97,,228,1087
Hugh Smith,2002,97,,229,1184
Hugh Smith,2002,84,,230,1268
Hugh Smith,2002,161,,231,1429
Hugh Smith,2002,122,,232,1551
Hugh Smith,2002,59,,233,1610
Hugh Smith,2002,167,,234,1777
Hugh Smith,2002,969,,235,2746
Hugh Smith,2002,847,,236,3593
Hugh Smith,2002,1322,,237,4915
Hugh Smith,2002,630,,238,5545
Hugh Smith,2002,264,,239,5809
Hugh Smith,2002,961,,240,6770
Hugh Smith,2002,502,,241,7272
Hugh Smith,2002,450,,242,7722
Hugh Smith,2002,490,,243,8212
Hugh Smith,2002,364,,244,8576
Hugh Smith,2002,628,,245,9204
Hugh Smith,2002,363,,246,9567
Hugh Smith,2002,1081,,247,10648
Hugh Smith,2002,14,,248,10662
Hugh Smith,2002,90,,249,10752
Hugh Smith,2002,525,,250,11277
Hugh Smith,2002,426,,251,11703
Hugh Smith,2002,204,,252,11907
Hugh Smith,2002,54,,253,11961
Hugh Smith,2002,29,,254,11990
Hugh Smith,2002,212,,255,12202
Hugh Smith,2002,145,,256,12347
Hugh Smith,2002,35,,257,12382
Hugh Smith,2002,53,,258,12435
Hugh Smith,2002,3,,259,12438
Hugh Smith,2002,46,,260,12484
Hugh Smith,2002,19,,262,12503
Hugh Smith,2002,7,,263,12510
Hugh Smith,2002,12,,264,12522
Hugh Smith,2002,20,,265,12542
Hugh Smith,2002,7,,266,12549
Hugh Smith,2002,19,,267,12568
Hugh Smith,2002,5,,268,12573
Hugh Smith,2002,2,,269,12575
Hugh Smith,2002,1,,270,12576
Hugh Smith,2002,2,,271,12578
Hugh Smith,2002,5,,275,12583
Hugh Smith,2002,1,,276,12584
Hugh Smith,2002,1,,277,12585
Hugh Smith,2002,5,,279,12590
Hugh Smith,2002,1,,282,12591
Hugh Smith,2002,2,,293,12593
Hugh Smith,2003,1,,182,1
Hugh Smith,2003,1,,191,2
Hugh Smith,2003,1,,192,3
Hugh Smith,2003,1,,203,4
Hugh Smith,2003,2,,216,6
Hugh Smith,2003,3,,217,9
Hugh Smith,2003,2,,218,11
Hugh Smith,2003,3,,219,14
Hugh Smith,2003,1,,220,15
Hugh Smith,2003,2,,221,17
Hugh Smith,2003,2,,223,19
Hugh Smith,2003,1,,224,20
Hugh Smith,2003,2,,225,22
Hugh Smith,2003,7,,226,29
Hugh Smith,2003,6,,227,35
Hugh Smith,2003,18,,228,53
Hugh Smith,2003,45,,229,98
Hugh Smith,2003,177,,230,275
Hugh Smith,2003,279,,231,554
Hugh Smith,2003,450,,232,1004
Hugh Smith,2003,243,,233,1247
Hugh Smith,2003,936,,234,2183
Hugh Smith,2003,460,,235,2643
Hugh Smith,2003,472,,236,3115
Hugh Smith,2003,257,,237,3372
Hugh Smith,2003,570,,238,3942
Hugh Smith,2003,610,,239,4552
Hugh Smith,2003,534,,240,5086
Hugh Smith,2003,27,,241,5113
Hugh Smith,2003,633,,242,5746
Hugh Smith,2003,840,,243,6586
Hugh Smith,2003,774,,244,7360
Hugh Smith,2003,701,,245,8061
Hugh Smith,2003,66,,246,8127
Hugh Smith,2003,164,,247,8291
Hugh Smith,2003,159,,248,8450
Hugh Smith,2003,164,,249,8614
Hugh Smith,2003,167,,250,8781
Hugh Smith,2003,222,,252,9003
Hugh Smith,2003,447,,253,9450
Hugh Smith,2003,47,,254,9497
Hugh Smith,2003,90,,255,9587
Hugh Smith,2003,157,,256,9744
Hugh Smith,2003,14,,258,9758
Hugh Smith,2003,10,,259,9768
Hugh Smith,2003,13,,260,9781
Hugh Smith,2003,54,,261,9835
Hugh Smith,2003,28,,262,9863
Hugh Smith,2003,12,,263,9875
Hugh Smith,2003,7,,264,9882
Hugh Smith,2003,6,,265,9888
Hugh Smith,2003,12,,267,9900
Hugh Smith,2003,11,,269,9911
Hugh Smith,2003,6,,270,9917
Hugh Smith,2003,2,,271,9919
Hugh Smith,2003,2,,272,9921
Hugh Smith,2003,8,,275,9929
Hugh Smith,2003,2,,276,9931
Hugh Smith,2003,2,,278,9933
Hugh Smith,2003,1,,281,9934
Hugh Smith,2003,1,,288,9935
Hugh Smith,2004,1,,184,1
Hugh Smith,2004,60,,216,61
Hugh Smith,2004,82,,217,143
Hugh Smith,2004,331,,218,474
Hugh Smith,2004,110,,219,584
Hugh Smith,2004,54,,220,638
Hugh Smith,2004,3,,221,641
Hugh Smith,2004,20,,222,661
Hugh Smith,2004,16,,223,677
Hugh Smith,2004,21,,224,698
Hugh Smith,2004,20,,225,718
Hugh Smith,2004,6,,226,724
Hugh Smith,2004,9,,227,733
Hugh Smith,2004,12,,228,745
Hugh Smith,2004,40,,229,785
Hugh Smith,2004,18,,230,803
Hugh Smith,2004,34,,231,837
Hugh Smith,2004,1,,232,838
Hugh Smith,2004,25,,233,863
Hugh Smith,2004,215,,234,1078
Hugh Smith,2004,62,,235,1140
Hugh Smith,2004,277,,236,1417
Hugh Smith,2004,405,,237,1822
Hugh Smith,2004,1031,,238,2853
Hugh Smith,2004,944,,239,3797
Hugh Smith,2004,1029,,240,4826
Hugh Smith,2004,1091,,241,5917
Hugh Smith,2004,631,,242,6548
Hugh Smith,2004,368,,243,6916
Hugh Smith,2004,794,,244,7710
Hugh Smith,2004,545,,245,8255
Hugh Smith,2004,527,,246,8782
Hugh Smith,2004,1087,,247,9869
Hugh Smith,2004,166,,248,10035
Hugh Smith,2004,42,,249,10077
Hugh Smith,2004,56,,250,10133
Hugh Smith,2004,4,,251,10137
Hugh Smith,2004,5,,252,10142
Hugh Smith,2004,8,,253,10150
Hugh Smith,2004,11,,254,10161
Hugh Smith,2004,37,,255,10198
Hugh Smith,2004,295,,256,10493
Hugh Smith,2004,139,,257,10632
Hugh Smith,2004,50,,259,10682
Hugh Smith,2004,5,,260,10687
Hugh Smith,2004,83,,261,10770
Hugh Smith,2004,103,,262,10873
Hugh Smith,2004,34,,263,10907
Hugh Smith,2004,102,,264,11009
Hugh Smith,2004,19,,265,11028
Hugh Smith,2004,6,,266,11034
Hugh Smith,2004,5,,269,11039
Hugh Smith,2004,2,,270,11041
Hugh Smith,2004,2,,273,11043
Hugh Smith,2004,1,,274,11044
Hugh Smith,2004,1,,275,11045
Hugh Smith,2004,1,,276,11046
Hugh Smith,2005,2,,187,2
Hugh Smith,2005,2,,193,4
Hugh Smith,2005,2,,198,6
Hugh Smith,2005,2,,199,8
Hugh Smith,2005,1,,200,9
Hugh Smith,2005,4,,201,13
Hugh Smith,2005,1,,202,14
Hugh Smith,2005,6,,203,20
Hugh Smith,2005,1,,204,21
Hugh Smith,2005,1,,205,22
Hugh Smith,2005,9,,206,31
Hugh Smith,2005,3,,207,34
Hugh Smith,2005,3,,208,37
Hugh Smith,2005,21,,209,58
Hugh Smith,2005,69,,210,127
Hugh Smith,2005,58,,211,185
Hugh Smith,2005,69,,212,254
Hugh Smith,2005,127,,213,381
Hugh Smith,2005,69,,214,450
Hugh Smith,2005,127,,215,577
Hugh Smith,2005,160,,216,737
Hugh Smith,2005,208,,217,945
Hugh Smith,2005,225,,218,1170
Hugh Smith,2005,228,,219,1398
Hugh Smith,2005,119,,220,1517
Hugh Smith,2005,159,,221,1676
Hugh Smith,2005,81,,222,1757
Hugh Smith,2005,22,,223,1779
Hugh Smith,2005,3,,224,1782
Hugh Smith,2005,3,,225,1785
Hugh Smith,2005,23,,226,1808
Hugh Smith,2005,111,,227,1919
Hugh Smith,2005,116,,228,2035
Hugh Smith,2005,144,,229,2179
Hugh Smith,2005,224,,230,2403
Hugh Smith,2005,213,,231,2616
Hugh Smith,2005,955,,232,3571
Hugh Smith,2005,1268,,233,4839
Hugh Smith,2005,1549,,234,6388
Hugh Smith,2005,635,,235,7023
Hugh Smith,2005,279,,236,7302
Hugh Smith,2005,481,,237,7783
Hugh Smith,2005,182,,238,7965
Hugh Smith,2005,360,,239,8325
Hugh Smith,2005,309,,240,8634
Hugh Smith,2005,399,,241,9033
Hugh Smith,2005,268,,242,9301
Hugh Smith,2005,296,,243,9597
Hugh Smith,2005,1392,,244,10989
Hugh Smith,2005,818,,245,11807
Hugh Smith,2005,340,,246,12147
Hugh Smith,2005,192,,247,12339
Hugh Smith,2005,171,,248,12510
Hugh Smith,2005,319,,249,12829
Hugh Smith,2005,459,,250,13288
Hugh Smith,2005,116,,251,13404
Hugh Smith,2005,125,,252,13529
Hugh Smith,2005,166,,253,13695
Hugh Smith,2005,148,,254,13843
Hugh Smith,2005,81,,255,13924
Hugh Smith,2005,433,,256,14357
Hugh Smith,2005,43,,257,14400
Hugh Smith,2005,172,,259,14572
Hugh Smith,2005,144,,260,14716
Hugh Smith,2005,222,,261,14938
Hugh Smith,2005,67,,262,15005
Hugh Smith,2005,66,,263,15071
Hugh Smith,2005,10,,264,15081
Hugh Smith,2005,24,,265,15105
Hugh Smith,2005,10,,266,15115
Hugh Smith,2005,7,,267,15122
Hugh Smith,2005,7,,268,15129
Hugh Smith,2005,5,,269,15134
Hugh Smith,2005,33,,270,15167
Hugh Smith,2005,16,,271,15183
Hugh Smith,2005,10,,272,15193
Hugh Smith,2005,5,,273,15198
Hugh Smith,2005,2,,274,15200
Hugh Smith,2005,1,,276,15201
Hugh Smith,2005,4,,278,15205
Hugh Smith,2005,1,,279,15206
Hugh Smith,2005,1,,282,15207
Hugh Smith,2006,2,,214,2
Hugh Smith,2006,4,,215,6
Hugh Smith,2006,1,,216,7
Hugh Smith,2006,4,,217,11
Hugh Smith,2006,2,,218,13
Hugh Smith,2006,1,,219,14
Hugh Smith,2006,1,,220,15
Hugh Smith,2006,146,,221,161
Hugh Smith,2006,256,,222,417
Hugh Smith,2006,60,,223,477
Hugh Smith,2006,21,,224,498
Hugh Smith,2006,12,,225,510
Hugh Smith,2006,12,,226,522
Hugh Smith,2006,45,,227,567
Hugh Smith,2006,17,,228,584
Hugh Smith,2006,76,,229,660
Hugh Smith,2006,84,,230,744
Hugh Smith,2006,8,,231,752
Hugh Smith,2006,15,,232,767
Hugh Smith,2006,56,,233,823
Hugh Smith,2006,82,,234,905
Hugh Smith,2006,126,,235,1031
Hugh Smith,2006,93,,236,1124
Hugh Smith,2006,263,,237,1387
Hugh Smith,2006,86,,238,1473
Hugh Smith,2006,59,,239,1532
Hugh Smith,2006,769,,240,2301
Hugh Smith,2006,1150,,241,3451
Hugh Smith,2006,538,,242,3989
Hugh Smith,2006,291,,243,4280
Hugh Smith,2006,314,,244,4594
Hugh Smith,2006,185,,246,4779
Hugh Smith,2006,102,,247,4881
Hugh Smith,2006,308,,248,5189
Hugh Smith,2006,240,,249,5429
Hugh Smith,2006,344,,250,5773
Hugh Smith,2006,298,,251,6071
Hugh Smith,2006,32,,252,6103
Hugh Smith,2006,325,,253,6428
Hugh Smith,2006,87,,254,6515
Hugh Smith,2006,32,,255,6547
Hugh Smith,2006,189,,256,6736
Hugh Smith,2006,25,,257,6761
Hugh Smith,2006,46,,258,6807
Hugh Smith,2006,44,,259,6851
Hugh Smith,2006,99,,260,6950
Hugh Smith,2006,63,,261,7013
Hugh Smith,2006,9,,262,7022
Hugh Smith,2006,113,,263,7135
Hugh Smith,2006,30,,264,7165
Hugh Smith,2006,1,,265,7166
Hugh Smith,2006,14,,266,7180
Hugh Smith,2006,28,,267,7208
Hugh Smith,2006,24,,268,7232
Hugh Smith,2006,28,,269,7260
Hugh Smith,2006,9,,270,7269
Hugh Smith,2006,1,,272,7270
Hugh Smith,2006,2,,273,7272
Hugh Smith,2006,2,,276,7274
Hugh Smith,2006,1,,277,7275
Hugh Smith,2006,2,,278,7277
Hugh Smith,2006,2,,279,7279
Hugh Smith,2006,2,,281,7281
Hugh Smith,2006,1,,282,7282
Hugh Smith,2006,1,,285,7283
Hugh Smith,2006,1,,288,7284
Hugh Smith,2007,1,,194,1
Hugh Smith,2007,1,,203,2
Hugh Smith,2007,1,,204,3
Hugh Smith,2007,1,,205,4
Hugh Smith,2007,2,,206,6
Hugh Smith,2007,6,,207,12
Hugh Smith,2007,10,,208,22
Hugh Smith,2007,8,,209,30
Hugh Smith,2007,3,,211,33
Hugh Smith,2007,24,,212,57
Hugh Smith,2007,10,,213,67
Hugh Smith,2007,11,,214,78
Hugh Smith,2007,18,,215,96
Hugh Smith,2007,122,,216,218
Hugh Smith,2007,21,,217,239
Hugh Smith,2007,49,,218,288
Hugh Smith,2007,3,,219,291
Hugh Smith,2007,18,,220,309
Hugh Smith,2007,14,,221,323
Hugh Smith,2007,26,,222,349
Hugh Smith,2007,7,,223,356
Hugh Smith,2007,17,,224,373
Hugh Smith,2007,34,,225,407
Hugh Smith,2007,20,,226,427
Hugh Smith,2007,31,,227,458
Hugh Smith,2007,24,,228,482
Hugh Smith,2007,38,,229,520
Hugh Smith,2007,38,,230,558
Hugh Smith,2007,68,,231,626
Hugh Smith,2007,190,,232,816
Hugh Smith,2007,339,,233,1155
Hugh Smith,2007,62,,234,1217
Hugh Smith,2007,196,,235,1413
Hugh Smith,2007,142,,236,1555
Hugh Smith,2007,222,,237,1777
Hugh Smith,2007,869,,238,2646
Hugh Smith,2007,1402,,239,4048
Hugh Smith,2007,1472,,240,5520
Hugh Smith,2007,682,,247,6202
Hugh Smith,2007,335,,248,6537
Hugh Smith,2007,104,,249,6641
Hugh Smith,2007,96,,250,6737
Hugh Smith,2007,129,,251,6866
Hugh Smith,2007,90,,252,6956
Hugh Smith,2007,200,,253,7156
Hugh Smith,2007,229,,254,7385
Hugh Smith,2007,288,,255,7673
Hugh Smith,2007,293,,256,7966
Hugh Smith,2007,329,,257,8295
Hugh Smith,2008,1,,194,1
Hugh Smith,2008,1,,195,2
Hugh Smith,2008,3,,196,5
Hugh Smith,2008,4,,197,9
Hugh Smith,2008,2,,203,11
Hugh Smith,2008,1,,204,12
Hugh Smith,2008,1,,205,13
Hugh Smith,2008,2,,206,15
Hugh Smith,2008,10,,207,25
Hugh Smith,2008,5,,208,30
Hugh Smith,2008,2,,209,32
Hugh Smith,2008,1,,210,33
Hugh Smith,2008,6,,211,39
Hugh Smith,2008,16,,212,55
Hugh Smith,2008,14,,213,69
Hugh Smith,2008,7,,214,76
Hugh Smith,2008,11,,215,87
Hugh Smith,2008,3,,216,90
Hugh Smith,2008,10,,217,100
Hugh Smith,2008,6,,218,106
Hugh Smith,2008,1,,219,107
Hugh Smith,2008,1,,220,108
Hugh Smith,2008,1,,221,109
Hugh Smith,2008,2,,222,111
Hugh Smith,2008,9,,223,120
Hugh Smith,2008,2,,224,122
Hugh Smith,2008,54,,225,176
Hugh Smith,2008,70,,226,246
Hugh Smith,2008,244,,227,490
Hugh Smith,2008,5,,227,495
Hugh Smith,2008,106,,228,601
Hugh Smith,2008,133,,229,734
Hugh Smith,2008,420,,230,1154
Hugh Smith,2008,610,,231,1764
Hugh Smith,2008,642,,232,2406
Hugh Smith,2008,403,,233,2809
Hugh Smith,2008,379,,234,3188
Hugh Smith,2008,379,,235,3567
Hugh Smith,2008,417,,236,3984
Hugh Smith,2008,463,,237,4447
Hugh Smith,2008,147,,238,4594
Hugh Smith,2008,217,,239,4811
Hugh Smith,2008,209,,240,5020
Hugh Smith,2008,385,,241,5405
Hugh Smith,2008,233,,242,5638
Hugh Smith,2008,494,,243,6132
Hugh Smith,2008,310,,244,6442
Hugh Smith,2008,505,,245,6947
Hugh Smith,2008,496,,246,7443
Hugh Smith,2008,484,,247,7927
Hugh Smith,2008,167,,248,8094
Hugh Smith,2008,397,,249,8491
Hugh Smith,2008,27,,250,8518
Hugh Smith,2008,60,,251,8578
Hugh Smith,2008,48,,252,8626
Hugh Smith,2008,182,,253,8808
Hugh Smith,2008,271,,254,9079
Hugh Smith,2008,94,,255,9173
Hugh Smith,2008,113,,256,9286
Hugh Smith,2008,58,,257,9344
Hugh Smith,2008,200,,258,9544
Hugh Smith,2008,221,,259,9765
Hugh Smith,2008,42,,260,9807
Hugh Smith,2008,14,,261,9821
Hugh Smith,2008,27,,262,9848
Hugh Smith,2008,68,,263,9916
Hugh Smith,2008,16,,264,9932
Hugh Smith,2008,12,,266,9944
Hugh Smith,2008,10,,267,9954
Hugh Smith,2008,10,,268,9964
Hugh Smith,2008,7,,269,9971
Hugh Smith,2008,13,,270,9984
Hugh Smith,2008,6,,271,9990
Hugh Smith,2008,7,,272,9997
Hugh Smith,2008,1,,273,9998
Hugh Smith,2008,1,,275,9999
Hugh Smith,2009,2,,199,2
Hugh Smith,2009,1,,200,3
Hugh Smith,2009,1,,201,4
Hugh Smith,2009,1,,202,5
Hugh Smith,2009,1,,204,6
Hugh Smith,2009,1,,205,7
Hugh Smith,2009,1,,206,8
Hugh Smith,2009,3,,207,11
Hugh Smith,2009,1,,212,12
Hugh Smith,2009,2,,217,14
Hugh Smith,2009,1,,220,15
Hugh Smith,2009,1,,221,16
Hugh Smith,2009,232,,222,248
Hugh Smith,2009,943,,223,1191
Hugh Smith,2009,463,,224,1654
Hugh Smith,2009,630,,225,2284
Hugh Smith,2009,893,,226,3177
Hugh Smith,2009,551,,227,3728
Hugh Smith,2009,243,,228,3971
Hugh Smith,2009,501,,229,4472
Hugh Smith,2009,364,,230,4836
Hugh Smith,2009,999,,231,5835
Hugh Smith,2009,1190,,232,7025
Hugh Smith,2009,811,,235,7836
Hugh Smith,2009,1116,,236,8952
Hugh Smith,2009,762,,237,9714
Hugh Smith,2009,554,,238,10268
Hugh Smith,2009,594,,239,10862
Hugh Smith,2009,277,,240,11139
Hugh Smith,2009,574,,241,11713
Hugh Smith,2009,235,,242,11948
Hugh Smith,2009,204,,243,12152
Hugh Smith,2009,137,,244,12289
Hugh Smith,2009,923,,245,13212
Hugh Smith,2009,310,,246,13522
Hugh Smith,2009,161,,247,13683
Hugh Smith,2009,19,,248,13702
Hugh Smith,2009,35,,249,13737
Hugh Smith,2009,105,,250,13842
Hugh Smith,2009,107,,251,13949
Hugh Smith,2009,297,,252,14246
Hugh Smith,2009,332,,253,14578
Hugh Smith,2009,20,,254,14598
Hugh Smith,2009,77,,257,14675
Hugh Smith,2010,1,,183,1
Hugh Smith,2010,1,,201,2
Hugh Smith,2010,2,,202,4
Hugh Smith,2010,2,,204,6
Hugh Smith,2010,18,,205,24
Hugh Smith,2010,26,,206,50
Hugh Smith,2010,7,,207,57
Hugh Smith,2010,1,,208,58
Hugh Smith,2010,1,,209,59
Hugh Smith,2010,3,,210,62
Hugh Smith,2010,1,,218,63
Hugh Smith,2010,5,,219,68
Hugh Smith,2010,15,,220,83
Hugh Smith,2010,6,,221,89
Hugh Smith,2010,3,,222,92
Hugh Smith,2010,24,,223,116
Hugh Smith,2010,4,,224,120
Hugh Smith,2010,2,,225,122
Hugh Smith,2010,6,,226,128
Hugh Smith,2010,16,,227,144
Hugh Smith,2010,1,,228,145
Hugh Smith,2010,3,,229,148
Hugh Smith,2010,4,,230,152
Hugh Smith,2010,7,,231,159
Hugh Smith,2010,33,,232,192
Hugh Smith,2010,16,,233,208
Hugh Smith,2010,45,,234,253
Hugh Smith,2010,101,,235,354
Hugh Smith,2010,511,,236,865
Hugh Smith,2010,831,,237,1696
Hugh Smith,2010,1600,,238,3296
Hugh Smith,2010,1356,,239,4652
Hugh Smith,2010,135,,240,4787
Hugh Smith,2010,1579,,241,6366
Hugh Smith,2010,1187,,242,7553
Hugh Smith,2010,606,,243,8159
Hugh Smith,2010,468,,244,8627
Hugh Smith,2010,417,,245,9044
Hugh Smith,2010,224,,246,9268
Hugh Smith,2010,135,,247,9403
Hugh Smith,2010,65,,248,9468
Hugh Smith,2010,51,,249,9519
Hugh Smith,2010,83,,250,9602
Hugh Smith,2010,428,,251,10030
Hugh Smith,2010,156,,252,10186
Hugh Smith,2010,58,,253,10244
Hugh Smith,2010,110,,254,10354
Hugh Smith,2010,44,,255,10398
Hugh Smith,2010,164,,256,10562
Hugh Smith,2010,20,,257,10582
Hugh Smith,2010,123,,258,10705
Hugh Smith,2010,50,,259,10755
Hugh Smith,2010,71,,260,10826
Hugh Smith,2010,29,,261,10855
Hugh Smith,2010,18,,262,10873
Hugh Smith,2010,10,,263,10883
Hugh Smith,2010,9,,264,10892
Hugh Smith,2010,3,,265,10895
Hugh Smith,2010,10,,266,10905
Hugh Smith,2010,11,,267,10916
Hugh Smith,2010,22,,268,10938
Hugh Smith,2010,19,,269,10957
Hugh Smith,2010,2,,272,10959
Hugh Smith,2010,1,,273,10960
Hugh Smith,2010,1,,274,10961
Hugh Smith,2010,1,,276,10962
Hugh Smith,2010,1,,277,10963
Hugh Smith,2010,1,,278,10964
Hugh Smith,2011,1,,194,1
Hugh Smith,2011,1,,195,2
Hugh Smith,2011,1,,201,3
Hugh Smith,2011,1,,202,4
Hugh Smith,2011,9,,205,13
Hugh Smith,2011,12,,206,25
Hugh Smith,2011,4,,207,29
Hugh Smith,2011,2,,208,31
Hugh Smith,2011,13,,209,44
Hugh Smith,2011,95,,210,139
Hugh Smith,2011,48,,211,187
Hugh Smith,2011,23,,212,210
Hugh Smith,2011,10,,213,220
Hugh Smith,2011,16,,214,236
Hugh Smith,2011,9,,215,245
Hugh Smith,2011,10,,216,255
Hugh Smith,2011,12,,217,267
Hugh Smith,2011,6,,218,273
Hugh Smith,2011,20,,219,293
Hugh Smith,2011,9,,220,302
Hugh Smith,2011,26,,221,328
Hugh Smith,2011,19,,222,347
Hugh Smith,2011,26,,223,373
Hugh Smith,2011,28,,224,401
Hugh Smith,2011,38,,225,439
Hugh Smith,2011,54,,226,493
Hugh Smith,2011,57,,227,550
Hugh Smith,2011,424,,228,974
Hugh Smith,2011,819,,229,1793
Hugh Smith,2011,492,,230,2285
Hugh Smith,2011,876,,231,3161
Hugh Smith,2011,486,,232,3647
Hugh Smith,2011,17,,234,3664
Hugh Smith,2011,243,,235,3907
Hugh Smith,2011,172,,237,4079
Hugh Smith,2011,304,,238,4383
Hugh Smith,2011,830,,239,5213
Hugh Smith,2011,365,,240,5578
Hugh Smith,2011,761,,241,6339
Hugh Smith,2011,532,,242,6871
Hugh Smith,2011,690,,243,7561
Hugh Smith,2011,886,,244,8447
Hugh Smith,2011,315,,245,8762
Hugh Smith,2011,443,,246,9205
Hugh Smith,2011,658,,247,9863
Hugh Smith,2011,146,,248,10009
Hugh Smith,2011,228,,256,10237
Hugh Smith,2011,425,,257,10662
Hugh Smith,2011,162,,258,10824
Hugh Smith,2011,166,,259,10990
Hugh Smith,2011,55,,260,11045
Hugh Smith,2011,58,,261,11103
Hugh Smith,2011,18,,263,11121
Hugh Smith,2011,13,,266,11134
Hugh Smith,2011,4,,267,11138
Hugh Smith,2011,1,,268,11139
Hugh Smith,2011,6,,269,11145
Hugh Smith,2011,2,,270,11147
Hugh Smith,2011,6,,271,11153
Hugh Smith,2011,3,,273,11156
Hugh Smith,2011,1,,276,11157
Hugh Smith,2011,1,,278,11158
Hugh Smith,2011,2,,280,11160
Hugh Smith,2011,3,,281,11163
Hugh Smith,2011,2,,282,11165
Hugh Smith,2011,1,,283,11166
Hugh Smith,2011,1,,299,11167
Hugh Smith,2012,1,,193,1
Hugh Smith,2012,2,,195,3
Hugh Smith,2012,4,,208,7
Hugh Smith,2012,2,,211,9
Hugh Smith,2012,19,,213,28
Hugh Smith,2012,79,,214,107
Hugh Smith,2012,47,,215,154
Hugh Smith,2012,49,,216,203
Hugh Smith,2012,21,,217,224
Hugh Smith,2012,43,,218,267
Hugh Smith,2012,40,,219,307
Hugh Smith,2012,118,,220,425
Hugh Smith,2012,85,,221,510
Hugh Smith,2012,184,,222,694
Hugh Smith,2012,103,,223,797
Hugh Smith,2012,33,,224,830
Hugh Smith,2012,89,,225,919
Hugh Smith,2012,38,,226,957
Hugh Smith,2012,188,,227,1145
Hugh Smith,2012,84,,228,1229
Hugh Smith,2012,51,,229,1280
Hugh Smith,2012,80,,230,1360
Hugh Smith,2012,71,,231,1431
Hugh Smith,2012,175,,232,1606
Hugh Smith,2012,211,,233,1817
Hugh Smith,2012,227,,234,2044
Hugh Smith,2012,188,,235,2232
Hugh Smith,2012,194,,236,2426
Hugh Smith,2012,169,,237,2595
Hugh Smith,2012,82,,238,2677
Hugh Smith,2012,95,,239,2772
Hugh Smith,2012,71,,240,2843
Hugh Smith,2012,307,,241,3150
Hugh Smith,2012,223,,242,3373
Hugh Smith,2012,134,,243,3507
Hugh Smith,2012,158,,244,3665
Hugh Smith,2012,86,,245,3751
Hugh Smith,2012,108,,246,3859
Hugh Smith,2012,94,,247,3953
Hugh Smith,2012,86,,248,4039
Hugh Smith,2012,51,,249,4090
Hugh Smith,2012,24,,250,4114
Hugh Smith,2012,9,,251,4123
Hugh Smith,2012,197,,252,4320
Hugh Smith,2012,105,,253,4425
Hugh Smith,2012,21,,254,4446
Hugh Smith,2012,18,,255,4464
Hugh Smith,2012,30,,256,4494
Hugh Smith,2012,14,,257,4508
Hugh Smith,2012,2,,259,4510
Hugh Smith,2012,19,,260,4529
Hugh Smith,2012,11,,261,4540
Hugh Smith,2012,6,,262,4546
Hugh Smith,2012,11,,263,4557
Hugh Smith,2012,8,,264,4565
Hugh Smith,2012,8,,265,4573
Hugh Smith,2012,3,,266,4576
Hugh Smith,2012,4,,267,4580
Hugh Smith,2012,4,,268,4584
Hugh Smith,2012,4,,269,4588
Hugh Smith,2012,5,,270,4593
Hugh Smith,2012,1,,272,4594
Hugh Smith,2012,1,,278,4595
Kadashan East,1969,0,,182,0
Kadashan East,1969,0,,183,0
Kadashan East,1969,0,,184,0
Kadashan East,1969,0,,185,0
Kadashan East,1969,0,,186,0
Kadashan East,1969,0,,187,0
Kadashan East,1969,0,,188,0
Kadashan East,1969,50,,189,50
Kadashan East,1969,8,,190,58
Kadashan East,1969,632,,191,690
Kadashan East,1969,828,,192,1518
Kadashan East,1969,160,,193,1678
Kadashan East,1969,227,,194,1905
Kadashan East,1969,705,,195,2610
Kadashan East,1969,676,,196,3286
Kadashan East,1969,7,,197,3293
Kadashan East,1969,680,,198,3973
Kadashan East,1969,1008,,199,4981
Kadashan East,1969,4735,,200,9716
Kadashan East,1969,193,,201,9909
Kadashan East,1969,7240,,202,17149
Kadashan East,1969,1954,,203,19103
Kadashan East,1969,6822,,204,25925
Kadashan East,1969,49,,205,25974
Kadashan East,1969,5339,,206,31313
Kadashan East,1969,300,,207,31613
Kadashan East,1969,10,,208,31623
Kadashan East,1969,0,,209,31623
Kadashan East,1969,16,,210,31639
Kadashan East,1969,186,,211,31825
Kadashan East,1969,106,,212,31931
Kadashan East,1969,410,,213,32341
Kadashan East,1969,68,,214,32409
Kadashan East,1969,4,,215,32413
Kadashan East,1969,898,,216,33311
Kadashan East,1969,145,,217,33456
Kadashan East,1969,1483,,218,34939
Kadashan East,1969,2243,,219,37182
Kadashan East,1969,639,,220,37821
Kadashan East,1969,0,,221,37821
Kadashan East,1969,0,,222,37821
Kadashan East,1969,0,,223,37821
Kadashan East,1969,14,,224,37835
Kadashan East,1969,2,,225,37837
Kadashan East,1969,10,,226,37847
Kadashan East,1969,6,,227,37853
Kadashan East,1969,15,,228,37868
Kadashan East,1969,2,,229,37870
Kadashan East,1969,0,,230,37870
Kadashan East,1969,0,,231,37870
Kadashan East,1969,0,,232,37870
Kadashan East,1969,0,,233,37870
Kadashan East,1969,0,,234,37870
Kadashan East,1970,0,,182,0
Kadashan East,1970,0,,183,0
Kadashan East,1970,10,,184,10
Kadashan East,1970,2066,,185,2076
Kadashan East,1970,771,,186,2847
Kadashan East,1970,3030,,187,5877
Kadashan East,1970,4000,,188,9877
Kadashan East,1970,4000,,189,13877
Kadashan East,1970,230,,190,14107
Kadashan East,1970,776,,191,14883
Kadashan East,1970,673,,192,15556
Kadashan East,1970,4419,,193,19975
Kadashan East,1970,0,,194,19975
Kadashan East,1970,2664,,195,22639
Kadashan East,1970,1463,,196,24102
Kadashan East,1970,1232,,197,25334
Kadashan East,1970,4857,,198,30191
Kadashan East,1970,5795,,199,35986
Kadashan East,1970,930,,200,36916
Kadashan East,1970,364,,201,37280
Kadashan East,1970,799,,202,38079
Kadashan East,1970,3104,,203,41183
Kadashan East,1970,902,,204,42085
Kadashan East,1970,1274,,205,43359
Kadashan East,1970,0,,206,43359
Kadashan East,1970,149,,207,43508
Kadashan East,1970,2957,,208,46465
Kadashan East,1970,1429,,209,47894
Kadashan East,1970,1080,,210,48974
Kadashan East,1970,658,,211,49632
Kadashan East,1970,1122,,212,50754
Kadashan East,1970,3013,,213,53767
Kadashan East,1970,874,,214,54641
Kadashan East,1970,270,,215,54911
Kadashan East,1970,3088,,216,57999
Kadashan East,1970,2160,,217,60159
Kadashan East,1970,2994,,218,63153
Kadashan East,1970,815,,219,63968
Kadashan East,1970,929,,220,64897
Kadashan East,1970,10787,,221,75684
Kadashan East,1970,46,,222,75730
Kadashan East,1970,1080,,223,76810
Kadashan East,1970,9,,224,76819
Kadashan East,1970,14,,225,76833
Kadashan East,1970,2000,,226,78833
Kadashan East,1971,0,,188,0
Kadashan East,1971,0,,189,0
Kadashan East,1971,0,,190,0
Kadashan East,1971,0,,191,0
Kadashan East,1971,0,,192,0
Kadashan East,1971,0,,193,0
Kadashan East,1971,0,,194,0
Kadashan East,1971,0,,195,0
Kadashan East,1971,2,,196,2
Kadashan East,1971,3662,,197,3664
Kadashan East,1971,76,,198,3740
Kadashan East,1971,150,,199,3890
Kadashan East,1971,178,,200,4068
Kadashan East,1971,1651,,201,5719
Kadashan East,1971,543,,202,6262
Kadashan East,1971,279,,203,6541
Kadashan East,1971,1338,,204,7879
Kadashan East,1971,843,,205,8722
Kadashan East,1971,209,,206,8931
Kadashan East,1971,902,,207,9833
Kadashan East,1971,1331,,208,11164
Kadashan East,1971,1657,,209,12821
Kadashan East,1971,689,,210,13510
Kadashan East,1971,1708,,211,15218
Kadashan East,1971,113,,212,15331
Kadashan East,1971,22473,,213,37804
Kadashan East,1971,884,,214,38688
Kadashan East,1971,100,,215,38788
Kadashan East,1971,69,,216,38857
Kadashan East,1971,0,,217,38857
Kadashan East,1971,2223,,218,41080
Kadashan East,1971,87,,219,41167
Kadashan East,1971,1026,,220,42193
Kadashan East,1971,515,,221,42708
Kadashan East,1971,500,,222,43208
Kadashan East,1971,300,,223,43508
Kadashan East,1971,650,,224,44158
Kadashan East,1971,539,,225,44697
Kadashan East,1971,706,,226,45403
Kadashan East,1971,618,,227,46021
Kadashan East,1971,1148,,228,47169
Kadashan East,1971,1056,,229,48225
Kadashan East,1971,2872,,230,51097
Kadashan East,1971,2800,,231,53897
Kadashan East,1972,4,,189,4
Kadashan East,1972,529,,190,533
Kadashan East,1972,219,,191,752
Kadashan East,1972,764,,192,1516
Kadashan East,1972,100,,193,1616
Kadashan East,1972,3,,194,1619
Kadashan East,1972,6,,195,1625
Kadashan East,1972,83,,196,1708
Kadashan East,1972,0,,197,1708
Kadashan East,1972,837,,198,2545
Kadashan East,1972,263,,199,2808
Kadashan East,1972,111,,200,2919
Kadashan East,1972,420,,201,3339
Kadashan East,1972,332,,202,3671
Kadashan East,1972,550,,203,4221
Kadashan East,1972,344,,204,4565
Kadashan East,1972,435,,205,5000
Kadashan East,1972,11067,,206,16067
Kadashan East,1972,57,,207,16124
Kadashan East,1972,385,,208,16509
Kadashan East,1972,1200,,209,17709
Kadashan East,1972,300,,210,18009
Kadashan East,1972,443,,211,18452
Kadashan East,1972,844,,212,19296
Kadashan East,1972,693,,213,19989
Kadashan East,1972,0,,214,19989
Kadashan East,1972,504,,215,20493
Kadashan East,1972,1104,,216,21597
Kadashan East,1972,22,,217,21619
Kadashan East,1972,1,,218,21620
Kadashan East,1972,122,,219,21742
Kadashan East,1972,802,,220,22544
Kadashan East,1972,81,,221,22625
Kadashan East,1972,272,,222,22897
Kadashan East,1972,275,,223,23172
Kadashan East,1972,306,,224,23478
Kadashan East,1972,615,,225,24093
Kadashan East,1972,1476,,226,25569
Kadashan East,1972,811,,227,26380
Kadashan East,1972,1301,,228,27681
Kadashan East,1972,29,,229,27710
Kadashan East,1972,153,,230,27863
Kadashan East,1972,240,,231,28103
Kadashan East,1972,305,,232,28408
Kadashan East,1972,666,,233,29074
Kadashan East,1972,307,,234,29381
Kadashan East,1972,869,,235,30250
Kadashan East,1972,800,,236,31050
Kadashan East,1972,700,,237,31750
Kadashan East,1972,600,,238,32350
Kadashan East,1972,500,,239,32850
Kadashan East,1972,400,,240,33250
Kadashan East,1972,300,,241,33550
Kadashan East,1972,100,,242,33650
Kadashan East,1973,0,,185,0
Kadashan East,1973,0,,186,0
Kadashan East,1973,0,,187,0
Kadashan East,1973,0,,188,0
Kadashan East,1973,3,,189,3
Kadashan East,1973,13,,190,16
Kadashan East,1973,20,,191,36
Kadashan East,1973,28,,192,64
Kadashan East,1973,945,,193,1009
Kadashan East,1973,241,,194,1250
Kadashan East,1973,936,,195,2186
Kadashan East,1973,0,,196,2186
Kadashan East,1973,176,,197,2362
Kadashan East,1973,18,,198,2380
Kadashan East,1973,985,,199,3365
Kadashan East,1973,6867,,200,10232
Kadashan East,1973,11597,,201,21829
Kadashan East,1973,210,,202,22039
Kadashan East,1973,413,,203,22452
Kadashan East,1973,865,,204,23317
Kadashan East,1973,3041,,205,26358
Kadashan East,1973,2739,,206,29097
Kadashan East,1973,3916,,207,33013
Kadashan East,1973,3963,,208,36976
Kadashan East,1973,10720,,209,47696
Kadashan East,1973,11832,,210,59528
Kadashan East,1973,0,,211,59528
Kadashan East,1973,783,,212,60311
Kadashan East,1973,23,,213,60334
Kadashan East,1973,119,,214,60453
Kadashan East,1973,4846,,215,65299
Kadashan East,1973,151,,216,65450
Kadashan East,1973,0,,217,65450
Kadashan East,1973,0,,218,65450
Kadashan East,1973,0,,219,65450
Kadashan East,1973,428,,220,65878
Kadashan East,1973,95,,221,65973
Kadashan East,1974,458,,190,458
Kadashan East,1974,1382,,191,1840
Kadashan East,1974,1139,,192,2979
Kadashan East,1974,633,,193,3612
Kadashan East,1974,725,,194,4337
Kadashan East,1974,3,,195,4340
Kadashan East,1974,43,,196,4383
Kadashan East,1974,34,,197,4417
Kadashan East,1974,601,,198,5018
Kadashan East,1974,34,,199,5052
Kadashan East,1974,54,,200,5106
Kadashan East,1974,24,,201,5130
Kadashan East,1974,1379,,202,6509
Kadashan East,1974,23,,203,6532
Kadashan East,1974,8005,,204,14537
Kadashan East,1974,5588,,205,20125
Kadashan East,1974,64,,206,20189
Kadashan East,1974,0,,207,20189
Kadashan East,1974,46,,208,20235
Kadashan East,1974,417,,209,20652
Kadashan East,1974,971,,210,21623
Kadashan East,1974,1450,,211,23073
Kadashan East,1974,1380,,212,24453
Kadashan East,1974,1483,,213,25936
Kadashan East,1974,916,,214,26852
Kadashan East,1974,272,,215,27124
Kadashan East,1974,1638,,216,28762
Kadashan East,1974,794,,217,29556
Kadashan East,1974,1224,,218,30780
Kadashan East,1974,0,,219,30780
Kadashan East,1974,1857,,220,32637
Kadashan East,1974,838,,221,33475
Kadashan East,1974,1250,,222,34725
Kadashan East,1974,731,,223,35456
Kadashan East,1974,0,,224,35456
Kadashan East,1974,1205,,225,36661
Kadashan East,1974,809,,226,37470
Kadashan East,1974,300,,227,37770
Kadashan East,1974,809,,228,38579
Kadashan East,1974,737,,229,39316
Kadashan East,1974,1064,,230,40380
Kadashan East,1974,736,,231,41116
Kadashan East,1974,269,,232,41385
Kadashan East,1974,276,,233,41661
Kadashan East,1974,827,,234,42488
Kadashan East,1974,741,,235,43229
Kadashan East,1975,93,,203,93
Kadashan East,1975,565,,204,658
Kadashan East,1975,216,,205,874
Kadashan East,1975,4,,206,878
Kadashan East,1975,653,,207,1531
Kadashan East,1975,4738,,208,6269
Kadashan East,1975,0,,209,6269
Kadashan East,1975,0,,210,6269
Kadashan East,1975,229,,211,6498
Kadashan East,1975,291,,212,6789
Kadashan East,1975,1766,,213,8555
Kadashan East,1975,0,,214,8555
Kadashan East,1975,120,,215,8675
Kadashan East,1975,802,,216,9477
Kadashan East,1975,844,,217,10321
Kadashan East,1975,3074,,218,13395
Kadashan East,1975,458,,219,13853
Kadashan East,1975,1188,,220,15041
Kadashan East,1975,2237,,221,17278
Kadashan East,1975,151,,222,17429
Kadashan East,1975,16,,223,17445
Kadashan East,1975,71,,224,17516
Kadashan East,1975,0,,225,17516
Kadashan East,1975,282,,226,17798
Kadashan East,1975,367,,227,18165
Kadashan East,1975,319,,228,18484
Kadashan East,1975,275,,229,18759
Kadashan East,1976,1,,199,1
Kadashan East,1976,20,,200,21
Kadashan East,1976,24,,201,45
Kadashan East,1976,300,,202,345
Kadashan East,1976,0,,203,345
Kadashan East,1976,0,,204,345
Kadashan East,1976,0,,205,345
Kadashan East,1976,11,,206,356
Kadashan East,1976,361,,207,717
Kadashan East,1976,723,,208,1440
Kadashan East,1976,304,,209,1744
Kadashan East,1976,908,,210,2652
Kadashan East,1976,41,,211,2693
Kadashan East,1976,1035,,212,3728
Kadashan East,1976,2165,,213,5893
Kadashan East,1976,510,,214,6403
Kadashan East,1976,700,,215,7103
Kadashan East,1976,900,,216,8003
Kadashan East,1976,1503,,217,9506
Kadashan East,1976,1310,,218,10816
Kadashan East,1976,20,,219,10836
Kadashan East,1976,2757,,220,13593
Kadashan East,1976,818,,221,14411
Kadashan East,1976,4800,,222,19211
Kadashan East,1976,255,,223,19466
Kadashan East,1976,0,,224,19466
Kadashan East,1976,5000,,225,24466
Kadashan East,1977,511,,190,511
Kadashan East,1977,897,,191,1408
Kadashan East,1977,14,,192,1422
Kadashan East,1977,59,,193,1481
Kadashan East,1977,111,,194,1592
Kadashan East,1977,42,,195,1634
Kadashan East,1977,6312,,196,7946
Kadashan East,1977,1395,,197,9341
Kadashan East,1977,62,,198,9403
Kadashan East,1977,0,,199,9403
Kadashan East,1977,101,,200,9504
Kadashan East,1977,127,,201,9631
Kadashan East,1977,44,,202,9675
Kadashan East,1977,148,,203,9823
Kadashan East,1977,3178,,204,13001
Kadashan East,1977,15425,,205,28426
Kadashan East,1977,5900,,206,34326
Kadashan East,1977,517,,207,34843
Kadashan East,1977,200,,208,35043
Kadashan East,1977,1042,,209,36085
Kadashan East,1977,1566,,210,37651
Kadashan East,1977,4126,,211,41777
Kadashan East,1977,2066,,212,43843
Kadashan East,1977,639,,213,44482
Kadashan East,1977,1175,,214,45657
Kadashan East,1977,618,,215,46275
Kadashan East,1977,978,,216,47253
Kadashan East,1977,1224,,217,48477
Kadashan East,1977,1125,,218,49602
Kadashan East,1977,532,,219,50134
Kadashan East,1977,3702,,220,53836
Kadashan East,1977,1350,,221,55186
Kadashan East,1977,1443,,222,56629
Kadashan East,1977,5654,,223,62283
Kadashan East,1977,100,,224,62383
Kadashan East,1977,70,,225,62453
Kadashan East,1977,140,,226,62593
Kadashan East,1977,775,,227,63368
Kadashan East,1977,400,,228,63768
Kadashan East,1977,135,,229,63903
Kadashan East,1977,625,,230,64528
Kadashan East,1977,185,,231,64713
Kadashan East,1977,120,,232,64833
Kadashan East,1977,160,,233,64993
Kadashan East,1977,284,,234,65277
Kadashan East,1977,255,,235,65532
Kadashan East,1977,147,,236,65679
Kadashan East,1977,412,,237,66091
Kadashan East,1977,340,,238,66431
Kadashan East,1977,1214,,239,67645
Kadashan East,1977,1398,,240,69043
Kadashan East,1977,652,,241,69695
Kadashan East,1978,8,,182,8
Kadashan East,1978,42,,183,50
Kadashan East,1978,85,,184,135
Kadashan East,1978,85,,185,220
Kadashan East,1978,169,,186,389
Kadashan East,1978,211,,187,600
Kadashan East,1978,245,,188,845
Kadashan East,1978,730,,189,1575
Kadashan East,1978,182,,190,1757
Kadashan East,1978,832,,191,2589
Kadashan East,1978,1980,,192,4569
Kadashan East,1978,9603,,193,14172
Kadashan East,1978,4764,,194,18936
Kadashan East,1978,3020,,195,21956
Kadashan East,1978,7800,,196,29756
Kadashan East,1978,5500,,197,35256
Kadashan East,1978,330,,198,35586
Kadashan East,1978,842,,199,36428
Kadashan East,1978,2340,,200,38768
Kadashan East,1978,7021,,201,45789
Kadashan East,1978,7672,,202,53461
Kadashan East,1978,5125,,203,58586
Kadashan East,1978,5010,,204,63596
Kadashan East,1978,360,,205,63956
Kadashan East,1978,3027,,206,66983
Kadashan East,1978,2672,,207,69655
Kadashan East,1978,610,,208,70265
Kadashan East,1978,20052,,209,90317
Kadashan East,1978,490,,210,90807
Kadashan East,1978,682,,211,91489
Kadashan East,1978,4265,,212,95754
Kadashan East,1978,6150,,213,101904
Kadashan East,1978,1432,,214,103336
Kadashan East,1978,2025,,215,105361
Kadashan East,1978,435,,216,105796
Kadashan East,1978,206,,217,106002
Kadashan East,1978,1454,,218,107456
Kadashan East,1978,1522,,219,108978
Kadashan East,1978,3982,,220,112960
Kadashan East,1978,3893,,221,116853
Kadashan East,1978,5410,,222,122263
Kadashan East,1978,490,,223,122753
Kadashan East,1978,38,,224,122791
Kadashan East,1978,21,,225,122812
Kadashan East,1978,34,,226,122846
Kadashan East,1978,189,,227,123035
Kadashan East,1978,307,,228,123342
Kadashan East,1978,6764,,229,130106
Kadashan East,1978,560,,230,130666
Kadashan East,1978,121,,231,130787
Kadashan East,1978,79,,232,130866
Kadashan East,1978,860,,233,131726
Kadashan East,1978,69,,234,131795
Kadashan East,1978,357,,235,132152
Kadashan East,1978,449,,236,132601
Kadashan East,1978,0,,237,132601
Kadashan East,1978,510,,238,133111
Kadashan East,1978,123,,239,133234
Kadashan East,1979,1,,187,1
Kadashan East,1979,0,,188,1
Kadashan East,1979,26,,189,27
Kadashan East,1979,34,,190,61
Kadashan East,1979,35,,191,96
Kadashan East,1979,0,,192,96
Kadashan East,1979,0,,193,96
Kadashan East,1979,0,,194,96
Kadashan East,1979,0,,195,96
Kadashan East,1979,79,,196,175
Kadashan East,1979,4339,,197,4514
Kadashan East,1979,34743,,198,39257
Kadashan East,1979,2399,,199,41656
Kadashan East,1979,2521,,200,44177
Kadashan East,1979,2500,,201,46677
Kadashan East,1979,14133,,202,60810
Kadashan East,1979,2782,,203,63592
Kadashan East,1979,530,,204,64122
Kadashan East,1979,2772,,205,66894
Kadashan East,1979,1385,,206,68279
Kadashan East,1979,189,,207,68468
Kadashan East,1979,141,,208,68609
Kadashan East,1979,252,,209,68861
Kadashan East,1979,1169,,210,70030
Kadashan East,1979,1065,,211,71095
Kadashan East,1979,4056,,212,75151
Kadashan East,1979,5333,,213,80484
Kadashan East,1979,16742,,214,97226
Kadashan East,1979,0,,215,97226
Kadashan East,1979,0,,216,97226
Kadashan East,1979,158,,217,97384
Kadashan East,1979,284,,218,97668
Kadashan East,1979,0,,219,97668
Kadashan East,1979,404,,220,98072
Kadashan East,1979,407,,221,98479
Kadashan East,1979,1220,,222,99699
Kadashan East,1979,566,,223,100265
Kadashan East,1979,726,,224,100991
Kadashan East,1979,1335,,225,102326
Kadashan East,1979,1441,,226,103767
Kadashan East,1979,1210,,227,104977
Kadashan East,1979,590,,228,105567
Kadashan East,1979,115,,229,105682
Kadashan East,1979,1527,,230,107209
Kadashan East,1979,359,,231,107568
Kadashan East,1979,233,,232,107801
Kadashan East,1979,50,,233,107851
Kadashan East,1980,4696,,194,4696
Kadashan East,1980,3346,,195,8042
Kadashan East,1980,692,,196,8734
Kadashan East,1980,0,,197,8734
Kadashan East,1980,77,,198,8811
Kadashan East,1980,0,,199,8811
Kadashan East,1980,3141,,200,11952
Kadashan East,1980,10420,,201,22372
Kadashan East,1980,3322,,202,25694
Kadashan East,1980,1309,,203,27003
Kadashan East,1980,3934,,204,30937
Kadashan East,1980,103,,205,31040
Kadashan East,1980,0,,206,31040
Kadashan East,1980,0,,207,31040
Kadashan East,1980,0,,208,31040
Kadashan East,1980,116,,209,31156
Kadashan East,1980,693,,210,31849
Kadashan East,1980,5072,,211,36921
Kadashan East,1980,5165,,212,42086
Kadashan East,1980,3034,,213,45120
Kadashan East,1980,3034,,214,48154
Kadashan East,1980,3034,,215,51188
Kadashan East,1980,3034,,216,54222
Kadashan East,1980,3034,,217,57256
Kadashan East,1980,3034,,218,60290
Kadashan East,1980,3034,,219,63324
Kadashan East,1980,14036,,220,77360
Kadashan East,1980,0,,221,77360
Kadashan East,1980,3030,,222,80390
Kadashan East,1980,0,,223,80390
Kadashan East,1980,3010,,224,83400
Kadashan East,1980,1959,,225,85359
Kadashan East,1980,1492,,226,86851
Kadashan East,1980,86,,227,86937
Kadashan East,1980,13031,,228,99968
Kadashan East,1980,63,,229,100031
Kadashan East,1981,3166,,187,3166
Kadashan East,1981,1153,,188,4319
Kadashan East,1981,7646,,189,11965
Kadashan East,1981,0,,190,11965
Kadashan East,1981,1030,,191,12995
Kadashan East,1981,8227,,192,21222
Kadashan East,1981,4723,,193,25945
Kadashan East,1981,1941,,194,27886
Kadashan East,1981,2933,,195,30819
Kadashan East,1981,2954,,196,33773
Kadashan East,1981,1020,,197,34793
Kadashan East,1981,2264,,198,37057
Kadashan East,1981,2061,,199,39118
Kadashan East,1981,2444,,200,41562
Kadashan East,1981,517,,201,42079
Kadashan East,1981,12,,202,42091
Kadashan East,1981,0,,203,42091
Kadashan East,1981,82,,204,42173
Kadashan East,1981,245,,205,42418
Kadashan East,1981,1992,,206,44410
Kadashan East,1981,706,,207,45116
Kadashan East,1981,31501,,208,76617
Kadashan East,1981,551,,209,77168
Kadashan East,1981,0,,210,77168
Kadashan East,1981,304,,211,77472
Kadashan East,1981,220,,212,77692
Kadashan East,1981,833,,213,78525
Kadashan East,1981,159,,214,78684
Kadashan East,1981,8607,,215,87291
Kadashan East,1982,252,,193,252
Kadashan East,1982,191,,194,443
Kadashan East,1982,6804,,195,7247
Kadashan East,1982,1085,,196,8332
Kadashan East,1982,16,,197,8348
Kadashan East,1982,362,,198,8710
Kadashan East,1982,1147,,199,9857
Kadashan East,1982,1110,,200,10967
Kadashan East,1982,2,,201,10969
Kadashan East,1982,0,,202,10969
Kadashan East,1982,31,,203,11000
Kadashan East,1982,3,,204,11003
Kadashan East,1982,56,,205,11059
Kadashan East,1982,164,,206,11223
Kadashan East,1982,206,,207,11429
Kadashan East,1982,246,,208,11675
Kadashan East,1982,370,,209,12045
Kadashan East,1982,3781,,210,15826
Kadashan East,1982,51,,211,15877
Kadashan East,1982,1892,,212,17769
Kadashan East,1982,812,,213,18581
Kadashan East,1982,780,,214,19361
Kadashan East,1982,381,,215,19742
Kadashan East,1982,8430,,216,28172
Kadashan East,1982,90,,217,28262
Kadashan East,1982,2051,,218,30313
Kadashan East,1982,4176,,219,34489
Kadashan East,1982,14343,,220,48832
Kadashan East,1982,4000,,221,52832
Kadashan East,1982,652,,222,53484
Kadashan East,1982,3476,,223,56960
Kadashan East,1982,512,,224,57472
Kadashan East,1982,180,,225,57652
Kadashan East,1982,937,,226,58589
Kadashan East,1982,3745,,227,62334
Kadashan East,1982,1214,,228,63548
Kadashan East,1982,1219,,229,64767
Kadashan East,1982,1271,,230,66038
Kadashan East,1982,0,,231,66038
Kadashan East,1982,105,,232,66143
Kadashan East,1982,1646,,233,67789
Kadashan East,1982,1662,,234,69451
Kadashan East,1983,21,,191,21
Kadashan East,1983,31,,192,52
Kadashan East,1983,84,,193,136
Kadashan East,1983,0,,194,136
Kadashan East,1983,0,,195,136
Kadashan East,1983,4,,196,140
Kadashan East,1983,30,,197,170
Kadashan East,1983,2,,198,172
Kadashan East,1983,192,,199,364
Kadashan East,1983,2310,,200,2674
Kadashan East,1983,1535,,201,4209
Kadashan East,1983,851,,202,5060
Kadashan East,1983,23869,,203,28929
Kadashan East,1983,3864,,204,32793
Kadashan East,1983,99,,205,32892
Kadashan East,1983,33,,206,32925
Kadashan East,1983,632,,207,33557
Kadashan East,1983,3620,,208,37177
Kadashan East,1983,3068,,209,40245
Kadashan East,1983,1158,,210,41403
Kadashan East,1983,911,,211,42314
Kadashan East,1983,35230,,212,77544
Kadashan East,1983,742,,213,78286
Kadashan East,1983,160,,214,78446
Kadashan East,1983,459,,215,78905
Kadashan East,1983,193,,216,79098
Kadashan East,1983,428,,217,79526
Kadashan East,1983,1102,,218,80628
Kadashan East,1983,11443,,219,92071
Kadashan East,1983,359,,220,92430
Kadashan East,1983,727,,221,93157
Kadashan East,1983,5130,,222,98287
Kadashan East,1983,31,,223,98318
Kadashan East,1983,108,,224,98426
Kadashan East,1983,147,,225,98573
Kadashan East,1983,87,,226,98660
Kadashan East,1984,0,,178,0
Kadashan East,1984,0,,179,0
Kadashan East,1984,0,,180,0
Kadashan East,1984,0,,181,0
Kadashan East,1984,0,,182,0
Kadashan East,1984,0,,183,0
Kadashan East,1984,0,,184,0
Kadashan East,1984,0,,185,0
Kadashan East,1984,0,,186,0
Kadashan East,1984,0,,187,0
Kadashan East,1984,0,,188,0
Kadashan East,1984,40,,189,40
Kadashan East,1984,173,,190,213
Kadashan East,1984,327,,191,540
Kadashan East,1984,1470,,192,2010
Kadashan East,1984,1535,,193,3545
Kadashan East,1984,476,,194,4021
Kadashan East,1984,243,,195,4264
Kadashan East,1984,1091,,196,5355
Kadashan East,1984,284,,198,5639
Kadashan East,1984,47,,199,5686
Kadashan East,1984,336,,200,6022
Kadashan East,1984,279,,201,6301
Kadashan East,1984,1272,,202,7573
Kadashan East,1984,1906,,203,9479
Kadashan East,1984,465,,204,9944
Kadashan East,1984,334,,205,10278
Kadashan East,1984,32,,206,10310
Kadashan East,1984,69,,207,10379
Kadashan East,1984,118,,208,10497
Kadashan East,1984,77,,209,10574
Kadashan East,1984,273,,210,10847
Kadashan East,1984,4076,,211,14923
Kadashan East,1984,18,,212,14941
Kadashan East,1984,322,,213,15263
Kadashan East,1984,26,,214,15289
Kadashan East,1984,106,,215,15395
Kadashan East,1984,565,,216,15960
Kadashan East,1984,747,,217,16707
Kadashan East,1984,491,,218,17198
Kadashan East,1984,911,,219,18109
Kadashan East,1984,3221,,220,21330
Kadashan East,1984,165,,221,21495
Kadashan East,1984,0,,222,21495
Kadashan East,1984,9,,223,21504
Kadashan East,1984,51,,224,21555
Kadashan East,1984,1091,,225,22646
Kadashan East,1984,0,,226,22646
Kadashan East,1984,5,,227,22651
Kadashan East,1984,5,,228,22656
Kadashan East,1984,434,,229,23090
Kadashan East,1984,466,,230,23556
Kadashan East,1984,436,,231,23992
Kadashan East,1984,2482,,232,26474
Kadashan East,1984,302,,233,26776
Kadashan East,1984,0,,234,26776
Kadashan East,1984,0,,235,26776
Kadashan East,1984,0,,236,26776
Kadashan East,1984,0,,237,26776
Kadashan East,1985,0,,180,0
Kadashan East,1985,0,,181,0
Kadashan East,1985,0,,182,0
Kadashan East,1985,0,,183,0
Kadashan East,1985,0,,184,0
Kadashan East,1985,0,,185,0
Kadashan East,1985,0,,186,0
Kadashan East,1985,0,,187,0
Kadashan East,1985,0,,188,0
Kadashan East,1985,0,,189,0
Kadashan East,1985,3,,190,3
Kadashan East,1985,3,,191,6
Kadashan East,1985,1,,192,7
Kadashan East,1985,140,,193,147
Kadashan East,1985,3146,,194,3293
Kadashan East,1985,2716,,195,6009
Kadashan East,1985,311,,196,6320
Kadashan East,1985,3861,,197,10181
Kadashan East,1985,1857,,198,12038
Kadashan East,1985,2515,,199,14553
Kadashan East,1985,1925,,200,16478
Kadashan East,1985,357,,201,16835
Kadashan East,1985,668,,202,17503
Kadashan East,1985,205,,203,17708
Kadashan East,1985,2202,,204,19910
Kadashan East,1985,117,,205,20027
Kadashan East,1985,8000,,206,28027
Kadashan East,1985,579,,207,28606
Kadashan East,1985,1358,,208,29964
Kadashan East,1985,1447,,209,31411
Kadashan East,1985,4694,,210,36105
Kadashan East,1985,6870,,211,42975
Kadashan East,1985,3709,,212,46684
Kadashan East,1985,18419,,213,65103
Kadashan East,1985,14612,,214,79715
Kadashan East,1985,693,,215,80408
Kadashan East,1985,2225,,216,82633
Kadashan East,1985,988,,217,83621
Kadashan East,1985,5053,,218,88674
Kadashan East,1985,881,,219,89555
Kadashan East,1985,1030,,220,90585
Kadashan East,1985,336,,221,90921
Kadashan East,1985,5247,,222,96168
Kadashan East,1985,6792,,223,102960
Kadashan East,1985,95,,224,103055
Kadashan East,1985,597,,225,103652
Kadashan East,1985,4542,,226,108194
Kadashan East,1985,5132,,227,113326
Kadashan East,1985,3644,,228,116970
Kadashan East,1985,3632,,229,120602
Kadashan East,1985,2540,,230,123142
Kadashan East,1985,954,,231,124096
Kadashan East,1985,4489,,232,128585
Kadashan East,1985,4006,,233,132591
Kadashan East,1985,12110,,234,144701
Kadashan East,1985,604,,235,145305
Kadashan East,1985,1500,,236,146805
Kadashan East,1985,803,,237,147608
Kadashan East,1985,145,,238,147753
Kadashan East,1986,0,,185,0
Kadashan East,1986,0,,186,0
Kadashan East,1986,0,,187,0
Kadashan East,1986,0,,188,0
Kadashan East,1986,0,,189,0
Kadashan East,1986,0,,190,0
Kadashan East,1986,0,,191,0
Kadashan East,1986,0,,192,0
Kadashan East,1986,0,,193,0
Kadashan East,1986,1,,194,1
Kadashan East,1986,0,,195,1
Kadashan East,1986,0,,196,1
Kadashan East,1986,0,,197,1
Kadashan East,1986,0,,198,1
Kadashan East,1986,0,,199,1
Kadashan East,1986,0,,200,1
Kadashan East,1986,138,,201,139
Kadashan East,1986,0,,202,139
Kadashan East,1986,28,,203,167
Kadashan East,1986,20,,204,187
Kadashan East,1986,35,,205,222
Kadashan East,1986,712,,206,934
Kadashan East,1986,14,,207,948
Kadashan East,1986,9257,,208,10205
Kadashan East,1986,0,,209,10205
Kadashan East,1986,31,,210,10236
Kadashan East,1986,42,,211,10278
Kadashan East,1986,86,,212,10364
Kadashan East,1986,1062,,213,11426
Kadashan East,1986,9542,,214,20968
Kadashan East,1986,1037,,215,22005
Kadashan East,1986,9505,,216,31510
Kadashan East,1986,1293,,217,32803
Kadashan East,1986,38940,,218,71743
Kadashan East,1986,0,,219,71743
Kadashan East,1986,23,,220,71766
Kadashan East,1986,637,,221,72403
Kadashan East,1986,567,,222,72970
Kadashan East,1986,10902,,223,83872
Kadashan East,1986,0,,224,83872
Kadashan East,1986,734,,225,84606
Kadashan East,1986,0,,226,84606
Kadashan East,1986,143,,227,84749
Kadashan East,1986,2375,,228,87124
Kadashan East,1986,8064,,229,95188
Kadashan East,1986,138,,230,95326
Kadashan East,1986,460,,231,95786
Kadashan East,1986,450,,232,96236
Kadashan East,1986,50,,233,96286
Kadashan East,1986,768,,234,97054
Kadashan East,1986,5325,,235,102379
Kadashan East,1986,0,,236,102379
Kadashan East,1986,106,,237,102485
Kadashan East,1986,288,,238,102773
Kadashan East,1986,1410,,239,104183
Kadashan East,1986,641,,240,104824
Kadashan East,1987,0,,189,0
Kadashan East,1987,0,,190,0
Kadashan East,1987,0,,191,0
Kadashan East,1987,0,,192,0
Kadashan East,1987,0,,193,0
Kadashan East,1987,0,,194,0
Kadashan East,1987,4737,,195,4737
Kadashan East,1987,40,,196,4777
Kadashan East,1987,0,,197,4777
Kadashan East,1987,3,,198,4780
Kadashan East,1987,0,,199,4780
Kadashan East,1987,842,,200,5622
Kadashan East,1987,1293,,201,6915
Kadashan East,1987,2014,,202,8929
Kadashan East,1987,1319,,203,10248
Kadashan East,1987,1442,,204,11690
Kadashan East,1987,73,,205,11763
Kadashan East,1987,3116,,206,14879
Kadashan East,1987,3428,,207,18307
Kadashan East,1987,26676,,208,44983
Kadashan East,1987,414,,209,45397
Kadashan East,1987,1767,,210,47164
Kadashan East,1987,278,,211,47442
Kadashan East,1987,2086,,212,49528
Kadashan East,1987,1678,,213,51206
Kadashan East,1987,1381,,214,52587
Kadashan East,1987,3319,,215,55906
Kadashan East,1987,4037,,216,59943
Kadashan East,1987,4220,,217,64163
Kadashan East,1987,1228,,218,65391
Kadashan East,1987,5496,,219,70887
Kadashan East,1987,3393,,220,74280
Kadashan East,1987,2166,,221,76446
Kadashan East,1987,3076,,222,79522
Kadashan East,1987,867,,223,80389
Kadashan East,1987,1198,,224,81587
Kadashan East,1987,587,,225,82174
Kadashan East,1987,270,,226,82444
Kadashan East,1987,715,,227,83159
Kadashan East,1987,1853,,228,85012
Kadashan East,1987,567,,229,85579
Kadashan East,1987,201,,230,85780
Kadashan East,1987,2157,,231,87937
Kadashan East,1987,100,,232,88037
Kadashan East,1987,1326,,233,89363
Kadashan East,1987,841,,234,90204
Kadashan East,1987,0,,235,90204
Kadashan East,1987,1804,,236,92008
Kadashan East,1987,1502,,237,93510
Kadashan East,1987,267,,238,93777
Kadashan East,1987,1080,,239,94857
Kadashan East,1987,450,,240,95307
Sashin Creek,1934,310,,230,310
Sashin Creek,1934,279,,231,589
Sashin Creek,1934,10,,232,599
Sashin Creek,1934,51,,234,650
Sashin Creek,1934,9,,235,659
Sashin Creek,1934,41,,236,700
Sashin Creek,1934,30,,237,730
Sashin Creek,1934,62,,238,792
Sashin Creek,1934,9,,239,801
Sashin Creek,1934,196,,240,997
Sashin Creek,1934,41,,241,1038
Sashin Creek,1934,890,,243,1928
Sashin Creek,1934,100,,244,2028
Sashin Creek,1934,52,,245,2080
Sashin Creek,1934,28,,246,2108
Sashin Creek,1934,86,,247,2194
Sashin Creek,1934,6,,248,2200
Sashin Creek,1934,1206,,249,3406
Sashin Creek,1934,178,,250,3584
Sashin Creek,1934,48,,251,3632
Sashin Creek,1934,5,,252,3637
Sashin Creek,1934,32,,253,3669
Sashin Creek,1934,205,,254,3874
Sashin Creek,1934,14,,255,3888
Sashin Creek,1934,235,,256,4123
Sashin Creek,1934,2723,,257,6846
Sashin Creek,1934,12,,258,6858
Sashin Creek,1934,82,,260,6940
Sashin Creek,1935,2,,223,2
Sashin Creek,1935,73,,229,75
Sashin Creek,1935,3,,230,78
Sashin Creek,1935,28,,231,106
Sashin Creek,1935,147,,232,253
Sashin Creek,1935,574,,233,827
Sashin Creek,1935,700,,234,1527
Sashin Creek,1935,130,,235,1657
Sashin Creek,1935,905,,236,2562
Sashin Creek,1935,265,,237,2827
Sashin Creek,1935,100,,238,2927
Sashin Creek,1935,36,,239,2963
Sashin Creek,1935,69,,240,3032
Sashin Creek,1935,39,,241,3071
Sashin Creek,1935,44,,242,3115
Sashin Creek,1935,31,,243,3146
Sashin Creek,1935,67,,244,3213
Sashin Creek,1935,47,,245,3260
Sashin Creek,1935,12,,246,3272
Sashin Creek,1935,81,,247,3353
Sashin Creek,1935,20,,248,3373
Sashin Creek,1935,68,,249,3441
Sashin Creek,1935,214,,250,3655
Sashin Creek,1935,77,,251,3732
Sashin Creek,1935,102,,252,3834
Sashin Creek,1935,264,,253,4098
Sashin Creek,1935,128,,254,4226
Sashin Creek,1935,543,,255,4769
Sashin Creek,1935,450,,256,5219
Sashin Creek,1935,477,,257,5696
Sashin Creek,1935,66,,258,5762
Sashin Creek,1935,19,,259,5781
Sashin Creek,1935,4,,260,5785
Sashin Creek,1935,287,,261,6072
Sashin Creek,1935,7,,262,6079
Sashin Creek,1935,9,,263,6088
Sashin Creek,1935,5,,264,6093
Sashin Creek,1936,131,,237,131
Sashin Creek,1936,46,,238,177
Sashin Creek,1936,150,,239,327
Sashin Creek,1936,377,,240,704
Sashin Creek,1936,45,,241,749
Sashin Creek,1936,248,,242,997
Sashin Creek,1936,1048,,243,2045
Sashin Creek,1936,330,,245,2375
Sashin Creek,1936,9,,246,2384
Sashin Creek,1936,355,,247,2739
Sashin Creek,1936,189,,248,2928
Sashin Creek,1936,583,,249,3511
Sashin Creek,1936,46,,250,3557
Sashin Creek,1936,144,,251,3701
Sashin Creek,1936,434,,252,4135
Sashin Creek,1936,104,,253,4239
Sashin Creek,1936,109,,254,4348
Sashin Creek,1936,6,,255,4354
Sashin Creek,1936,23,,257,4377
Sashin Creek,1936,263,,258,4640
Sashin Creek,1936,81,,259,4721
Sashin Creek,1936,275,,260,4996
Sashin Creek,1936,159,,261,5155
Sashin Creek,1936,9,,262,5164
Sashin Creek,1937,25,,228,25
Sashin Creek,1937,100,,229,125
Sashin Creek,1937,23,,230,148
Sashin Creek,1937,122,,232,270
Sashin Creek,1937,1006,,233,1276
Sashin Creek,1937,1029,,234,2305
Sashin Creek,1937,156,,235,2461
Sashin Creek,1937,134,,236,2595
Sashin Creek,1937,857,,237,3452
Sashin Creek,1937,342,,238,3794
Sashin Creek,1937,123,,239,3917
Sashin Creek,1937,76,,241,3993
Sashin Creek,1937,89,,242,4082
Sashin Creek,1937,157,,243,4239
Sashin Creek,1937,280,,244,4519
Sashin Creek,1937,191,,245,4710
Sashin Creek,1937,189,,246,4899
Sashin Creek,1937,195,,248,5094
Sashin Creek,1937,461,,249,5555
Sashin Creek,1937,653,,250,6208
Sashin Creek,1937,806,,251,7014
Sashin Creek,1937,71,,252,7085
Sashin Creek,1938,119,,241,119
Sashin Creek,1938,322,,242,441
Sashin Creek,1938,227,,243,668
Sashin Creek,1938,276,,244,944
Sashin Creek,1938,160,,245,1104
Sashin Creek,1938,63,,246,1167
Sashin Creek,1938,39,,247,1206
Sashin Creek,1938,71,,248,1277
Sashin Creek,1938,9,,249,1286
Sashin Creek,1938,204,,250,1490
Sashin Creek,1938,16,,251,1506
Sashin Creek,1938,800,,252,2306
Sashin Creek,1938,2484,,253,4790
Sashin Creek,1938,338,,254,5128
Sashin Creek,1938,570,,255,5698
Sashin Creek,1938,391,,256,6089
Sashin Creek,1938,145,,257,6234
Sashin Creek,1938,49,,258,6283
Sashin Creek,1938,29,,259,6312
Sashin Creek,1938,3,,260,6315
Sashin Creek,1938,14,,261,6329
Sashin Creek,1938,20,,262,6349
Sashin Creek,1938,67,,263,6416
Sashin Creek,1938,48,,264,6464
Sashin Creek,1938,3,,265,6467
Sashin Creek,1939,9,,229,9
Sashin Creek,1939,361,,233,370
Sashin Creek,1939,240,,234,610
Sashin Creek,1939,223,,235,833
Sashin Creek,1939,311,,236,1144
Sashin Creek,1939,424,,237,1568
Sashin Creek,1939,179,,238,1747
Sashin Creek,1939,259,,239,2006
Sashin Creek,1939,1011,,240,3017
Sashin Creek,1939,656,,241,3673
Sashin Creek,1939,860,,242,4533
Sashin Creek,1939,511,,243,5044
Sashin Creek,1939,952,,244,5996
Sashin Creek,1939,1082,,245,7078
Sashin Creek,1939,578,,246,7656
Sashin Creek,1939,581,,247,8237
Sashin Creek,1939,566,,248,8803
Sashin Creek,1939,4514,,250,13317
Sashin Creek,1939,520,,251,13837
Sashin Creek,1939,1366,,254,15203
Sashin Creek,1939,466,,255,15669
Sashin Creek,1939,427,,257,16096
Sashin Creek,1939,11,,258,16107
Sashin Creek,1939,249,,264,16356
Sashin Creek,1939,308,,266,16664
Sashin Creek,1939,166,,269,16830
Sashin Creek,1940,12,,232,12
Sashin Creek,1940,200,,234,212
Sashin Creek,1940,410,,235,622
Sashin Creek,1940,2854,,237,3476
Sashin Creek,1940,3305,,238,6781
Sashin Creek,1940,2192,,239,8973
Sashin Creek,1940,14,,240,8987
Sashin Creek,1940,848,,241,9835
Sashin Creek,1940,2388,,242,12223
Sashin Creek,1940,2527,,243,14750
Sashin Creek,1940,1629,,244,16379
Sashin Creek,1940,102,,245,16481
Sashin Creek,1940,2904,,246,19385
Sashin Creek,1940,4737,,247,24122
Sashin Creek,1940,5336,,248,29458
Sashin Creek,1940,4092,,249,33550
Sashin Creek,1940,1228,,250,34778
Sashin Creek,1940,1412,,251,36190
Sashin Creek,1940,330,,252,36520
Sashin Creek,1940,660,,253,37180
Sashin Creek,1940,917,,254,38097
Sashin Creek,1940,1337,,255,39434
Sashin Creek,1940,767,,256,40201
Sashin Creek,1940,2608,,257,42809
Sashin Creek,1940,14,,258,42823
Sashin Creek,1940,3275,,259,46098
Sashin Creek,1940,1487,,260,47585
Sashin Creek,1940,9,,263,47594
Sashin Creek,1941,160,,228,160
Sashin Creek,1941,106,,229,266
Sashin Creek,1941,353,,230,619
Sashin Creek,1941,528,,231,1147
Sashin Creek,1941,840,,232,1987
Sashin Creek,1941,2313,,233,4300
Sashin Creek,1941,3881,,234,8181
Sashin Creek,1941,4870,,235,13051
Sashin Creek,1941,4286,,236,17337
Sashin Creek,1941,8265,,237,25602
Sashin Creek,1941,1310,,238,26912
Sashin Creek,1941,290,,239,27202
Sashin Creek,1941,32,,240,27234
Sashin Creek,1941,61,,241,27295
Sashin Creek,1941,1064,,242,28359
Sashin Creek,1941,201,,243,28560
Sashin Creek,1941,479,,244,29039
Sashin Creek,1941,434,,245,29473
Sashin Creek,1941,151,,246,29624
Sashin Creek,1941,3,,247,29627
Sashin Creek,1941,148,,248,29775
Sashin Creek,1941,280,,249,30055
Sashin Creek,1941,92,,250,30147
Sashin Creek,1941,1535,,251,31682
Sashin Creek,1941,421,,252,32103
Sashin Creek,1941,37,,253,32140
Sashin Creek,1941,115,,254,32255
Sashin Creek,1941,155,,255,32410
Sashin Creek,1941,963,,256,33373
Sashin Creek,1941,98,,257,33471
Sashin Creek,1941,778,,258,34249
Sashin Creek,1941,4150,,259,38399
Sashin Creek,1941,4124,,260,42523
Sashin Creek,1941,6254,,261,48777
Sashin Creek,1941,3783,,262,52560
Sashin Creek,1941,88,,263,52648
Sashin Creek,1941,7637,,264,60285
Sashin Creek,1941,9999,,265,70284
Sashin Creek,1941,6019,,266,76303
Sashin Creek,1942,5,,229,5
Sashin Creek,1942,77,,230,82
Sashin Creek,1942,21,,231,103
Sashin Creek,1942,13,,232,116
Sashin Creek,1942,346,,234,462
Sashin Creek,1942,70,,235,532
Sashin Creek,1942,1403,,236,1935
Sashin Creek,1942,521,,237,2456
Sashin Creek,1942,184,,238,2640
Sashin Creek,1942,1865,,239,4505
Sashin Creek,1942,896,,240,5401
Sashin Creek,1942,48,,241,5449
Sashin Creek,1942,1739,,242,7188
Sashin Creek,1942,481,,243,7669
Sashin Creek,1942,726,,244,8395
Sashin Creek,1942,1346,,245,9741
Sashin Creek,1942,1315,,246,11056
Sashin Creek,1942,543,,247,11599
Sashin Creek,1942,381,,248,11980
Sashin Creek,1942,125,,249,12105
Sashin Creek,1942,4649,,250,16754
Sashin Creek,1942,4047,,251,20801
Sashin Creek,1942,2975,,252,23776
Sashin Creek,1942,3826,,253,27602
Sashin Creek,1942,9999,,254,37601
Sashin Creek,1942,9072,,255,46673
Sashin Creek,1942,3620,,256,50293
Sashin Creek,1942,5605,,257,55898
Sashin Creek,1942,3088,,258,58986
Sashin Creek,1942,1091,,259,60077
Sashin Creek,1942,625,,260,60702
Sashin Creek,1942,252,,263,60954
Sashin Creek,1942,7648,,264,68602
Sashin Creek,1942,9436,,265,78038
Sashin Creek,1942,7365,,266,85403
Sashin Creek,1942,2740,,267,88143
Sashin Creek,1942,628,,268,88771
Sashin Creek,1942,58,,269,88829
Sashin Creek,1943,25,,233,25
Sashin Creek,1943,111,,234,136
Sashin Creek,1943,363,,235,499
Sashin Creek,1943,363,,236,862
Sashin Creek,1943,286,,237,1148
Sashin Creek,1943,279,,240,1427
Sashin Creek,1943,1205,,241,2632
Sashin Creek,1943,284,,242,2916
Sashin Creek,1943,1107,,243,4023
Sashin Creek,1943,32,,244,4055
Sashin Creek,1943,98,,245,4153
Sashin Creek,1943,1939,,246,6092
Sashin Creek,1943,36,,248,6128
Sashin Creek,1943,5,,249,6133
Sashin Creek,1943,6,,250,6139
Sashin Creek,1943,474,,251,6613
Sashin Creek,1943,341,,252,6954
Sashin Creek,1943,29,,253,6983
Sashin Creek,1943,1573,,254,8556
Sashin Creek,1943,1829,,255,10385
Sashin Creek,1943,405,,256,10790
Sashin Creek,1943,139,,257,10929
Sashin Creek,1943,222,,258,11151
Sashin Creek,1943,349,,259,11500
Sashin Creek,1943,131,,260,11631
Sashin Creek,1943,270,,261,11901
Sashin Creek,1943,1467,,262,13368
Sashin Creek,1943,602,,263,13970
Sashin Creek,1943,1,,264,13971
Sashin Creek,1943,248,,265,14219
Sashin Creek,1943,500,,266,14719
Sashin Creek,1943,37,,267,14756
Sashin Creek,1943,2,,268,14758
Sashin Creek,1943,16,,269,14774
Sashin Creek,1943,71,,270,14845
Sashin Creek,1943,29,,271,14874
Sashin Creek,1943,7,,272,14881
Sashin Creek,1943,17,,273,14898
Sashin Creek,1943,2,,275,14900
Sashin Creek,1944,1,,237,1
Sashin Creek,1944,55,,238,56
Sashin Creek,1944,1,,239,57
Sashin Creek,1944,17,,240,74
Sashin Creek,1944,100,,241,174
Sashin Creek,1944,28,,242,202
Sashin Creek,1944,26,,243,228
Sashin Creek,1944,173,,244,401
Sashin Creek,1944,195,,245,596
Sashin Creek,1944,116,,246,712
Sashin Creek,1944,259,,247,971
Sashin Creek,1944,148,,248,1119
Sashin Creek,1944,197,,249,1316
Sashin Creek,1944,174,,250,1490
Sashin Creek,1944,113,,251,1603
Sashin Creek,1944,101,,252,1704
Sashin Creek,1944,285,,253,1989
Sashin Creek,1944,130,,254,2119
Sashin Creek,1944,432,,255,2551
Sashin Creek,1944,612,,256,3163
Sashin Creek,1944,271,,257,3434
Sashin Creek,1944,164,,258,3598
Sashin Creek,1944,68,,259,3666
Sashin Creek,1944,42,,260,3708
Sashin Creek,1944,3,,261,3711
Sashin Creek,1944,14,,262,3725
Sashin Creek,1944,18,,263,3743
Sashin Creek,1944,106,,264,3849
Sashin Creek,1944,52,,265,3901
Sashin Creek,1944,8,,266,3909
Sashin Creek,1944,2,,268,3911
Sashin Creek,1944,3,,270,3914
Sashin Creek,1944,5,,273,3919
Sashin Creek,1944,1,,274,3920
Sashin Creek,1944,3,,275,3923
Sashin Creek,1944,2,,278,3925
Sashin Creek,1945,2,,235,2
Sashin Creek,1945,1,,236,3
Sashin Creek,1945,1,,240,4
Sashin Creek,1945,1,,242,5
Sashin Creek,1945,8,,244,13
Sashin Creek,1945,20,,246,33
Sashin Creek,1945,81,,247,114
Sashin Creek,1945,127,,248,241
Sashin Creek,1945,685,,249,926
Sashin Creek,1945,328,,250,1254
Sashin Creek,1945,151,,251,1405
Sashin Creek,1945,275,,252,1680
Sashin Creek,1945,494,,253,2174
Sashin Creek,1945,294,,254,2468
Sashin Creek,1945,233,,255,2701
Sashin Creek,1945,145,,256,2846
Sashin Creek,1945,214,,257,3060
Sashin Creek,1945,181,,258,3241
Sashin Creek,1945,72,,259,3313
Sashin Creek,1945,18,,260,3331
Sashin Creek,1945,600,,261,3931
Sashin Creek,1945,277,,262,4208
Sashin Creek,1945,110,,263,4318
Sashin Creek,1945,50,,264,4368
Sashin Creek,1945,21,,265,4389
Sashin Creek,1945,54,,266,4443
Sashin Creek,1945,280,,267,4723
Sashin Creek,1945,103,,268,4826
Sashin Creek,1945,75,,269,4901
Sashin Creek,1945,291,,270,5192
Sashin Creek,1945,113,,271,5305
Sashin Creek,1945,91,,272,5396
Sashin Creek,1945,9,,273,5405
Sashin Creek,1945,15,,274,5420
Sashin Creek,1945,6,,275,5426
Sashin Creek,1945,4,,276,5430
Sashin Creek,1945,9,,277,5439
Sashin Creek,1945,6,,278,5445
Sashin Creek,1945,3,,279,5448
Sashin Creek,1945,2,,281,5450
Sashin Creek,1945,1,,282,5451
Sashin Creek,1945,1,,283,5452
Sashin Creek,1945,4,,284,5456
Sashin Creek,1946,9,,252,9
Sashin Creek,1946,54,,253,63
Sashin Creek,1946,21,,254,84
Sashin Creek,1946,159,,255,243
Sashin Creek,1946,130,,256,373
Sashin Creek,1946,74,,257,447
Sashin Creek,1946,153,,258,600
Sashin Creek,1946,107,,259,707
Sashin Creek,1946,115,,260,822
Sashin Creek,1946,15,,261,837
Sashin Creek,1946,31,,262,868
Sashin Creek,1946,7,,263,875
Sashin Creek,1946,2,,264,877
Sashin Creek,1946,35,,265,912
Sashin Creek,1946,1,,266,913
Sashin Creek,1946,5,,267,918
Sashin Creek,1946,3,,268,921
Sashin Creek,1946,3,,270,924
Sashin Creek,1946,3,,271,927
Sashin Creek,1946,1,,272,928
Sashin Creek,1946,3,,278,931
Sashin Creek,1946,1,,279,932
Sashin Creek,1946,1,,283,933
Sashin Creek,1947,14,,241,14
Sashin Creek,1947,6,,242,20
Sashin Creek,1947,26,,243,46
Sashin Creek,1947,28,,244,74
Sashin Creek,1947,18,,245,92
Sashin Creek,1947,15,,246,107
Sashin Creek,1947,5,,247,112
Sashin Creek,1947,7,,248,119
Sashin Creek,1947,18,,249,137
Sashin Creek,1947,58,,250,195
Sashin Creek,1947,52,,251,247
Sashin Creek,1947,123,,252,370
Sashin Creek,1947,119,,253,489
Sashin Creek,1947,118,,254,607
Sashin Creek,1947,57,,255,664
Sashin Creek,1947,54,,256,718
Sashin Creek,1947,74,,257,792
Sashin Creek,1947,47,,258,839
Sashin Creek,1947,26,,259,865
Sashin Creek,1947,59,,260,924
Sashin Creek,1947,34,,261,958
Sashin Creek,1947,130,,262,1088
Sashin Creek,1947,71,,263,1159
Sashin Creek,1947,79,,264,1238
Sashin Creek,1947,48,,265,1286
Sashin Creek,1947,33,,266,1319
Sashin Creek,1947,17,,267,1336
Sashin Creek,1947,12,,268,1348
Sashin Creek,1947,20,,269,1368
Sashin Creek,1947,4,,270,1372
Sashin Creek,1947,7,,271,1379
Sashin Creek,1947,39,,272,1418
Sashin Creek,1947,1,,273,1419
Sashin Creek,1947,7,,274,1426
Sashin Creek,1947,5,,275,1431
Sashin Creek,1947,4,,276,1435
Sashin Creek,1948,9,,243,9
Sashin Creek,1948,9,,244,18
Sashin Creek,1948,3,,245,21
Sashin Creek,1948,22,,246,43
Sashin Creek,1948,29,,247,72
Sashin Creek,1948,9,,248,81
Sashin Creek,1948,18,,249,99
Sashin Creek,1948,15,,250,114
Sashin Creek,1948,18,,251,132
Sashin Creek,1948,45,,252,177
Sashin Creek,1948,72,,253,249
Sashin Creek,1948,41,,254,290
Sashin Creek,1948,14,,255,304
Sashin Creek,1948,19,,256,323
Sashin Creek,1948,25,,257,348
Sashin Creek,1948,18,,258,366
Sashin Creek,1948,22,,259,388
Sashin Creek,1948,57,,260,445
Sashin Creek,1948,43,,261,488
Sashin Creek,1948,8,,262,496
Sashin Creek,1948,19,,263,515
Sashin Creek,1948,24,,264,539
Sashin Creek,1948,15,,265,554
Sashin Creek,1948,3,,266,557
Sashin Creek,1948,3,,267,560
Sashin Creek,1948,1,,268,561
Sashin Creek,1948,5,,269,566
Sashin Creek,1948,5,,270,571
Sashin Creek,1948,1,,271,572
Sashin Creek,1948,1,,272,573
Sashin Creek,1948,1,,275,574
Sashin Creek,1948,1,,276,575
Sashin Creek,1948,2,,279,577
Sashin Creek,1948,1,,281,578
Sashin Creek,1949,4,,239,4
Sashin Creek,1949,6,,240,10
Sashin Creek,1949,35,,241,45
Sashin Creek,1949,68,,242,113
Sashin Creek,1949,58,,243,171
Sashin Creek,1949,209,,244,380
Sashin Creek,1949,154,,245,534
Sashin Creek,1949,176,,246,710
Sashin Creek,1949,169,,247,879
Sashin Creek,1949,170,,248,1049
Sashin Creek,1949,184,,249,1233
Sashin Creek,1949,243,,250,1476
Sashin Creek,1949,234,,251,1710
Sashin Creek,1949,143,,252,1853
Sashin Creek,1949,163,,253,2016
Sashin Creek,1949,164,,254,2180
Sashin Creek,1949,309,,255,2489
Sashin Creek,1949,344,,256,2833
Sashin Creek,1949,493,,257,3326
Sashin Creek,1949,492,,258,3818
Sashin Creek,1949,288,,259,4106
Sashin Creek,1949,143,,260,4249
Sashin Creek,1949,81,,261,4330
Sashin Creek,1949,117,,262,4447
Sashin Creek,1949,66,,263,4513
Sashin Creek,1949,59,,264,4572
Sashin Creek,1949,82,,265,4654
Sashin Creek,1949,52,,266,4706
Sashin Creek,1949,103,,267,4809
Sashin Creek,1949,27,,268,4836
Sashin Creek,1949,38,,269,4874
Sashin Creek,1949,13,,270,4887
Sashin Creek,1949,4,,271,4891
Sashin Creek,1949,3,,272,4894
Sashin Creek,1949,4,,273,4898
Sashin Creek,1950,1,,237,1
Sashin Creek,1950,1,,239,2
Sashin Creek,1950,2,,240,4
Sashin Creek,1950,2,,241,6
Sashin Creek,1950,4,,244,10
Sashin Creek,1950,2,,247,12
Sashin Creek,1950,1,,248,13
Sashin Creek,1950,2,,251,15
Sashin Creek,1950,3,,253,18
Sashin Creek,1950,11,,254,29
Sashin Creek,1950,2,,256,31
Sashin Creek,1950,6,,257,37
Sashin Creek,1950,3,,258,40
Sashin Creek,1950,2,,260,42
Sashin Creek,1950,24,,261,66
Sashin Creek,1950,23,,262,89
Sashin Creek,1950,5,,263,94
Sashin Creek,1950,2,,264,96
Sashin Creek,1950,2,,266,98
Sashin Creek,1950,1,,267,99
Sashin Creek,1950,2,,269,101
Sashin Creek,1950,2,,270,103
Sashin Creek,1950,1,,271,104
Sashin Creek,1951,8,,225,8
Sashin Creek,1951,22,,226,30
Sashin Creek,1951,41,,227,71
Sashin Creek,1951,37,,228,108
Sashin Creek,1951,60,,229,168
Sashin Creek,1951,68,,230,236
Sashin Creek,1951,40,,231,276
Sashin Creek,1951,7,,232,283
Sashin Creek,1951,8,,233,291
Sashin Creek,1951,10,,234,301
Sashin Creek,1951,6,,235,307
Sashin Creek,1951,7,,236,314
Sashin Creek,1951,16,,237,330
Sashin Creek,1951,19,,238,349
Sashin Creek,1951,25,,239,374
Sashin Creek,1951,26,,240,400
Sashin Creek,1951,53,,241,453
Sashin Creek,1951,35,,242,488
Sashin Creek,1951,99,,243,587
Sashin Creek,1951,131,,244,718
Sashin Creek,1951,248,,245,966
Sashin Creek,1951,131,,246,1097
Sashin Creek,1951,354,,247,1451
Sashin Creek,1951,273,,248,1724
Sashin Creek,1951,360,,249,2084
Sashin Creek,1951,493,,250,2577
Sashin Creek,1951,216,,251,2793
Sashin Creek,1951,217,,252,3010
Sashin Creek,1951,193,,253,3203
Sashin Creek,1951,3,,254,3206
Sashin Creek,1951,95,,255,3301
Sashin Creek,1951,89,,256,3390
Sashin Creek,1951,92,,257,3482
Sashin Creek,1951,53,,258,3535
Sashin Creek,1951,42,,259,3577
Sashin Creek,1951,108,,260,3685
Sashin Creek,1951,74,,261,3759
Sashin Creek,1951,28,,262,3787
Sashin Creek,1951,9,,263,3796
Sashin Creek,1951,11,,264,3807
Sashin Creek,1951,46,,265,3853
Sashin Creek,1951,38,,266,3891
Sashin Creek,1951,32,,267,3923
Sashin Creek,1951,7,,268,3930
Sashin Creek,1951,9,,270,3939
Sashin Creek,1951,155,,271,4094
Sashin Creek,1951,43,,272,4137
Sashin Creek,1951,21,,273,4158
Sashin Creek,1951,12,,274,4170
Sashin Creek,1951,17,,275,4187
Sashin Creek,1951,1,,276,4188
Sashin Creek,1951,3,,277,4191
Sashin Creek,1952,2,,251,2
Sashin Creek,1952,6,,256,8
Sashin Creek,1952,2,,257,10
Sashin Creek,1952,8,,258,18
Sashin Creek,1952,16,,259,34
Sashin Creek,1952,1,,260,35
Sashin Creek,1952,5,,262,40
Sashin Creek,1952,2,,263,42
Sashin Creek,1952,2,,268,44
Sashin Creek,1952,1,,275,45
Sashin Creek,1953,2,,222,2
Sashin Creek,1953,4,,224,6
Sashin Creek,1953,18,,225,24
Sashin Creek,1953,57,,226,81
Sashin Creek,1953,7,,227,88
Sashin Creek,1953,27,,228,115
Sashin Creek,1953,18,,229,133
Sashin Creek,1953,8,,230,141
Sashin Creek,1953,2,,231,143
Sashin Creek,1953,1,,232,144
Sashin Creek,1953,2,,233,146
Sashin Creek,1953,1,,234,147
Sashin Creek,1953,18,,235,165
Sashin Creek,1953,51,,236,216
Sashin Creek,1953,8,,237,224
Sashin Creek,1953,2,,238,226
Sashin Creek,1953,16,,239,242
Sashin Creek,1953,23,,240,265
Sashin Creek,1953,191,,241,456
Sashin Creek,1953,136,,242,592
Sashin Creek,1953,76,,243,668
Sashin Creek,1953,6,,244,674
Sashin Creek,1953,36,,245,710
Sashin Creek,1953,39,,246,749
Sashin Creek,1953,33,,247,782
Sashin Creek,1953,105,,248,887
Sashin Creek,1953,62,,249,949
Sashin Creek,1953,99,,250,1048
Sashin Creek,1953,55,,251,1103
Sashin Creek,1953,15,,252,1118
Sashin Creek,1953,11,,253,1129
Sashin Creek,1953,27,,257,1156
Sashin Creek,1953,2,,258,1158
Sashin Creek,1953,2,,259,1160
Sashin Creek,1953,1,,260,1161
Sashin Creek,1953,2,,263,1163
Sashin Creek,1953,1,,274,1164
Sashin Creek,1954,3,,257,3
Sashin Creek,1954,4,,264,7
Sashin Creek,1954,5,,265,12
Sashin Creek,1954,1,,268,13
Sashin Creek,1955,2,,217,2
Sashin Creek,1955,27,,219,29
Sashin Creek,1955,41,,220,70
Sashin Creek,1955,12,,221,82
Sashin Creek,1955,11,,222,93
Sashin Creek,1955,3,,223,96
Sashin Creek,1955,22,,224,118
Sashin Creek,1955,30,,225,148
Sashin Creek,1955,13,,226,161
Sashin Creek,1955,5,,227,166
Sashin Creek,1955,46,,228,212
Sashin Creek,1955,28,,229,240
Sashin Creek,1955,23,,230,263
Sashin Creek,1955,8,,231,271
Sashin Creek,1955,47,,232,318
Sashin Creek,1955,15,,233,333
Sashin Creek,1955,67,,234,400
Sashin Creek,1955,31,,235,431
Sashin Creek,1955,40,,236,471
Sashin Creek,1955,61,,237,532
Sashin Creek,1955,66,,238,598
Sashin Creek,1955,2,,239,600
Sashin Creek,1955,65,,240,665
Sashin Creek,1955,103,,241,768
Sashin Creek,1955,298,,242,1066
Sashin Creek,1955,325,,243,1391
Sashin Creek,1955,1744,,244,3135
Sashin Creek,1955,2243,,245,5378
Sashin Creek,1955,940,,246,6318
Sashin Creek,1955,502,,247,6820
Sashin Creek,1955,166,,248,6986
Sashin Creek,1955,112,,249,7098
Sashin Creek,1955,193,,250,7291
Sashin Creek,1955,213,,251,7504
Sashin Creek,1955,228,,252,7732
Sashin Creek,1955,200,,253,7932
Sashin Creek,1955,204,,254,8136
Sashin Creek,1955,576,,255,8712
Sashin Creek,1955,359,,256,9071
Sashin Creek,1955,145,,257,9216
Sashin Creek,1955,17,,258,9233
Sashin Creek,1955,3,,259,9236
Sashin Creek,1955,76,,260,9312
Sashin Creek,1955,21,,261,9333
Sashin Creek,1955,11,,262,9344
Sashin Creek,1955,3,,265,9347
Sashin Creek,1955,5,,266,9352
Sashin Creek,1955,4,,267,9356
Sashin Creek,1955,1,,268,9357
Sashin Creek,1956,53,,252,53
Sashin Creek,1956,50,,253,103
Sashin Creek,1956,69,,254,172
Sashin Creek,1956,63,,255,235
Sashin Creek,1956,21,,256,256
Sashin Creek,1956,153,,257,409
Sashin Creek,1956,29,,258,438
Sashin Creek,1956,25,,259,463
Sashin Creek,1956,60,,260,523
Sashin Creek,1956,200,,261,723
Sashin Creek,1956,80,,262,803
Sashin Creek,1956,56,,263,859
Sashin Creek,1956,37,,264,896
Sashin Creek,1956,25,,265,921
Sashin Creek,1956,4,,266,925
Sashin Creek,1956,2,,267,927
Sashin Creek,1956,6,,268,933
Sashin Creek,1957,10,,214,10
Sashin Creek,1957,11,,215,21
Sashin Creek,1957,1,,216,22
Sashin Creek,1957,11,,218,33
Sashin Creek,1957,15,,219,48
Sashin Creek,1957,18,,220,66
Sashin Creek,1957,15,,221,81
Sashin Creek,1957,30,,222,111
Sashin Creek,1957,57,,223,168
Sashin Creek,1957,52,,224,220
Sashin Creek,1957,48,,225,268
Sashin Creek,1957,13,,226,281
Sashin Creek,1957,27,,227,308
Sashin Creek,1957,69,,228,377
Sashin Creek,1957,79,,229,456
Sashin Creek,1957,81,,230,537
Sashin Creek,1957,56,,231,593
Sashin Creek,1957,42,,232,635
Sashin Creek,1957,67,,233,702
Sashin Creek,1957,4,,234,706
Sashin Creek,1957,178,,235,884
Sashin Creek,1957,24,,237,908
Sashin Creek,1957,14,,238,922
Sashin Creek,1957,148,,239,1070
Sashin Creek,1957,70,,240,1140
Sashin Creek,1957,92,,241,1232
Sashin Creek,1957,94,,242,1326
Sashin Creek,1957,157,,243,1483
Sashin Creek,1957,373,,244,1856
Sashin Creek,1957,40,,245,1896
Sashin Creek,1957,9,,246,1905
Sashin Creek,1957,35,,248,1940
Sashin Creek,1957,21,,249,1961
Sashin Creek,1957,20,,250,1981
Sashin Creek,1957,7,,251,1988
Sashin Creek,1957,8,,253,1996
Sashin Creek,1957,2,,255,1998
Sashin Creek,1957,2,,256,2000
Sashin Creek,1957,2,,257,2002
Sashin Creek,1957,4,,263,2006
Sashin Creek,1957,2,,264,2008
Sashin Creek,1957,1,,272,2009
Sashin Creek,1957,1,,273,2010
Sashin Creek,1958,1,,232,1
Sashin Creek,1958,1,,234,2
Sashin Creek,1958,1,,235,3
Sashin Creek,1958,33,,246,36
Sashin Creek,1958,50,,247,86
Sashin Creek,1958,32,,248,118
Sashin Creek,1958,30,,249,148
Sashin Creek,1958,8,,250,156
Sashin Creek,1958,16,,251,172
Sashin Creek,1958,15,,252,187
Sashin Creek,1958,3,,253,190
Sashin Creek,1958,2,,255,192
Sashin Creek,1958,4,,256,196
Sashin Creek,1958,11,,258,207
Sashin Creek,1958,2,,259,209
Sashin Creek,1958,2,,260,211
Sashin Creek,1958,1,,261,212
Sashin Creek,1958,5,,266,217
Sashin Creek,1959,2,,211,2
Sashin Creek,1959,5,,217,7
Sashin Creek,1959,59,,218,66
Sashin Creek,1959,21,,219,87
Sashin Creek,1959,11,,220,98
Sashin Creek,1959,11,,221,109
Sashin Creek,1959,29,,222,138
Sashin Creek,1959,24,,223,162
Sashin Creek,1959,154,,224,316
Sashin Creek,1959,181,,225,497
Sashin Creek,1959,473,,226,970
Sashin Creek,1959,470,,227,1440
Sashin Creek,1959,662,,228,2102
Sashin Creek,1959,665,,229,2767
Sashin Creek,1959,544,,230,3311
Sashin Creek,1959,1168,,231,4479
Sashin Creek,1959,1650,,232,6129
Sashin Creek,1959,509,,233,6638
Sashin Creek,1959,573,,234,7211
Sashin Creek,1959,704,,235,7915
Sashin Creek,1959,1040,,236,8955
Sashin Creek,1959,1336,,237,10291
Sashin Creek,1959,1449,,238,11740
Sashin Creek,1959,840,,239,12580
Sashin Creek,1959,514,,240,13094
Sashin Creek,1959,3777,,241,16871
Sashin Creek,1959,3772,,242,20643
Sashin Creek,1959,2474,,243,23117
Sashin Creek,1959,5336,,244,28453
Sashin Creek,1959,1098,,245,29551
Sashin Creek,1959,317,,246,29868
Sashin Creek,1959,293,,247,30161
Sashin Creek,1959,93,,248,30254
Sashin Creek,1959,108,,249,30362
Sashin Creek,1959,175,,250,30537
Sashin Creek,1959,469,,251,31006
Sashin Creek,1959,2179,,252,33185
Sashin Creek,1959,409,,253,33594
Sashin Creek,1959,499,,254,34093
Sashin Creek,1959,434,,255,34527
Sashin Creek,1959,78,,256,34605
Sashin Creek,1959,98,,257,34703
Sashin Creek,1959,140,,258,34843
Sashin Creek,1959,70,,259,34913
Sashin Creek,1959,37,,260,34950
Sashin Creek,1959,106,,261,35056
Sashin Creek,1959,33,,262,35089
Sashin Creek,1959,21,,263,35110
Sashin Creek,1959,16,,264,35126
Sashin Creek,1959,63,,265,35189
Sashin Creek,1959,119,,266,35308
Sashin Creek,1959,37,,267,35345
Sashin Creek,1959,33,,268,35378
Sashin Creek,1959,5,,269,35383
Sashin Creek,1959,10,,270,35393
Sashin Creek,1959,7,,271,35400
Sashin Creek,1959,4,,272,35404
Sashin Creek,1959,4,,273,35408
Sashin Creek,1959,7,,274,35415
Sashin Creek,1959,2,,275,35417
Sashin Creek,1959,1,,279,35418
Sashin Creek,1960,2,,219,2
Sashin Creek,1960,2,,220,4
Sashin Creek,1960,2,,228,6
Sashin Creek,1960,3,,229,9
Sashin Creek,1960,5,,230,14
Sashin Creek,1960,2,,232,16
Sashin Creek,1960,3,,235,19
Sashin Creek,1960,3,,239,22
Sashin Creek,1960,1,,241,23
Sashin Creek,1960,1,,242,24
Sashin Creek,1960,3,,245,27
Sashin Creek,1960,2,,247,29
Sashin Creek,1960,5,,248,34
Sashin Creek,1960,4,,249,38
Sashin Creek,1960,6,,250,44
Sashin Creek,1960,16,,251,60
Sashin Creek,1960,13,,252,73
Sashin Creek,1960,10,,253,83
Sashin Creek,1960,9,,254,92
Sashin Creek,1960,9,,255,101
Sashin Creek,1960,5,,256,106
Sashin Creek,1960,4,,257,110
Sashin Creek,1960,4,,258,114
Sashin Creek,1960,2,,259,116
Sashin Creek,1960,2,,260,118
Sashin Creek,1960,10,,261,128
Sashin Creek,1960,3,,262,131
Sashin Creek,1960,3,,263,134
Sashin Creek,1961,4,,213,4
Sashin Creek,1961,21,,214,25
Sashin Creek,1961,37,,215,62
Sashin Creek,1961,113,,216,175
Sashin Creek,1961,23,,217,198
Sashin Creek,1961,85,,218,283
Sashin Creek,1961,1016,,219,1299
Sashin Creek,1961,379,,220,1678
Sashin Creek,1961,291,,221,1969
Sashin Creek,1961,112,,222,2081
Sashin Creek,1961,152,,223,2233
Sashin Creek,1961,4725,,224,6958
Sashin Creek,1961,6124,,225,13082
Sashin Creek,1961,1984,,226,15066
Sashin Creek,1961,1244,,227,16310
Sashin Creek,1961,155,,228,16465
Sashin Creek,1961,117,,229,16582
Sashin Creek,1961,68,,230,16650
Sashin Creek,1961,71,,231,16721
Sashin Creek,1961,94,,232,16815
Sashin Creek,1961,160,,233,16975
Sashin Creek,1961,472,,234,17447
Sashin Creek,1961,2139,,235,19586
Sashin Creek,1961,3323,,236,22909
Sashin Creek,1961,1501,,237,24410
Sashin Creek,1961,67,,238,24477
Sashin Creek,1961,93,,239,24570
Sashin Creek,1961,398,,240,24968
Sashin Creek,1961,216,,241,25184
Sashin Creek,1961,140,,242,25324
Sashin Creek,1961,256,,243,25580
Sashin Creek,1961,179,,244,25759
Sashin Creek,1961,129,,245,25888
Sashin Creek,1961,1266,,246,27154
Sashin Creek,1961,37,,247,27191
Sashin Creek,1961,41,,248,27232
Sashin Creek,1961,27,,249,27259
Sashin Creek,1961,87,,250,27346
Sashin Creek,1961,863,,251,28209
Sashin Creek,1961,53,,252,28262
Sashin Creek,1961,63,,253,28325
Sashin Creek,1961,53,,254,28378
Sashin Creek,1961,11,,255,28389
Sashin Creek,1961,1,,256,28390
Sashin Creek,1961,42,,257,28432
Sashin Creek,1961,59,,258,28491
Sashin Creek,1961,82,,261,28573
Sashin Creek,1961,34,,262,28607
Sashin Creek,1961,22,,263,28629
Sashin Creek,1961,19,,264,28648
Sashin Creek,1961,5,,265,28653
Sashin Creek,1961,39,,266,28692
Sashin Creek,1961,11,,267,28703
Sashin Creek,1961,3,,269,28706
Sashin Creek,1961,8,,270,28714
Sashin Creek,1961,3,,271,28717
Sashin Creek,1961,1,,281,28718
Sashin Creek,1962,1,,222,1
Sashin Creek,1962,3,,228,4
Sashin Creek,1962,1,,252,5
Sashin Creek,1962,2,,253,7
Sashin Creek,1962,1,,256,8
Sashin Creek,1963,509,,222,509
Sashin Creek,1963,184,,223,693
Sashin Creek,1963,481,,224,1174
Sashin Creek,1963,508,,225,1682
Sashin Creek,1963,132,,226,1814
Sashin Creek,1963,193,,227,2007
Sashin Creek,1963,500,,228,2507
Sashin Creek,1963,579,,229,3086
Sashin Creek,1963,1141,,230,4227
Sashin Creek,1963,1047,,231,5274
Sashin Creek,1963,232,,232,5506
Sashin Creek,1963,331,,233,5837
Sashin Creek,1963,380,,234,6217
Sashin Creek,1963,305,,235,6522
Sashin Creek,1963,72,,236,6594
Sashin Creek,1963,468,,237,7062
Sashin Creek,1963,1043,,238,8105
Sashin Creek,1963,250,,239,8355
Sashin Creek,1963,492,,240,8847
Sashin Creek,1963,297,,241,9144
Sashin Creek,1963,145,,242,9289
Sashin Creek,1963,881,,243,10170
Sashin Creek,1963,383,,244,10553
Sashin Creek,1963,760,,245,11313
Sashin Creek,1963,4554,,246,15867
Sashin Creek,1963,398,,247,16265
Sashin Creek,1963,15,,251,16280
Sashin Creek,1963,21,,252,16301
Sashin Creek,1963,15,,253,16316
Sashin Creek,1963,5,,254,16321
Sashin Creek,1963,1,,255,16322
Sashin Creek,1963,2,,256,16324
Sashin Creek,1963,4,,257,16328
Sashin Creek,1963,3,,258,16331
Sashin Creek,1963,1,,259,16332
Sashin Creek,1963,4,,260,16336
Sashin Creek,1963,2,,261,16338
Sashin Creek,1965,89,,225,89
Sashin Creek,1965,120,,226,209
Sashin Creek,1965,487,,227,696
Sashin Creek,1965,291,,228,987
Sashin Creek,1965,453,,229,1440
Sashin Creek,1965,133,,230,1573
Sashin Creek,1965,692,,231,2265
Sashin Creek,1965,99,,232,2364
Sashin Creek,1965,1836,,233,4200
Sashin Creek,1965,611,,234,4811
Sashin Creek,1965,1400,,235,6211
Sashin Creek,1965,387,,236,6598
Sashin Creek,1965,562,,237,7160
Sashin Creek,1965,1974,,238,9134
Sashin Creek,1965,1848,,239,10982
Sashin Creek,1965,609,,240,11591
Sashin Creek,1965,1444,,241,13035
Sashin Creek,1965,331,,242,13366
Sashin Creek,1965,343,,243,13709
Sashin Creek,1965,343,,244,14052
Sashin Creek,1965,22,,245,14074
Sashin Creek,1965,79,,246,14153
Sashin Creek,1965,17,,247,14170
Sashin Creek,1965,116,,249,14286
Sashin Creek,1965,119,,250,14405
Sashin Creek,1965,45,,251,14450
Sashin Creek,1965,51,,252,14501
Sashin Creek,1965,39,,253,14540
Sashin Creek,1965,12,,254,14552
Sashin Creek,1965,26,,255,14578
Sashin Creek,1965,26,,256,14604
Sashin Creek,1965,145,,257,14749
Sashin Creek,1965,6,,258,14755
Sashin Creek,1965,130,,259,14885
Sashin Creek,1965,33,,260,14918
Sashin Creek,1965,13,,261,14931
Sashin Creek,1965,8,,262,14939
Sashin Creek,1965,117,,263,15056
Sashin Creek,1965,3,,264,15059
Sashin Creek,1965,1,,265,15060
Sashin Creek,1965,5,,266,15065
Sashin Creek,1965,5,,267,15070
Sashin Creek,1965,7,,270,15077
Sashin Creek,1965,1,,271,15078
Sashin Creek,1966,68,,235,68
Sashin Creek,1966,40,,236,108
Sashin Creek,1966,59,,237,167
Sashin Creek,1966,542,,238,709
Sashin Creek,1966,424,,239,1133
Sashin Creek,1966,274,,240,1407
Sashin Creek,1966,373,,241,1780
Sashin Creek,1966,677,,242,2457
Sashin Creek,1966,1551,,243,4008
Sashin Creek,1966,700,,244,4708
Sashin Creek,1966,146,,245,4854
Sashin Creek,1966,71,,246,4925
Sashin Creek,1966,514,,247,5439
Sashin Creek,1966,151,,248,5590
Sashin Creek,1966,21,,249,5611
Sashin Creek,1966,1,,250,5612
Sashin Creek,1966,14,,251,5626
Sashin Creek,1966,12,,252,5638
Sashin Creek,1966,12,,253,5650
Sashin Creek,1966,3,,254,5653
Sashin Creek,1966,11,,255,5664
Sashin Creek,1966,25,,256,5689
Sashin Creek,1966,2,,257,5691
Sashin Creek,1966,7,,258,5698
Sashin Creek,1966,31,,259,5729
Sashin Creek,1966,3,,260,5732
Sashin Creek,1966,5,,261,5737
Sashin Creek,1966,24,,262,5761
Sashin Creek,1967,3,,220,3
Sashin Creek,1967,299,,221,302
Sashin Creek,1967,2359,,222,2661
Sashin Creek,1967,3355,,223,6016
Sashin Creek,1967,1819,,224,7835
Sashin Creek,1967,345,,225,8180
Sashin Creek,1967,896,,226,9076
Sashin Creek,1967,406,,227,9482
Sashin Creek,1967,1407,,228,10889
Sashin Creek,1967,131,,229,11020
Sashin Creek,1967,884,,230,11904
Sashin Creek,1967,6965,,231,18869
Sashin Creek,1967,3229,,232,22098
Sashin Creek,1967,3166,,233,25264
Sashin Creek,1967,2045,,234,27309
Sashin Creek,1967,1209,,235,28518
Sashin Creek,1967,89,,236,28607
Sashin Creek,1967,757,,237,29364
Sashin Creek,1967,1422,,238,30786
Sashin Creek,1967,282,,239,31068
Sashin Creek,1967,129,,240,31197
Sashin Creek,1967,15,,241,31212
Sashin Creek,1967,461,,242,31673
Sashin Creek,1967,2426,,243,34099
Sashin Creek,1967,2111,,244,36210
Sashin Creek,1967,59,,245,36269
Sashin Creek,1967,809,,246,37078
Sashin Creek,1967,171,,247,37249
Sashin Creek,1967,60,,248,37309
Sashin Creek,1967,17,,249,37326
Sashin Creek,1967,61,,250,37387
Sashin Creek,1967,336,,251,37723
Sashin Creek,1967,44,,252,37767
Sashin Creek,1967,132,,253,37899
Sashin Creek,1967,66,,254,37965
Sashin Creek,1967,40,,255,38005
Sashin Creek,1967,40,,256,38045
Sashin Creek,1967,8,,257,38053
Sashin Creek,1967,33,,258,38086
Sashin Creek,1967,12,,259,38098
Sashin Creek,1967,9,,260,38107
Sashin Creek,1968,1,,220,1
Sashin Creek,1968,2,,229,3
Sashin Creek,1968,60,,230,63
Sashin Creek,1968,782,,231,845
Sashin Creek,1968,571,,232,1416
Sashin Creek,1968,338,,233,1754
Sashin Creek,1968,338,,234,2092
Sashin Creek,1968,274,,235,2366
Sashin Creek,1968,367,,236,2733
Sashin Creek,1968,479,,237,3212
Sashin Creek,1968,340,,238,3552
Sashin Creek,1968,479,,239,4031
Sashin Creek,1968,510,,240,4541
Sashin Creek,1968,917,,241,5458
Sashin Creek,1968,108,,242,5566
Sashin Creek,1968,285,,243,5851
Sashin Creek,1968,1496,,244,7347
Sashin Creek,1968,1315,,245,8662
Sashin Creek,1968,1383,,246,10045
Sashin Creek,1968,764,,247,10809
Sashin Creek,1968,187,,248,10996
Sashin Creek,1968,339,,249,11335
Sashin Creek,1968,232,,250,11567
Sashin Creek,1968,447,,251,12014
Sashin Creek,1968,134,,252,12148
Sashin Creek,1968,31,,253,12179
Sashin Creek,1968,194,,254,12373
Sashin Creek,1968,95,,255,12468
Sashin Creek,1968,32,,256,12500
Sashin Creek,1968,30,,257,12530
Sashin Creek,1968,9,,258,12539
Sashin Creek,1968,42,,259,12581
Sashin Creek,1968,42,,260,12623
Sashin Creek,1968,1,,261,12624
Sashin Creek,1968,2,,262,12626
Sashin Creek,1968,2,,263,12628
Sashin Creek,1968,7,,264,12635
Sashin Creek,1968,1,,265,12636
Sashin Creek,1968,1,,266,12637
Sashin Creek,1968,1,,267,12638
Sashin Creek,1969,1,,215,1
Sashin Creek,1969,55,,221,56
Sashin Creek,1969,58,,222,114
Sashin Creek,1969,1467,,223,1581
Sashin Creek,1969,5279,,224,6860
Sashin Creek,1969,3405,,225,10265
Sashin Creek,1969,6580,,226,16845
Sashin Creek,1969,5145,,227,21990
Sashin Creek,1969,929,,228,22919
Sashin Creek,1969,329,,229,23248
Sashin Creek,1969,1363,,230,24611
Sashin Creek,1969,898,,231,25509
Sashin Creek,1969,1007,,232,26516
Sashin Creek,1969,124,,233,26640
Sashin Creek,1969,165,,234,26805
Sashin Creek,1969,450,,235,27255
Sashin Creek,1969,738,,236,27993
Sashin Creek,1969,695,,238,28688
Sashin Creek,1969,864,,239,29552
Sashin Creek,1969,563,,240,30115
Sashin Creek,1969,2268,,241,32383
Sashin Creek,1969,411,,242,32794
Sashin Creek,1969,106,,243,32900
Sashin Creek,1969,690,,244,33590
Sashin Creek,1969,39,,245,33629
Sashin Creek,1969,287,,246,33916
Sashin Creek,1969,243,,247,34159
Sashin Creek,1969,269,,248,34428
Sashin Creek,1969,50,,249,34478
Sashin Creek,1969,17,,250,34495
Sashin Creek,1969,54,,251,34549
Sashin Creek,1969,400,,252,34949
Sashin Creek,1969,33,,253,34982
Sashin Creek,1969,168,,254,35150
Sashin Creek,1969,113,,255,35263
Sashin Creek,1969,43,,256,35306
Sashin Creek,1969,107,,257,35413
Sashin Creek,1969,4,,258,35417
Sashin Creek,1969,57,,259,35474
Sashin Creek,1969,20,,260,35494
Sashin Creek,1969,32,,261,35526
Sashin Creek,1969,9,,262,35535
Sashin Creek,1969,2,,263,35537
Sashin Creek,1969,1,,264,35538
Sashin Creek,1970,200,,220,200
Sashin Creek,1970,1,,221,201
Sashin Creek,1970,1,,224,202
Sashin Creek,1970,4,,225,206
Sashin Creek,1970,12,,226,218
Sashin Creek,1970,18,,227,236
Sashin Creek,1970,28,,229,264
Sashin Creek,1970,58,,230,322
Sashin Creek,1970,79,,231,401
Sashin Creek,1970,20,,232,421
Sashin Creek,1970,21,,233,442
Sashin Creek,1970,214,,234,656
Sashin Creek,1970,170,,235,826
Sashin Creek,1970,162,,236,988
Sashin Creek,1970,374,,237,1362
Sashin Creek,1970,274,,238,1636
Sashin Creek,1970,491,,239,2127
Sashin Creek,1970,487,,240,2614
Sashin Creek,1970,1653,,241,4267
Sashin Creek,1970,1362,,242,5629
Sashin Creek,1970,862,,243,6491
Sashin Creek,1970,1176,,244,7667
Sashin Creek,1970,432,,245,8099
Sashin Creek,1970,652,,246,8751
Sashin Creek,1970,244,,247,8995
Sashin Creek,1970,108,,248,9103
Sashin Creek,1970,126,,249,9229
Sashin Creek,1970,50,,250,9279
Sashin Creek,1970,36,,251,9315
Sashin Creek,1970,42,,252,9357
Sashin Creek,1970,17,,253,9374
Sashin Creek,1970,7,,254,9381
Sashin Creek,1970,8,,255,9389
Sashin Creek,1970,8,,256,9397
Sashin Creek,1970,8,,257,9405
Sashin Creek,1970,26,,259,9431
Sashin Creek,1970,3,,260,9434
Sashin Creek,1970,1,,263,9435
Sashin Creek,1970,2,,264,9437
Sashin Creek,1971,1,,219,1
Sashin Creek,1971,3,,220,4
Sashin Creek,1971,37,,221,41
Sashin Creek,1971,2,,222,43
Sashin Creek,1971,68,,223,111
Sashin Creek,1971,497,,224,608
Sashin Creek,1971,609,,225,1217
Sashin Creek,1971,1649,,226,2866
Sashin Creek,1971,1873,,227,4739
Sashin Creek,1971,4221,,228,8960
Sashin Creek,1971,2929,,229,11889
Sashin Creek,1971,400,,230,12289
Sashin Creek,1971,2217,,231,14506
Sashin Creek,1971,1870,,232,16376
Sashin Creek,1971,387,,233,16763
Sashin Creek,1971,3833,,234,20596
Sashin Creek,1971,3808,,235,24404
Sashin Creek,1971,5462,,236,29866
Sashin Creek,1971,4648,,237,34514
Sashin Creek,1971,2888,,238,37402
Sashin Creek,1971,3224,,239,40626
Sashin Creek,1971,1141,,240,41767
Sashin Creek,1971,23,,241,41790
Sashin Creek,1971,345,,242,42135
Sashin Creek,1971,345,,243,42480
Sashin Creek,1971,3788,,244,46268
Sashin Creek,1971,2151,,245,48419
Sashin Creek,1971,683,,246,49102
Sashin Creek,1971,1803,,247,50905
Sashin Creek,1971,330,,248,51235
Sashin Creek,1971,2225,,249,53460
Sashin Creek,1971,1099,,250,54559
Sashin Creek,1971,1937,,251,56496
Sashin Creek,1971,2094,,252,58590
Sashin Creek,1971,89,,253,58679
Sashin Creek,1971,379,,255,59058
Sashin Creek,1971,317,,256,59375
Sashin Creek,1971,2578,,257,61953
Sashin Creek,1971,630,,258,62583
Sashin Creek,1971,630,,259,63213
Sashin Creek,1971,1852,,260,65065
Sashin Creek,1971,1222,,261,66287
Sashin Creek,1971,1148,,262,67435
Sashin Creek,1971,708,,263,68143
Sashin Creek,1971,671,,264,68814
Sashin Creek,1971,6,,265,68820
Sashin Creek,1971,87,,266,68907
Sashin Creek,1971,261,,267,69168
Sashin Creek,1971,89,,268,69257
Sashin Creek,1971,65,,270,69322
Sashin Creek,1971,59,,271,69381
Sashin Creek,1971,11,,273,69392
Sashin Creek,1971,22,,274,69414
Sashin Creek,1971,18,,276,69432
Sashin Creek,1971,28,,277,69460
Sashin Creek,1971,2,,279,69462
Sashin Creek,1971,1,,280,69463
Sashin Creek,1971,1,,282,69464
Sashin Creek,1971,1,,287,69465
Sashin Creek,1971,2,,294,69467
Sashin Creek,1972,20,,220,20
Sashin Creek,1972,1,,221,21
Sashin Creek,1972,1,,222,22
Sashin Creek,1972,4,,224,26
Sashin Creek,1972,2,,225,28
Sashin Creek,1972,4,,226,32
Sashin Creek,1972,6,,227,38
Sashin Creek,1972,76,,228,114
Sashin Creek,1972,104,,229,218
Sashin Creek,1972,152,,230,370
Sashin Creek,1972,186,,231,556
Sashin Creek,1972,135,,232,691
Sashin Creek,1972,190,,233,881
Sashin Creek,1972,201,,234,1082
Sashin Creek,1972,1,,235,1083
Sashin Creek,1972,947,,236,2030
Sashin Creek,1972,388,,237,2418
Sashin Creek,1972,1028,,238,3446
Sashin Creek,1972,1540,,239,4986
Sashin Creek,1972,503,,240,5489
Sashin Creek,1972,1336,,241,6825
Sashin Creek,1972,716,,242,7541
Sashin Creek,1972,998,,243,8539
Sashin Creek,1972,575,,244,9114
Sashin Creek,1972,316,,245,9430
Sashin Creek,1972,573,,246,10003
Sashin Creek,1972,504,,247,10507
Sashin Creek,1972,607,,248,11114
Sashin Creek,1972,1289,,249,12403
Sashin Creek,1972,358,,250,12761
Sashin Creek,1972,186,,251,12947
Sashin Creek,1972,6,,252,12953
Sashin Creek,1972,177,,253,13130
Sashin Creek,1972,113,,254,13243
Sashin Creek,1972,107,,255,13350
Sashin Creek,1972,10,,256,13360
Sashin Creek,1972,15,,257,13375
Sashin Creek,1972,3,,258,13378
Sashin Creek,1972,17,,259,13395
Sashin Creek,1972,1,,260,13396
Sashin Creek,1972,1,,266,13397
Sashin Creek,1972,2,,269,13399
Sashin Creek,1972,2,,271,13401
Sashin Creek,1973,12,,213,12
Sashin Creek,1973,1,,214,13
Sashin Creek,1973,44,,215,57
Sashin Creek,1973,38,,216,95
Sashin Creek,1973,13,,217,108
Sashin Creek,1973,488,,218,596
Sashin Creek,1973,329,,219,925
Sashin Creek,1973,534,,220,1459
Sashin Creek,1973,296,,221,1755
Sashin Creek,1973,167,,222,1922
Sashin Creek,1973,42,,223,1964
Sashin Creek,1973,595,,224,2559
Sashin Creek,1973,137,,225,2696
Sashin Creek,1973,53,,226,2749
Sashin Creek,1973,59,,227,2808
Sashin Creek,1973,4,,229,2812
Sashin Creek,1973,33,,230,2845
Sashin Creek,1973,23,,231,2868
Sashin Creek,1973,112,,233,2980
Sashin Creek,1973,14,,234,2994
Sashin Creek,1973,212,,235,3206
Sashin Creek,1973,232,,236,3438
Sashin Creek,1973,32,,237,3470
Sashin Creek,1973,6,,238,3476
Sashin Creek,1973,48,,240,3524
Sashin Creek,1973,29,,241,3553
Sashin Creek,1973,32,,242,3585
Sashin Creek,1973,4,,243,3589
Sashin Creek,1973,1,,244,3590
Sashin Creek,1973,4,,245,3594
Sashin Creek,1973,5,,246,3599
Sashin Creek,1973,1,,247,3600
Sashin Creek,1973,4,,248,3604
Sashin Creek,1973,2,,249,3606
Sashin Creek,1974,41,,234,41
Sashin Creek,1974,162,,235,203
Sashin Creek,1974,214,,236,417
Sashin Creek,1974,140,,237,557
Sashin Creek,1974,392,,238,949
Sashin Creek,1974,127,,239,1076
Sashin Creek,1974,257,,240,1333
Sashin Creek,1974,144,,241,1477
Sashin Creek,1974,372,,242,1849
Sashin Creek,1974,227,,243,2076
Sashin Creek,1974,182,,244,2258
Sashin Creek,1974,286,,245,2544
Sashin Creek,1974,339,,246,2883
Sashin Creek,1974,274,,247,3157
Sashin Creek,1974,563,,248,3720
Sashin Creek,1974,634,,249,4354
Sashin Creek,1974,676,,250,5030
Sashin Creek,1974,461,,251,5491
Sashin Creek,1974,761,,252,6252
Sashin Creek,1974,200,,253,6452
Sashin Creek,1974,157,,254,6609
Sashin Creek,1974,154,,255,6763
Sashin Creek,1974,146,,256,6909
Sashin Creek,1974,106,,257,7015
Sashin Creek,1974,13,,258,7028
Sashin Creek,1974,55,,259,7083
Sashin Creek,1974,31,,260,7114
Sashin Creek,1974,15,,261,7129
Sashin Creek,1974,7,,262,7136
Sashin Creek,1974,5,,263,7141
Sashin Creek,1974,1,,264,7142
Sashin Creek,1974,1,,267,7143
Sashin Creek,1974,2,,268,7145
Sashin Creek,1974,3,,269,7148
Sashin Creek,1975,4,,212,4
Sashin Creek,1975,1,,217,5
Sashin Creek,1975,4,,218,9
Sashin Creek,1975,3,,219,12
Sashin Creek,1975,2,,220,14
Sashin Creek,1975,8,,221,22
Sashin Creek,1975,6,,222,28
Sashin Creek,1975,9,,223,37
Sashin Creek,1975,19,,224,56
Sashin Creek,1975,41,,225,97
Sashin Creek,1975,45,,226,142
Sashin Creek,1975,36,,227,178
Sashin Creek,1975,45,,228,223
Sashin Creek,1975,88,,229,311
Sashin Creek,1975,108,,230,419
Sashin Creek,1975,101,,231,520
Sashin Creek,1975,210,,232,730
Sashin Creek,1975,163,,233,893
Sashin Creek,1975,71,,234,964
Sashin Creek,1975,65,,235,1029
Sashin Creek,1975,162,,236,1191
Sashin Creek,1975,137,,237,1328
Sashin Creek,1975,215,,238,1543
Sashin Creek,1975,228,,239,1771
Sashin Creek,1975,490,,240,2261
Sashin Creek,1975,492,,241,2753
Sashin Creek,1975,366,,242,3119
Sashin Creek,1975,263,,243,3382
Sashin Creek,1975,341,,244,3723
Sashin Creek,1975,515,,245,4238
Sashin Creek,1975,334,,246,4572
Sashin Creek,1975,273,,247,4845
Sashin Creek,1975,245,,248,5090
Sashin Creek,1975,56,,249,5146
Sashin Creek,1975,84,,250,5230
Sashin Creek,1975,43,,251,5273
Sashin Creek,1975,9,,252,5282
Sashin Creek,1975,14,,254,5296
Sashin Creek,1975,6,,255,5302
Sashin Creek,1975,1,,258,5303
Sashin Creek,1975,1,,267,5304
Sashin Creek,1976,2,,224,2
Sashin Creek,1976,1,,227,3
Sashin Creek,1976,1,,230,4
Sashin Creek,1976,14,,233,18
Sashin Creek,1976,2,,234,20
Sashin Creek,1976,9,,235,29
Sashin Creek,1976,6,,236,35
Sashin Creek,1976,29,,237,64
Sashin Creek,1976,310,,238,374
Sashin Creek,1976,146,,239,520
Sashin Creek,1976,315,,240,835
Sashin Creek,1976,289,,241,1124
Sashin Creek,1976,149,,242,1273
Sashin Creek,1976,213,,243,1486
Sashin Creek,1976,223,,244,1709
Sashin Creek,1976,433,,245,2142
Sashin Creek,1976,284,,246,2426
Sashin Creek,1976,167,,247,2593
Sashin Creek,1976,182,,248,2775
Sashin Creek,1976,155,,249,2930
Sashin Creek,1976,65,,250,2995
Sashin Creek,1976,495,,251,3490
Sashin Creek,1976,159,,252,3649
Sashin Creek,1976,57,,253,3706
Sashin Creek,1976,24,,254,3730
Sashin Creek,1976,13,,255,3743
Sashin Creek,1976,24,,256,3767
Sashin Creek,1976,31,,257,3798
Sashin Creek,1976,11,,258,3809
Sashin Creek,1976,2,,259,3811
Sashin Creek,1976,8,,262,3819
Sashin Creek,1976,5,,263,3824
Sashin Creek,1976,1,,264,3825
Sashin Creek,1976,3,,265,3828
Sashin Creek,1977,33,,220,33
Sashin Creek,1977,137,,221,170
Sashin Creek,1977,819,,222,989
Sashin Creek,1977,616,,223,1605
Sashin Creek,1977,484,,224,2089
Sashin Creek,1977,210,,225,2299
Sashin Creek,1977,147,,226,2446
Sashin Creek,1977,228,,227,2674
Sashin Creek,1977,316,,228,2990
Sashin Creek,1977,230,,229,3220
Sashin Creek,1977,132,,230,3352
Sashin Creek,1977,102,,231,3454
Sashin Creek,1977,60,,232,3514
Sashin Creek,1977,343,,233,3857
Sashin Creek,1977,216,,234,4073
Sashin Creek,1977,857,,235,4930
Sashin Creek,1977,759,,236,5689
Sashin Creek,1977,458,,237,6147
Sashin Creek,1977,765,,238,6912
Sashin Creek,1977,3200,,239,10112
Sashin Creek,1977,6179,,240,16291
Sashin Creek,1977,2835,,241,19126
Sashin Creek,1977,926,,242,20052
Sashin Creek,1977,931,,243,20983
Sashin Creek,1977,428,,244,21411
Sashin Creek,1977,422,,245,21833
Sashin Creek,1977,178,,246,22011
Sashin Creek,1977,253,,247,22264
Sashin Creek,1977,2571,,248,24835
Sashin Creek,1977,979,,249,25814
Sashin Creek,1977,388,,250,26202
Sashin Creek,1977,1803,,251,28005
Sashin Creek,1977,252,,252,28257
Sashin Creek,1977,164,,253,28421
Sashin Creek,1977,59,,254,28480
Sashin Creek,1977,9,,255,28489
Sashin Creek,1977,14,,256,28503
Sashin Creek,1977,9,,257,28512
Sashin Creek,1977,5,,258,28517
Sashin Creek,1977,2,,259,28519
Sashin Creek,1977,1,,263,28520
Sashin Creek,1977,1,,264,28521
Sashin Creek,1977,1,,265,28522
Sashin Creek,1977,3,,266,28525
Sashin Creek,1978,1,,223,1
Sashin Creek,1978,1,,224,2
Sashin Creek,1978,3,,225,5
Sashin Creek,1978,2,,226,7
Sashin Creek,1978,5,,228,12
Sashin Creek,1978,56,,229,68
Sashin Creek,1978,104,,230,172
Sashin Creek,1978,259,,231,431
Sashin Creek,1978,383,,232,814
Sashin Creek,1978,979,,233,1793
Sashin Creek,1978,1190,,234,2983
Sashin Creek,1978,876,,235,3859
Sashin Creek,1978,667,,236,4526
Sashin Creek,1978,848,,237,5374
Sashin Creek,1978,964,,238,6338
Sashin Creek,1978,746,,239,7084
Sashin Creek,1978,546,,240,7630
Sashin Creek,1978,6477,,241,14107
Sashin Creek,1978,4288,,242,18395
Sashin Creek,1978,3455,,243,21850
Sashin Creek,1978,5104,,244,26954
Sashin Creek,1978,4565,,245,31519
Sashin Creek,1978,2330,,246,33849
Sashin Creek,1978,1127,,247,34976
Sashin Creek,1978,789,,248,35765
Sashin Creek,1978,817,,249,36582
Sashin Creek,1978,399,,250,36981
Sashin Creek,1978,874,,251,37855
Sashin Creek,1978,386,,252,38241
Sashin Creek,1978,417,,253,38658
Sashin Creek,1978,571,,254,39229
Sashin Creek,1978,2147,,255,41376
Sashin Creek,1978,2384,,256,43760
Sashin Creek,1978,427,,257,44187
Sashin Creek,1978,203,,258,44390
Sashin Creek,1978,153,,259,44543
Sashin Creek,1978,104,,260,44647
Sashin Creek,1978,35,,261,44682
Sashin Creek,1978,2,,262,44684
Sashin Creek,1978,20,,263,44704
Sashin Creek,1978,9,,264,44713
Sashin Creek,1978,22,,265,44735
Sashin Creek,1978,13,,266,44748
Sashin Creek,1978,2,,267,44750
Sashin Creek,1978,2,,268,44752
Sashin Creek,1978,2,,270,44754
Sashin Creek,1978,1,,271,44755
Sashin Creek,1978,1,,272,44756
Sashin Creek,1979,1,,198,1
Sashin Creek,1979,1,,200,2
Sashin Creek,1979,1,,201,3
Sashin Creek,1979,1,,202,4
Sashin Creek,1979,1,,210,5
Sashin Creek,1979,7,,212,12
Sashin Creek,1979,39,,213,51
Sashin Creek,1979,240,,214,291
Sashin Creek,1979,264,,215,555
Sashin Creek,1979,324,,216,879
Sashin Creek,1979,819,,217,1698
Sashin Creek,1979,1050,,218,2748
Sashin Creek,1979,1233,,219,3981
Sashin Creek,1979,1235,,220,5216
Sashin Creek,1979,1840,,221,7056
Sashin Creek,1979,1867,,222,8923
Sashin Creek,1979,1659,,223,10582
Sashin Creek,1979,1858,,224,12440
Sashin Creek,1979,1695,,225,14135
Sashin Creek,1979,1235,,226,15370
Sashin Creek,1979,1637,,227,17007
Sashin Creek,1979,1973,,228,18980
Sashin Creek,1979,4184,,229,23164
Sashin Creek,1979,3556,,230,26720
Sashin Creek,1979,2394,,231,29114
Sashin Creek,1979,1507,,232,30621
Sashin Creek,1979,833,,233,31454
Sashin Creek,1979,460,,234,31914
Sashin Creek,1979,1163,,235,33077
Sashin Creek,1979,282,,236,33359
Sashin Creek,1979,79,,237,33438
Sashin Creek,1979,2852,,243,36290
Sashin Creek,1979,4618,,244,40908
Sashin Creek,1979,21562,,245,62470
Sashin Creek,1979,22688,,246,85158
Sashin Creek,1979,6998,,247,92156
Sashin Creek,1979,454,,248,92610
Sashin Creek,1979,3523,,249,96133
Sashin Creek,1979,76,,250,96209
Sashin Creek,1979,790,,251,96999
Sashin Creek,1979,1075,,252,98074
Sashin Creek,1979,763,,253,98837
Sashin Creek,1979,2849,,254,101686
Sashin Creek,1979,5428,,255,107114
Sashin Creek,1979,3196,,256,110310
Sashin Creek,1979,2159,,257,112469
Sashin Creek,1979,998,,258,113467
Sashin Creek,1979,676,,259,114143
Sashin Creek,1979,173,,260,114316
Sashin Creek,1979,67,,261,114383
Sashin Creek,1979,5,,263,114388
Sashin Creek,1979,19,,264,114407
Sashin Creek,1979,23,,265,114430
Sashin Creek,1979,3,,266,114433
Sashin Creek,1979,1,,269,114434
Sashin Creek,1979,2,,270,114436
Sashin Creek,1979,5,,271,114441
Sashin Creek,1979,1,,272,114442
Sashin Creek,1980,2,,213,2
Sashin Creek,1980,1,,216,3
Sashin Creek,1980,3,,225,6
Sashin Creek,1980,184,,226,190
Sashin Creek,1980,107,,227,297
Sashin Creek,1980,312,,228,609
Sashin Creek,1980,646,,229,1255
Sashin Creek,1980,1121,,230,2376
Sashin Creek,1980,1390,,231,3766
Sashin Creek,1980,1273,,232,5039
Sashin Creek,1980,2344,,233,7383
Sashin Creek,1980,1829,,234,9212
Sashin Creek,1980,971,,235,10183
Sashin Creek,1980,673,,236,10856
Sashin Creek,1980,4585,,237,15441
Sashin Creek,1980,2228,,238,17669
Sashin Creek,1980,1925,,239,19594
Sashin Creek,1980,2194,,240,21788
Sashin Creek,1980,6470,,241,28258
Sashin Creek,1980,2760,,242,31018
Sashin Creek,1980,2969,,243,33987
Sashin Creek,1980,3725,,244,37712
Sashin Creek,1980,2674,,245,40386
Sashin Creek,1980,2028,,246,42414
Sashin Creek,1980,1069,,247,43483
Sashin Creek,1980,922,,248,44405
Sashin Creek,1980,556,,249,44961
Sashin Creek,1980,760,,250,45721
Sashin Creek,1980,716,,251,46437
Sashin Creek,1980,580,,252,47017
Sashin Creek,1980,1487,,253,48504
Sashin Creek,1980,946,,254,49450
Sashin Creek,1980,1173,,255,50623
Sashin Creek,1980,1306,,256,51929
Sashin Creek,1980,586,,257,52515
Sashin Creek,1980,690,,258,53205
Sashin Creek,1980,322,,259,53527
Sashin Creek,1980,118,,260,53645
Sashin Creek,1980,574,,261,54219
Sashin Creek,1980,418,,262,54637
Sashin Creek,1980,54,,263,54691
Sashin Creek,1980,116,,264,54807
Sashin Creek,1980,26,,265,54833
Sashin Creek,1980,18,,269,54851
Sashin Creek,1980,1,,271,54852
Sashin Creek,1980,1,,273,54853
Sashin Creek,1980,1,,274,54854
Sashin Creek,1986,3,,236,3
Sashin Creek,1986,1,,237,4
Sashin Creek,1986,0,,238,4
Sashin Creek,1986,147,,239,151
Sashin Creek,1986,321,,240,472
Sashin Creek,1986,320,,241,792
Sashin Creek,1986,470,,242,1262
Sashin Creek,1986,1311,,243,2573
Sashin Creek,1986,1607,,244,4180
Sashin Creek,1986,604,,245,4784
Sashin Creek,1986,657,,246,5441
Sashin Creek,1986,592,,247,6033
Sashin Creek,1986,271,,248,6304
Sashin Creek,1986,104,,249,6408
Sashin Creek,1986,487,,250,6895
Sashin Creek,1986,183,,251,7078
Sashin Creek,1986,495,,252,7573
Sashin Creek,1986,557,,253,8130
Sashin Creek,1986,77,,254,8207
Sashin Creek,1986,74,,255,8281
Sashin Creek,1986,121,,256,8402
Sashin Creek,1986,264,,257,8666
Sashin Creek,1986,360,,258,9026
Sashin Creek,1986,103,,259,9129
Sashin Creek,1986,148,,260,9277
Sashin Creek,1986,213,,261,9490
Sashin Creek,1986,250,,262,9740
Sashin Creek,1986,136,,263,9876
Sashin Creek,1986,177,,264,10053
Sashin Creek,1986,322,,265,10375
Sashin Creek,1986,71,,266,10446
Sashin Creek,1986,32,,267,10478
Sashin Creek,1986,8,,268,10486
Sashin Creek,1986,1,,269,10487
Sashin Creek,1986,0,,270,10487
Sashin Creek,1986,0,,271,10487
Sashin Creek,1987,236,,238,236
Sashin Creek,1987,0,,239,236
Sashin Creek,1987,0,,240,236
Sashin Creek,1987,84,,241,320
Sashin Creek,1987,72,,242,392
Sashin Creek,1987,0,,243,392
Sashin Creek,1987,249,,244,641
Sashin Creek,1987,167,,245,808
Sashin Creek,1987,166,,246,974
Sashin Creek,1987,368,,247,1342
Sashin Creek,1987,135,,248,1477
Sashin Creek,1987,924,,249,2401
Sashin Creek,1987,1411,,250,3812
Sashin Creek,1987,1319,,251,5131
Sashin Creek,1987,1227,,252,6358
Sashin Creek,1987,817,,253,7175
Sashin Creek,1987,629,,254,7804
Sashin Creek,1987,380,,255,8184
Sashin Creek,1987,208,,256,8392
Sashin Creek,1987,652,,257,9044
Sashin Creek,1987,191,,258,9235
Sashin Creek,1987,43,,259,9278
Sashin Creek,1987,1,,260,9279
Sashin Creek,1987,0,,261,9279
Sashin Creek,1987,0,,262,9279
Sashin Creek,1987,0,,263,9279
Sashin Creek,1987,2,,264,9281
Sashin Creek,1987,1,,265,9282
Sashin Creek,1987,2,,266,9284
Sashin Creek,1987,0,,267,9284
Sashin Creek,1987,0,,268,9284
Sashin Creek,1987,0,,270,9284
Sashin Creek,1995,2,,225,2
Sashin Creek,1995,60,,226,62
Sashin Creek,1995,29,,227,91
Sashin Creek,1995,0,,228,91
Sashin Creek,1995,0,,229,91
Sashin Creek,1995,10,,230,101
Sashin Creek,1995,13,,231,114
Sashin Creek,1995,37,,232,151
Sashin Creek,1995,12,,233,163
Sashin Creek,1995,69,,234,232
Sashin Creek,1995,161,,235,393
Sashin Creek,1995,6,,236,399
Sashin Creek,1995,10,,237,409
Sashin Creek,1995,37,,238,446
Sashin Creek,1995,46,,239,492
Sashin Creek,1995,13,,240,505
Sashin Creek,1995,37,,241,542
Sashin Creek,1995,128,,242,670
Sashin Creek,1995,5180,,243,5850
Sashin Creek,1995,7770,,244,13620
Sashin Creek,1995,7547,,245,21167
Sashin Creek,1995,3888,,246,25055
Sashin Creek,1995,3314,,247,28369
Sashin Creek,1995,2450,,248,30819
Sashin Creek,1995,1192,,249,32011
Sashin Creek,1995,2146,,250,34157
Sashin Creek,1995,9434,,251,43591
Sashin Creek,1995,17,,252,43608
Sashin Creek,1995,11249,,253,54857
Sashin Creek,1995,8929,,255,63786
Sashin Creek,1995,12799,,256,76585
Sashin Creek,1995,11499,,257,88084
Sashin Creek,1995,7702,,258,95786
Sashin Creek,1995,2426,,259,98212
Sashin Creek,1995,2352,,260,100564
Sashin Creek,1995,968,,261,101532
Sashin Creek,1995,3981,,262,105513
Sashin Creek,1995,1833,,263,107346
Sashin Creek,1996,5,,221,5
Sashin Creek,1996,11,,223,16
Sashin Creek,1996,4,,224,20
Sashin Creek,1996,75,,225,95
Sashin Creek,1996,258,,226,353
Sashin Creek,1996,452,,227,805
Sashin Creek,1996,296,,228,1101
Sashin Creek,1996,296,,229,1397
Sashin Creek,1996,526,,230,1923
Sashin Creek,1996,5108,,231,7031
Sashin Creek,1996,1377,,232,8408
Sashin Creek,1996,1014,,233,9422
Sashin Creek,1996,1202,,234,10624
Sashin Creek,1996,4992,,235,15616
Sashin Creek,1996,5330,,236,20946
Sashin Creek,1996,2144,,237,23090
Sashin Creek,1996,1754,,238,24844
Sashin Creek,1996,7025,,239,31869
Sashin Creek,1996,6673,,240,38542
Sashin Creek,1996,10095,,241,48637
Sashin Creek,1996,8122,,242,56759
Sashin Creek,1996,6125,,243,62884
Sashin Creek,1996,11410,,244,74294
Sashin Creek,1996,12516,,245,86810
Sashin Creek,1996,6781,,246,93591
Sashin Creek,1996,2713,,247,96304
Sashin Creek,1996,3281,,248,99585
Sashin Creek,1996,621,,249,100206
Sashin Creek,1996,1006,,250,101212
Sashin Creek,1996,569,,251,101781
Sashin Creek,1996,2009,,252,103790
Sashin Creek,1996,3618,,253,107408
Sashin Creek,1996,3160,,254,110568
Sashin Creek,1996,7707,,255,118275
Sashin Creek,1996,6114,,256,124389
Sashin Creek,1996,1903,,257,126292
Sashin Creek,1996,4213,,258,130505
Sashin Creek,1996,3009,,259,133514
Sashin Creek,1996,1702,,260,135216
Sashin Creek,1996,4130,,261,139346
Sashin Creek,1996,3490,,262,142836
Sashin Creek,1996,1436,,263,144272
Sashin Creek,1996,2133,,264,146405
Sashin Creek,1996,890,,265,147295
Sashin Creek,1996,2117,,266,149412
Sashin Creek,1996,2059,,267,151471
Sashin Creek,1996,1902,,268,153373
Sashin Creek,1996,447,,269,153820
Sashin Creek,1996,1148,,270,154968
Sashin Creek,1997,15,,232,15
Sashin Creek,1997,15,,233,30
Sashin Creek,1997,241,,234,271
Sashin Creek,1997,310,,235,581
Sashin Creek,1997,634,,236,1215
Sashin Creek,1997,1326,,237,2541
Sashin Creek,1997,1908,,238,4449
Sashin Creek,1997,2457,,239,6906
Sashin Creek,1997,1539,,240,8445
Sashin Creek,1997,607,,241,9052
Sashin Creek,1997,94,,242,9146
Sashin Creek,1997,175,,243,9321
Sashin Creek,1997,129,,244,9450
Sashin Creek,1997,1427,,245,10877
Sashin Creek,1997,1419,,246,12296
Sashin Creek,1997,1858,,247,14154
Sashin Creek,1997,1402,,248,15556
Sashin Creek,1997,813,,249,16369
Sashin Creek,1997,488,,250,16857
Sashin Creek,1997,1352,,251,18209
Sashin Creek,1997,1568,,252,19777
Sashin Creek,1997,477,,253,20254
Sashin Creek,1997,693,,254,20947
Sashin Creek,1997,592,,255,21539
Sashin Creek,1997,217,,256,21756
Sashin Creek,1997,963,,257,22719
Sashin Creek,1997,1180,,258,23899
Sashin Creek,1997,1704,,259,25603
Sashin Creek,1997,1304,,260,26907
Sashin Creek,1997,1157,,261,28064
Sashin Creek,1997,2500,,262,30564
Sashin Creek,1997,1233,,263,31797
Sashin Creek,1997,406,,264,32203
Sashin Creek,1997,119,,265,32322
Sashin Creek,1997,104,,266,32426
Sashin Creek,1997,138,,267,32564
Sashin Creek,1997,31,,268,32595
Sashin Creek,1997,39,,269,32634
Sashin Creek,1997,22,,270,32656
Sashin Creek,1997,1,,271,32657
Sashin Creek,1997,14,,272,32671
Sashin Creek,1997,4,,273,32675
Sashin Creek,1997,4,,274,32679
Sashin Creek,1997,2,,275,32681
Sashin Creek,1997,0,,276,32681
Sashin Creek,1998,2,,219,2
Sashin Creek,1998,15,,220,17
Sashin Creek,1998,122,,221,139
Sashin Creek,1998,18,,222,157
Sashin Creek,1998,30,,223,187
Sashin Creek,1998,6,,224,193
Sashin Creek,1998,2,,225,195
Sashin Creek,1998,10,,226,205
Sashin Creek,1998,8,,227,213
Sashin Creek,1998,0,,228,213
Sashin Creek,1998,1,,229,214
Sashin Creek,1998,8,,230,222
Sashin Creek,1998,42,,231,264
Sashin Creek,1998,38,,232,302
Sashin Creek,1998,42,,233,344
Sashin Creek,1998,328,,234,672
Sashin Creek,1998,1528,,235,2200
Sashin Creek,1998,488,,236,2688
Sashin Creek,1998,4109,,237,6797
Sashin Creek,1998,1741,,238,8538
Sashin Creek,1998,1762,,239,10300
Sashin Creek,1998,7,,240,10307
Sashin Creek,1998,304,,241,10611
Sashin Creek,1998,304,,242,10915
Sashin Creek,1998,215,,243,11130
Sashin Creek,1998,84,,244,11214
Sashin Creek,1998,209,,245,11423
Sashin Creek,1998,216,,246,11639
Sashin Creek,1998,273,,247,11912
Sashin Creek,1998,197,,248,12109
Sashin Creek,1998,773,,249,12882
Sashin Creek,1998,1032,,250,13914
Sashin Creek,1998,1615,,251,15529
Sashin Creek,1998,921,,252,16450
Sashin Creek,1998,818,,253,17268
Sashin Creek,1998,786,,254,18054
Sashin Creek,1998,1293,,255,19347
Sashin Creek,1998,436,,256,19783
Sashin Creek,1998,549,,257,20332
Sashin Creek,1998,274,,258,20606
Sashin Creek,1998,642,,259,21248
Sashin Creek,1998,445,,260,21693
Sashin Creek,1998,358,,261,22051
Sashin Creek,1998,318,,262,22369
Sashin Creek,1998,181,,263,22550
Sashin Creek,1998,225,,264,22775
Sashin Creek,1998,87,,265,22862
Sashin Creek,1998,137,,266,22999
Sashin Creek,1998,191,,267,23190
Sashin Creek,1998,49,,268,23239
Sashin Creek,1998,72,,269,23311
Sashin Creek,1998,22,,270,23333
Sashin Creek,1998,3,,271,23336
Sashin Creek,1998,6,,272,23342
Sashin Creek,1998,0,,273,23342
Sashin Creek,1998,2,,274,23344
Sashin Creek,1998,3,,275,23347
Sashin Creek,1998,0,,276,23347
Sashin Creek,1998,3,,277,23350
Sashin Creek,1998,0,,278,23350
Sashin Creek,1998,2,,279,23352
Sashin Creek,1998,1,,280,23353
Sashin Creek,1998,2,,282,23355
Sashin Creek,1999,1,,228,1
Sashin Creek,1999,2,,229,3
Sashin Creek,1999,9,,230,12
Sashin Creek,1999,3,,231,15
Sashin Creek,1999,44,,232,59
Sashin Creek,1999,5,,233,64
Sashin Creek,1999,10,,234,74
Sashin Creek,1999,30,,235,104
Sashin Creek,1999,20,,236,124
Sashin Creek,1999,14,,237,138
Sashin Creek,1999,10,,238,148
Sashin Creek,1999,106,,239,254
Sashin Creek,1999,34,,240,288
Sashin Creek,1999,94,,241,382
Sashin Creek,1999,137,,242,519
Sashin Creek,1999,414,,243,933
Sashin Creek,1999,955,,244,1888
Sashin Creek,1999,2071,,245,3959
Sashin Creek,1999,4279,,246,8238
Sashin Creek,1999,1655,,247,9893
Sashin Creek,1999,3014,,248,12907
Sashin Creek,1999,2115,,249,15022
Sashin Creek,1999,85,,250,15107
Sashin Creek,1999,663,,251,15770
Sashin Creek,1999,679,,252,16449
Sashin Creek,1999,1796,,253,18245
Sashin Creek,1999,3561,,254,21806
Sashin Creek,1999,7157,,255,28963
Sashin Creek,1999,5132,,256,34095
Sashin Creek,1999,5372,,257,39467
Sashin Creek,1999,3206,,258,42673
Sashin Creek,1999,3103,,259,45776
Sashin Creek,1999,1116,,260,46892
Sashin Creek,1999,1449,,261,48341
Sashin Creek,1999,1296,,262,49637
Sashin Creek,1999,1613,,263,51250
Sashin Creek,1999,1490,,264,52740
Sashin Creek,1999,0,,265,52740
Sashin Creek,1999,996,,266,53736
Sashin Creek,1999,1726,,267,55462
Sashin Creek,1999,480,,268,55942
Sashin Creek,1999,531,,269,56473
Sashin Creek,1999,278,,270,56751
Sashin Creek,1999,238,,271,56989
Sashin Creek,1999,97,,272,57086
Sashin Creek,1999,53,,273,57139
Sashin Creek,1999,15,,274,57154
Sashin Creek,2000,76,,229,76
Sashin Creek,2000,29,,230,105
Sashin Creek,2000,83,,231,188
Sashin Creek,2000,218,,232,406
Sashin Creek,2000,82,,233,488
Sashin Creek,2000,171,,234,659
Sashin Creek,2000,130,,235,789
Sashin Creek,2000,28,,236,817
Sashin Creek,2000,155,,237,972
Sashin Creek,2000,136,,238,1108
Sashin Creek,2000,164,,239,1272
Sashin Creek,2000,573,,240,1845
Sashin Creek,2000,389,,241,2234
Sashin Creek,2000,546,,242,2780
Sashin Creek,2000,405,,243,3185
Sashin Creek,2000,461,,244,3646
Sashin Creek,2000,173,,245,3819
Sashin Creek,2000,79,,246,3898
Sashin Creek,2000,965,,247,4863
Sashin Creek,2000,1371,,248,6234
Sashin Creek,2000,629,,249,6863
Sashin Creek,2000,136,,250,6999
Sashin Creek,2000,184,,251,7183
Sashin Creek,2000,100,,252,7283
Sashin Creek,2000,122,,253,7405
Sashin Creek,2000,222,,254,7627
Sashin Creek,2000,142,,255,7769
Sashin Creek,2000,81,,256,7850
Sashin Creek,2000,68,,257,7918
Sashin Creek,2000,110,,259,8028
Sashin Creek,2000,25,,260,8053
Sashin Creek,2000,24,,261,8077
Sashin Creek,2000,6,,262,8083
Sashin Creek,2000,18,,263,8101
Sashin Creek,2000,2,,264,8103
Sashin Creek,2000,5,,265,8108
Sashin Creek,2000,6,,266,8114
Sashin Creek,2000,10,,267,8124
Sashin Creek,2000,4,,268,8128
Sashin Creek,2000,3,,269,8131
Sashin Creek,2000,2,,270,8133
Sashin Creek,2000,3,,271,8136
Sashin Creek,2000,0,,272,8136
Sashin Creek,2000,4,,273,8140
Sashin Creek,2000,0,,274,8140
Sashin Creek,2000,0,,275,8140
Sashin Creek,2000,0,,276,8140
Sashin Creek,2001,2096,,234,2096
Sashin Creek,2001,4959,,235,7055
Sashin Creek,2001,3848,,236,10903
Sashin Creek,2001,5334,,240,16237
Sashin Creek,2001,2418,,241,18655
Sashin Creek,2001,3477,,242,22132
Sashin Creek,2001,4983,,243,27115
Sashin Creek,2001,3547,,244,30662
Sashin Creek,2001,1787,,245,32449
Sashin Creek,2001,1910,,246,34359
Sashin Creek,2001,4056,,247,38415
Sashin Creek,2001,2973,,248,41388
Sashin Creek,2001,3278,,249,44666
Sashin Creek,2001,2619,,250,47285
Sashin Creek,2001,1465,,251,48750
Sashin Creek,2001,94,,252,48844
Sashin Creek,2001,3094,,253,51938
Sashin Creek,2001,912,,254,52850
Sashin Creek,2001,1188,,255,54038
Sashin Creek,2001,2167,,256,56205
Sashin Creek,2001,2380,,257,58585
Sashin Creek,2001,183,,258,58768
Sashin Creek,2001,841,,259,59609
Sashin Creek,2001,291,,260,59900
Sashin Creek,2001,272,,261,60172
Sashin Creek,2001,562,,262,60734
Sashin Creek,2001,129,,263,60863
Sashin Creek,2001,5,,264,60868
Sashin Creek,2001,37,,266,60905
Sashin Creek,2001,16,,267,60921
Sashin Creek,2001,15,,268,60936
Sashin Creek,2001,8,,269,60944
Sashin Creek,2002,2,,230,2
Sashin Creek,2002,9,,231,11
Sashin Creek,2002,3,,232,14
Sashin Creek,2002,109,,233,123
Sashin Creek,2002,94,,234,217
Sashin Creek,2002,294,,235,511
Sashin Creek,2002,262,,236,773
Sashin Creek,2002,277,,237,1050
Sashin Creek,2002,437,,238,1487
Sashin Creek,2002,466,,239,1953
Sashin Creek,2002,803,,240,2756
Sashin Creek,2002,704,,241,3460
Sashin Creek,2002,201,,242,3661
Sashin Creek,2002,430,,243,4091
Sashin Creek,2002,261,,244,4352
Sashin Creek,2002,363,,245,4715
Sashin Creek,2002,202,,246,4917
Sashin Creek,2002,192,,247,5109
Sashin Creek,2002,237,,248,5346
Sashin Creek,2002,98,,249,5444
Sashin Creek,2002,784,,250,6228
Sashin Creek,2002,852,,251,7080
Sashin Creek,2002,716,,252,7796
Sashin Creek,2002,573,,253,8369
Sashin Creek,2002,450,,254,8819
Sashin Creek,2002,259,,255,9078
Sashin Creek,2002,299,,256,9377
Sashin Creek,2002,90,,257,9467
Sashin Creek,2002,393,,258,9860
Sashin Creek,2002,218,,259,10078
Sashin Creek,2002,205,,260,10283
Sashin Creek,2002,70,,261,10353
Sashin Creek,2002,28,,262,10381
Sashin Creek,2002,52,,263,10433
Sashin Creek,2002,10,,264,10443
Sashin Creek,2002,17,,265,10460
Sashin Creek,2002,9,,266,10469
Sashin Creek,2002,15,,267,10484
Sashin Creek,2002,4,,268,10488
Sashin Creek,2002,15,,269,10503
Sashin Creek,2002,12,,270,10515
Sashin Creek,2002,0,,271,10515
Sashin Creek,2002,1,,272,10516
Sashin Creek,2002,1,,273,10517
Sashin Creek,2002,2,,274,10519
Sashin Creek,2002,1,,275,10520
Situk Lower,1988,2,,189,2
Situk Lower,1988,1,"1 RS mort, 1 chum, yellow 270 tags",190,3
Situk Lower,1988,2,"1 RS mort, 141 tags yellow cum. 399 yellow",192,5
Situk Lower,1988,2,"1 king tagged, 161 tagged yellow cum 560 cum Y",193,7
Situk Lower,1988,2,,194,9
Situk Lower,1988,8,"266/992 up, 45k tagged cum",195,17
Situk Lower,1988,7,,196,24
Situk Lower,1988,3,1 RS mort,197,27
Situk Lower,1988,4,1 moriband sockeye down,198,31
Situk Lower,1988,6,,199,37
Situk Lower,1988,7,,200,44
Situk Lower,1988,177,,201,221
Situk Lower,1988,80,,202,301
Situk Lower,1988,31,,203,332
Situk Lower,1988,147,,204,479
Situk Lower,1988,403,,207,882
Situk Lower,1988,29,,208,911
Situk Lower,1988,53,,209,964
Situk Lower,1988,124,,210,1088
Situk Lower,1988,2,,210,1090
Situk Lower,1988,949,,211,2039
Situk Lower,1988,3,,211,2042
Situk Lower,1988,150,,212,2192
Situk Lower,1988,148,,213,2340
Situk Lower,1988,43,,214,2383
Situk Lower,1988,113,,215,2496
Situk Lower,1988,18,,216,2514
Situk Lower,1988,279,,217,2793
Situk Lower,1988,2243,,218,5036
Situk Lower,1988,1642,1 AD clip,219,6678
Situk Lower,1988,10,,220,6688
Situk Lower,1988,1169,,221,7857
Situk Lower,1988,505,"Weir washed under pickets, Approx 300 reds and 3000 pinks thru it",222,8362
Situk Lower,1988,941,1 female king mort,223,9303
Situk Lower,1988,1211,,224,10514
Situk Lower,1988,8116,,225,18630
Situk Lower,1988,4670,,226,23300
Situk Lower,1988,11322,,227,34622
Situk Lower,1988,14312,,228,48934
Situk Lower,1988,4011,,229,52945
Situk Lower,1988,2935,,230,55880
Situk Lower,1988,9536,,231,65416
Situk Lower,1988,1799,,232,67215
Situk Lower,1988,8503,,233,75718
Situk Lower,1988,3041,,234,78759
Situk Lower,1989,6,2 NM king,189,6
Situk Lower,1989,4,1 NM king,190,10
Situk Lower,1989,14,65 NM king,191,24
Situk Lower,1989,6,10 NM king,192,30
Situk Lower,1989,4,"1 SH down, 4 NM king",193,34
Situk Lower,1989,24,6 NM king,194,58
Situk Lower,1989,3,9 NM king,195,61
Situk Lower,1989,1,,196,62
Situk Lower,1989,3,,197,65
Situk Lower,1989,25,,198,90
Situk Lower,1989,115,18 NM king,199,205
Situk Lower,1989,66,14 NM king,200,271
Situk Lower,1989,295,3 NM king,201,566
Situk Lower,1989,1487,10 NM king,202,2053
Situk Lower,1989,313,1 NM king,203,2366
Situk Lower,1989,1589,3 NM kings,204,3955
Situk Lower,1989,350,,205,4305
Situk Lower,1989,1596,5 NM king,206,5901
Situk Lower,1989,2189,9 NM king,207,8090
Situk Lower,1989,12711,25 NM king,208,20801
Situk Lower,1989,17206,22 NM king,209,38007
Situk Lower,1989,21934,26 NM king,210,59941
Situk Lower,1989,8789,2 NM king,211,68730
Situk Lower,1989,6850,,212,75580
Situk Lower,1989,10226,1 NM king,213,85806
Situk Lower,1989,26487,"2 NM king,",214,112293
Situk Lower,1989,34106,1 NM king,215,146399
Situk Lower,1989,18796,1 NM king,216,165195
Situk Lower,1989,9779,1 NM king,217,174974
Situk Lower,1989,26066,1 NM king,218,201040
Situk Lower,1989,9113,,219,210153
Situk Lower,1989,13613,,220,223766
Situk Lower,1989,10814,,221,234580
Situk Lower,1989,10533,,222,245113
Situk Lower,1989,5248,,223,250361
Situk Lower,1989,1112,,224,251473
Situk Lower,1989,10514,,225,261987
Situk Lower,1989,8347,,226,270334
Situk Lower,1989,9017,,227,279351
Situk Lower,1989,8401,,228,287752
Situk Lower,1989,494,Weir removed by noon,229,288246
Situk Lower,1991,2,"Washout, 10/5/10 chinook up",192,2
Situk Lower,1991,1,1 NM chinook,193,3
Situk Lower,1991,10,7 NM chinook,194,13
Situk Lower,1991,52,1 NM chinook,195,65
Situk Lower,1991,51,4 NM chinook,196,116
Situk Lower,1991,19,2 NM chinook,197,135
Situk Lower,1991,46,3 NM chinook,198,181
Situk Lower,1991,40,5 NM chinook,199,221
Situk Lower,1991,82,2 NM chinook,200,303
Situk Lower,1991,283,"1 NM chinook, 5 NM SH mort",201,586
Situk Lower,1991,600,10 NM chinook,202,1186
Situk Lower,1991,228,2 NM chinook,203,1414
Situk Lower,1991,100,,204,1514
Situk Lower,1991,500,"Pickets pulled, numbers estimated",205,2014
Situk Lower,1991,26,Fish tight at 1:00 PM,206,2040
Situk Lower,1991,1190,,207,3230
Situk Lower,1991,938,"Weir washout in flood, not replaced",208,4168
Situk Lower,1992,150,1 nm chinook,198,150
Situk Lower,1992,118,2 nm chinook,199,268
Situk Lower,1992,112,"12856 sockeye, 33 nm chinook",200,380
Situk Lower,1992,25,,201,405
Situk Lower,1992,364,,202,769
Situk Lower,1992,541,,203,1310
Situk Lower,1992,1566,,204,2876
Situk Lower,1992,1047,"2 ac, 3 nm chinook",205,3923
Situk Lower,1992,909,"1 ac, 1 nm chinook",206,4832
Situk Lower,1992,1056,2 ac chinook,207,5888
Situk Lower,1992,908,1 nm chinook,208,6796
Situk Lower,1992,690,,209,7486
Situk Lower,1992,1692,,210,9178
Situk Lower,1992,3554,,211,12732
Situk Lower,1992,935,"1 ac, 1 nm chinook",212,13667
Situk Lower,1992,5256,1 nm chinook,215,18923
Situk Lower,1992,5357,,216,24280
Situk Lower,1992,3169,,217,27449
Situk Lower,1992,1829,"1 ac, 1nm chinook",218,29278
Situk Lower,1993,38,10 NM chinook,193,38
Situk Lower,1993,7,,194,45
Situk Lower,1993,36,7 NM chinook,195,81
Situk Lower,1993,17,5 NM chinook,196,98
Situk Lower,1993,26,6 NM chinook,197,124
Situk Lower,1993,2,,198,126
Situk Lower,1993,10,2 NM chinook,199,136
Situk Lower,1993,21,4 NM chinook,200,157
Situk Lower,1993,5,4 NM chinook,201,162
Situk Lower,1993,44,6 NM chinook,202,206
Situk Lower,1993,53,5 NM chinook,203,259
Situk Lower,1993,2,"1 ad clip, 18 NM chinook",204,261
Situk Lower,1993,38,"1 SH down, 3 NM chinook",205,299
Situk Lower,1993,84,1 NM chinook,206,383
Situk Lower,1993,99,1 NM chinook,207,482
Situk Lower,1993,168,,208,650
Situk Lower,1993,605,,209,1255
Situk Lower,1993,370,1 NM chinook,210,1625
Situk Lower,1993,83,,211,1708
Situk Lower,1993,442,1 NM chinook,212,2150
Situk Lower,1993,198,2 NM chinook,213,2348
Situk Lower,1993,2671,8NM chinook,214,5019
Situk Lower,1993,5576,10 NM chinook,215,10595
Situk Lower,1993,4183,3 NM chinook,216,14778
Situk Lower,1993,1507,100 chinook below weir prior to removal,217,16285
Situk Lower,1994,1,9 NM chinook,180,1
Situk Lower,1994,10,"Cumulative 7745 SH down, 5 NM chinook",183,11
Situk Lower,1994,5,24 NM chinook,184,16
Situk Lower,1994,2,5 NM chinook,185,18
Situk Lower,1994,21,"Cumulative 7754 SH down, 82 NM chinook",186,39
Situk Lower,1994,2,3 NM chinook,187,41
Situk Lower,1994,41,"Cumulative 7783 SH down, 13 NM chinook",188,82
Situk Lower,1994,12,"Cumulative 7807 SH down, 9 NM chinook",189,94
Situk Lower,1994,55,7 NM chinook,191,149
Situk Lower,1994,50,11 NM chinook,192,199
Situk Lower,1994,29,1 NM chinook,193,228
Situk Lower,1994,16,9 NM chinook,194,244
Situk Lower,1994,21,1 NM chinook,195,265
Situk Lower,1994,39,,196,304
Situk Lower,1994,20,Cumulative 7812 SH down,197,324
Situk Lower,1994,3,,198,327
Situk Lower,1994,134,5 NM chinook,199,461
Situk Lower,1994,90,"4 NM chinook, cumulative 7813 SH down",200,551
Situk Lower,1994,104,"33 NM chinook, cumulative 7823 SH down",201,655
Situk Lower,1994,15,"2 NM chinook, cumulative 7853 SH down",202,670
Situk Lower,1994,65,1 NM chinook,203,735
Situk Lower,1994,333,1 NM chinook,204,1068
Situk Lower,1994,1143,1 NM chinook,205,2211
Situk Lower,1994,1768,2 NM chinook,206,3979
Situk Lower,1994,3061,3 NM chinook,207,7040
Situk Lower,1994,3416,2 NM chinook,208,10456
Situk Lower,1994,14684,11 NM chinook,209,25140
Situk Lower,1994,1289,Cumulative 7854 SH down,210,26429
Situk Lower,1994,15229,4 NM chinook,211,41658
Situk Lower,1994,6110,,212,47768
Situk Lower,1994,9601,1 NM chinook,213,57369
Situk Lower,1994,8073,,214,65442
Situk Lower,1994,5847,2 NM chinook,215,71289
Situk Lower,1994,7766,"2 NM chinook, last day of weir counts, 7858 SH down",216,79055
Situk Lower,1995,18,"5 SH down, cum 6565 down",190,18
Situk Lower,1995,6,,191,24
Situk Lower,1995,2,,192,26
Situk Lower,1995,12,"34 SH down, cum 6599 down",193,38
Situk Lower,1995,27,,194,65
Situk Lower,1995,5,,195,70
Situk Lower,1995,33,,196,103
Situk Lower,1995,20,,197,123
Situk Lower,1995,61,,198,184
Situk Lower,1995,228,,199,412
Situk Lower,1995,236,,200,648
Situk Lower,1995,2378,,201,3026
Situk Lower,1995,186,,202,3212
Situk Lower,1995,1590,,203,4802
Situk Lower,1995,612,,204,5414
Situk Lower,1995,781,,205,6195
Situk Lower,1995,1949,"3 SH down, cum 6603 down",206,8144
Situk Lower,1995,818,,207,8962
Situk Lower,1995,1175,,208,10137
Situk Lower,1995,1954,,209,12091
Situk Lower,1995,3666,,210,15757
Situk Lower,1995,3577,"1 SH down, cum 6604 down",211,19334
Situk Lower,1995,9243,,212,28577
Situk Lower,1995,26256,,213,54833
Situk Lower,1995,10649,,214,65482
Situk Lower,1995,791,"Flood, weir removed, 4 SH down, cum 6608 down",215,66273
Situk Lower,1996,4,11 NM chinook,187,4
Situk Lower,1996,1,24 NM chinook,188,5
Situk Lower,1996,4,29 NM chinook,189,9
Situk Lower,1996,5,5 NM chinook,190,14
Situk Lower,1996,28,13 NM chinook,191,42
Situk Lower,1996,40,8 NM chinook,192,82
Situk Lower,1996,14,6 NM chinook,193,96
Situk Lower,1996,5,2 NM chinook,194,101
Situk Lower,1996,6,1 NM chinook,195,107
Situk Lower,1996,11,15 NM chinook,196,118
Situk Lower,1996,162,17 NM chinook,197,280
Situk Lower,1996,321,21 NM chinook,198,601
Situk Lower,1996,479,12 NM chinook,199,1080
Situk Lower,1996,3482,18 NM chinook,200,4562
Situk Lower,1996,332,2 NM chinook,201,4894
Situk Lower,1996,250,8 NM chinook,202,5144
Situk Lower,1996,1404,1 NM chinook,203,6548
Situk Lower,1996,1626,2 NM chinook,204,8174
Situk Lower,1996,1662,,205,9836
Situk Lower,1996,5325,8 NM chinook,206,15161
Situk Lower,1996,1755,7 NM chinook,207,16916
Situk Lower,1996,4591,1 NM chinook,208,21507
Situk Lower,1996,5822,,209,27329
Situk Lower,1996,10771,2 NM chinook,210,38100
Situk Lower,1996,5216,1 NM chinook,211,43316
Situk Lower,1996,2578,,212,45894
Situk Lower,1996,3475,,213,49369
Situk Lower,1996,1118,7 NM chinook,214,50487
Situk Lower,1996,11365,8 NM chinook,215,61852
Situk Lower,1996,15730,3 NM chinook,216,77582
Situk Lower,1996,18601,2 NM chinook,217,96183
Situk Lower,1996,29373,2 NM chinook,218,125556
Situk Lower,1996,31456,Last day of weir operation,219,157012
Situk Lower,1997,1,25 NM chinook,180,1
Situk Lower,1997,2,3 NM chinook,185,3
Situk Lower,1997,10,18 NM chinook,186,13
Situk Lower,1997,2,10 NM chinook,187,15
Situk Lower,1997,15,6 NM chinook,188,30
Situk Lower,1997,7,2 NM chinook,189,37
Situk Lower,1997,10,1 NM chinook,190,47
Situk Lower,1997,23,3 NM chinook,191,70
Situk Lower,1997,59,14 NM chinook,192,129
Situk Lower,1997,492,91 NM chinook,193,621
Situk Lower,1997,275,16 NM chinook,194,896
Situk Lower,1997,65,4 NM chinook,195,961
Situk Lower,1997,85,3 NM chinook,196,1046
Situk Lower,1997,1147,9 NM chinook,197,2193
Situk Lower,1997,2216,3 NM chinook,198,4409
Situk Lower,1997,3445,13 NM chinook,199,7854
Situk Lower,1997,840,,200,8694
Situk Lower,1997,823,13 NM chinook,201,9517
Situk Lower,1997,3264,12 NM chinook,202,12781
Situk Lower,1997,5503,1 NM chinook,203,18284
Situk Lower,1997,17434,4 NM chinook,204,35718
Situk Lower,1997,8013,2 NM chinook,205,43731
Situk Lower,1997,4197,,206,47928
Situk Lower,1997,36242,4 NM chinook,207,84170
Situk Lower,1997,37220,5 NM chinook,208,121390
Situk Lower,1997,36374,12 NM chinook,209,157764
Situk Lower,1997,38181,,210,195945
Situk Lower,1997,43040,,211,238985
Situk Lower,1997,32352,,212,271337
Situk Lower,1997,13158,,213,284495
Situk Lower,1997,8557,,214,293052
Situk Lower,1997,34258,,215,327310
Situk Lower,1997,24557,2 NM chinook,216,351867
Situk Lower,1997,21762,1 NM chinook,217,373629
Situk Lower,1997,57598,2 NM chinook,218,431227
Situk Lower,1997,35040,,219,466267
Situk Lower,1998,23,"1 adult king mort washed up on weir, first pinks of the year",185,23
Situk Lower,1998,204,1 adult king mort washed up on weir,187,227
Situk Lower,1998,42,,188,269
Situk Lower,1998,87,,189,356
Situk Lower,1998,33,1 jack king mort on weir,190,389
Situk Lower,1998,84,1 adult king washed up on weir,191,473
Situk Lower,1998,30,1 adult king washed up on weir,192,503
Situk Lower,1998,23,1 adult king mort washed up on weir,193,526
Situk Lower,1998,188,,194,714
Situk Lower,1998,335,1 jack king mort washed up on weir,195,1049
Situk Lower,1998,45,,196,1094
Situk Lower,1998,183,,197,1277
Situk Lower,1998,74,1 mort sockeye washed up on weir,198,1351
Situk Lower,1998,263,,199,1614
Situk Lower,1998,239,,200,1853
Situk Lower,1998,240,1 adult mort king washed up on weir,201,2093
Situk Lower,1998,42,"boat panels under water this morning, 15 sockeye passed, weir fish tight by",202,2135
Situk Lower,1998,464,,203,2599
Situk Lower,1998,273,,204,2872
Situk Lower,1998,232,panels flooded at 94cm @ 2130,205,3104
Situk Lower,1998,183,"all panels under water by 0230, began 8 hour random count of fish passage",206,3287
Situk Lower,1998,192,"panels above water @ 1200, water level 92cm, back to reg. schedule counting",207,3479
Situk Lower,1998,1336,,208,4815
Situk Lower,1998,2707,,209,7522
Situk Lower,1998,8147,3 pink morts on weir,210,15669
Situk Lower,1998,13771,"3 pinks morts on weir, coho began showing up",211,29440
Situk Lower,1998,15842,,212,45282
Situk Lower,1998,9940,7 pink morts on weir today,213,55222
Situk Lower,1998,4724,"5 pink morts, 2 jack king morts on weir",214,59946
Situk Lower,1998,20891,6 pink morts on weir,215,80837
Situk Lower,1998,5638,8 pink morts on weir,216,86475
Situk Lower,1998,10917,,217,97392
Situk Lower,1999,1,"sampled 2 chinook, 22 sox",193,1
Situk Lower,1999,24,,194,25
Situk Lower,1999,10,,196,35
Situk Lower,1999,34,"sampled 2 chinook, 30 sox",197,69
Situk Lower,1999,8,"sampled 1 chinook, 13 sox",200,77
Situk Lower,1999,38,"sampled 1 chinook, 22 sox",201,115
Situk Lower,1999,5,"sampled 6 chinook, 10 sox",202,120
Situk Lower,1999,21,"sampled 0 chinook, 10 sox",203,141
Situk Lower,1999,62,"sampled 0 chinook, 10 sox",204,203
Situk Lower,1999,12,sampled 10 sox,205,215
Situk Lower,1999,4,"sampled 1 chinook, 9 sox",206,219
Situk Lower,1999,74,,207,293
Situk Lower,1999,1058,,208,1351
Situk Lower,1999,520,"sampled 7 chinook, 12 sox",209,1871
Situk Lower,1999,323,"sampled 62 chinook, 9 sox",210,2194
Situk Lower,1999,208,"sampled 4 chinook, 5 sox",211,2402
Situk Lower,1999,570,sampled 5 sox,212,2972
Situk Lower,1999,788,"sampled 2 chinook, 5 sox",213,3760
Situk Lower,1999,1337,sampled 3 sox,214,5097
Situk Lower,1999,7529,,215,12626
Situk Lower,1999,4345,,216,16971
Situk Lower,1999,1947,,217,18918
Situk Lower,1999,8468,,218,27386
Situk Lower,2000,11,"19 ch, 23 sox sampled",184,11
Situk Lower,2000,5,"8 ch, 17 sox sampled",185,16
Situk Lower,2000,1,"2 ch, 1 sox sampled",187,17
Situk Lower,2000,7,"4 ch, 1 sox sampled",188,24
Situk Lower,2000,1,"9 ch, 54 sox sampled",189,25
Situk Lower,2000,121,"16 ch, 47 sox sampled",190,146
Situk Lower,2000,29,39 sox sampled,191,175
Situk Lower,2000,59,"7 ch, 21 sox sampled",192,234
Situk Lower,2000,5,"4 ch, 20 sox sampled",193,239
Situk Lower,2000,118,"3 ch, 14 sox sampled",194,357
Situk Lower,2000,44,,195,401
Situk Lower,2000,79,1 ch sampled,196,480
Situk Lower,2000,49,"3 ch, 10 sox sampled",197,529
Situk Lower,2000,33,11 sox sampled,198,562
Situk Lower,2000,1080,"5 ch, 20 sox sampled",199,1642
Situk Lower,2000,221,"2 ch, 19 sox sampled",200,1863
Situk Lower,2000,1202,11 sox sampled,201,3065
Situk Lower,2000,377,"9 ch, 22 sox sampled",202,3442
Situk Lower,2000,2128,"5 ch, 15 sox sampled",203,5570
Situk Lower,2000,3809,16 sox sampled,204,9379
Situk Lower,2000,1242,,205,10621
Situk Lower,2000,324,"1 ch, 1 sox sampled",206,10945
Situk Lower,2000,4835,"1 ch, 10 sox sampled",207,15780
Situk Lower,2000,13534,18 sox sampled,208,29314
Situk Lower,2000,19209,"7 sox sampled, 3 chums sampled",209,48523
Situk Lower,2000,20627,4 sox sampled,210,69150
Situk Lower,2000,11197,10 sox sampled,211,80347
Situk Lower,2000,18887,4 sox sampled,212,99234
Situk Lower,2000,2104,,213,101338
Situk Lower,2000,1001,"2 ch, 4 sox sampled",214,102339
Situk Lower,2000,23386,3 sox sampled,215,125725
Situk Lower,2000,9537,,216,135262
Situk Lower,2000,31471,"9 sox sampled, 4 sh up",217,166733
Situk Lower,2000,29226,5 sh up,218,195959
Situk Lower,2000,24047,2 sh up,219,220006
Situk Lower,2000,75791,1 sh up,220,295797
Situk Lower,2000,35713,,221,331510
Situk Lower,2001,3,"1 chum upstream, sampled 15 chinook, 12 sockeye",183,3
Situk Lower,2001,67,"1 chum up, sample 4 chinook, 12 sockeye",186,70
Situk Lower,2001,5,"1 sh up, sample 5 chinook, 19 sockeye",187,75
Situk Lower,2001,5,"1 sh up, sample 15 chinook, 24 sockeye",189,80
Situk Lower,2001,21,"1 sh up, sample 2 chinook, 3 sockeye",194,101
Situk Lower,2001,108,"1 large chinook mort, sample 9 chinook, 31 sockeye",195,209
Situk Lower,2001,46,"sample 8 chinook, 53 sockeye",196,255
Situk Lower,2001,61,sample 27 sockeye,197,316
Situk Lower,2001,76,"sample 5 chinook, 21 sockeye",198,392
Situk Lower,2001,79,"sample 1 chinook, 19 sockeye",199,471
Situk Lower,2001,2820,"sample 5 chinook, 23 sockeye",200,3291
Situk Lower,2001,3637,"2 chums up, sample 4 chinook, 49 sockeye",201,6928
Situk Lower,2001,1329,sample 8 sockeye,202,8257
Situk Lower,2001,2722,"sample 2 chinook, 7 sockeye",203,10979
Situk Lower,2001,1125,"high 69, sample 7 sockeye",204,12104
Situk Lower,2001,508,sample 7 sockeye,205,12612
Situk Lower,2001,5024,sample 5 sockeye,206,17636
Situk Lower,2001,11082,sample 4 sockeye,207,28718
Situk Lower,2001,15889,sample 5 sockeye,208,44607
Situk Lower,2001,8371,sample 5 sockeye,209,52978
Situk Lower,2001,5735,2 chum up,210,58713
Situk Lower,2001,6282,2 chum up,211,64995
Situk Lower,2001,3738,,212,68733
Situk Lower,2001,4261,,213,72994
Situk Lower,2001,6336,,214,79330
Situk Lower,2001,14716,,215,94046
Situk Lower,2001,10204,2 chum up,216,104250
Situk Lower,2001,11480,5 chum up,217,115730
Situk Lower,2001,3602,1 chum up,218,119332
Situk Lower,2001,1353,1 chum up,219,120685
Situk Lower,2001,582,,220,121267
Situk Lower,2002,2,8 nm chinook,184,2
Situk Lower,2002,1,9 nm chinook,186,3
Situk Lower,2002,2,4 nm chinook,187,5
Situk Lower,2002,7,15 nm chinook,188,12
Situk Lower,2002,4,11 nm ch,190,16
Situk Lower,2002,1,1 nm ch,191,17
Situk Lower,2002,1,1 nm chinook,192,18
Situk Lower,2002,1,3 nm ch,193,19
Situk Lower,2002,3,11 nm ch,194,22
Situk Lower,2002,3,2 nm ch,195,25
Situk Lower,2002,1,,196,26
Situk Lower,2002,76,35 nm ch,197,102
Situk Lower,2002,2,,198,104
Situk Lower,2002,144,31 nm ch,199,248
Situk Lower,2002,557,3 nm ch,201,805
Situk Lower,2002,417,1 nm ch,202,1222
Situk Lower,2002,117,,203,1339
Situk Lower,2002,74,4 nm ch,204,1413
Situk Lower,2002,1417,8 nm ch,205,2830
Situk Lower,2002,61,"flooded, 5 AM fishtight",206,2891
Situk Lower,2002,968,,207,3859
Situk Lower,2002,814,,208,4673
Situk Lower,2002,351,,209,5024
Situk Lower,2002,5424,,210,10448
Situk Lower,2002,28110,,211,38558
Situk Lower,2002,5003,,212,43561
Situk Lower,2002,7291,,213,50852
Situk Lower,2002,4094,,214,54946
Situk Lower,2002,8191,,215,63137
Situk Lower,2002,10631,,216,73768
Situk Lower,2002,19712,,217,93480
Situk Lower,2002,4543,,218,98023
Situk Lower,2002,767,,219,98790
Situk Lower,2003,4,"1 S.H. up, 1 adult chinook mort.",179,4
Situk Lower,2003,1,,182,5
Situk Lower,2003,3,,183,8
Situk Lower,2003,2,1 adult chinook mort.,184,10
Situk Lower,2003,7,,185,17
Situk Lower,2003,17,,186,34
Situk Lower,2003,48,,187,82
Situk Lower,2003,310,,188,392
Situk Lower,2003,77,,189,469
Situk Lower,2003,3,,190,472
Situk Lower,2003,16,,191,488
Situk Lower,2003,119,,192,607
Situk Lower,2003,83,,193,690
Situk Lower,2003,259,,194,949
Situk Lower,2003,539,,195,1488
Situk Lower,2003,262,,196,1750
Situk Lower,2003,254,,197,2004
Situk Lower,2003,137,,198,2141
Situk Lower,2003,357,,199,2498
Situk Lower,2003,3405,,200,5903
Situk Lower,2003,6104,,201,12007
Situk Lower,2003,3063,,202,15070
Situk Lower,2003,6051,,203,21121
Situk Lower,2003,19509,,204,40630
Situk Lower,2003,29283,,205,69913
Situk Lower,2003,11510,,206,81423
Situk Lower,2003,10627,1 S.H. up,207,92050
Situk Lower,2003,3997,,208,96047
Situk Lower,2003,2867,,209,98914
Situk Lower,2003,2787,,210,101701
Situk Lower,2003,1667,,211,103368
Situk Lower,2003,61917,,212,165285
Situk Lower,2003,24013,,213,189298
Situk Lower,2003,12941,,214,202239
Situk Lower,2003,31658,,215,233897
Situk Lower,2003,42641,,216,276538
Situk Lower,2003,41140,,217,317678
Situk Lower,2003,19647,,218,337325
Situk Lower,2003,29496,,219,366821
Situk Lower,2003,7712,,220,374533
Situk Lower,2004,24,,190,24
Situk Lower,2004,34,,191,58
Situk Lower,2004,222,,192,280
Situk Lower,2004,48,,193,328
Situk Lower,2004,138,,194,466
Situk Lower,2004,19,,195,485
Situk Lower,2004,8,,196,493
Situk Lower,2004,100,,197,593
Situk Lower,2004,119,,198,712
Situk Lower,2004,49,,199,761
Situk Lower,2004,49,,200,810
Situk Lower,2004,5,,201,815
Situk Lower,2004,34,,202,849
Situk Lower,2004,12,,203,861
Situk Lower,2004,6,,204,867
Situk Lower,2004,16,,205,883
Situk Lower,2004,758,,206,1641
Situk Lower,2004,2912,,207,4553
Situk Lower,2004,3000,,208,7553
Situk Lower,2004,2198,,209,9751
Situk Lower,2004,352,,210,10103
Situk Lower,2004,352,,211,10455
Situk Lower,2004,716,,212,11171
Situk Lower,2004,839,,213,12010
Situk Lower,2004,6052,,214,18062
Situk Lower,2004,16393,,215,34455
Situk Lower,2004,25356,,216,59811
Situk Lower,2004,6268,,217,66079
Situk Lower,2004,27285,,218,93364
Situk Lower,2004,19923,,219,113287
Situk Lower,2004,14954,,220,128241
Situk Lower,2004,16697,,221,144938
Situk Lower,2005,2,,172,2
Situk Lower,2005,9,,173,11
Situk Lower,2005,7,,174,18
Situk Lower,2005,6,,175,24
Situk Lower,2005,1,,182,25
Situk Lower,2005,93,,183,118
Situk Lower,2005,22,,184,140
Situk Lower,2005,10,,185,150
Situk Lower,2005,9,,186,159
Situk Lower,2005,72,,187,231
Situk Lower,2005,129,,188,360
Situk Lower,2005,18,,189,378
Situk Lower,2005,9,,190,387
Situk Lower,2005,4,,191,391
Situk Lower,2005,1248,,192,1639
Situk Lower,2005,227,,193,1866
Situk Lower,2005,2556,,194,4422
Situk Lower,2005,257,,195,4679
Situk Lower,2005,2124,,196,6803
Situk Lower,2005,24310,,197,31113
Situk Lower,2005,13778,,198,44891
Situk Lower,2005,3703,,199,48594
Situk Lower,2005,27438,,200,76032
Situk Lower,2005,14213,,201,90245
Situk Lower,2005,9749,,202,99994
Situk Lower,2005,16240,,203,116234
Situk Lower,2005,25525,,204,141759
Situk Lower,2005,34645,,205,176404
Situk Lower,2005,10467,,206,186871
Situk Lower,2005,3316,,207,190187
Situk Lower,2005,15572,,208,205759
Situk Lower,2005,24985,,209,230744
Situk Lower,2005,9998,,210,240742
Situk Lower,2005,6875,,211,247617
Situk Lower,2005,33518,,212,281135
Situk Lower,2006,1,,191,1
Situk Lower,2006,14,,194,15
Situk Lower,2006,23,,195,38
Situk Lower,2006,10,,196,48
Situk Lower,2006,12,,197,60
Situk Lower,2006,3,,198,63
Situk Lower,2006,10,,199,73
Situk Lower,2006,100,,200,173
Situk Lower,2006,57,,201,230
Situk Lower,2006,141,,202,371
Situk Lower,2006,54,,203,425
Situk Lower,2006,1144,,204,1569
Situk Lower,2006,51,,205,1620
Situk Lower,2006,1141,,206,2761
Situk Lower,2006,1289,,207,4050
Situk Lower,2006,145,,208,4195
Situk Lower,2006,3464,,209,7659
Situk Lower,2006,9251,,210,16910
Situk Lower,2006,9117,,211,26027
Situk Lower,2006,4154,,212,30181
Situk Lower,2006,427,,213,30608
Situk Lower,2006,10703,,214,41311
Situk Lower,2006,11920,,215,53231
Situk Lower,2006,850,,216,54081
Situk Lower,2006,464,,217,54545
Situk Lower,2006,805,,218,55350
Situk Lower,2006,183,,219,55533
Situk Lower,2006,9177,,220,64710
Situk Lower,2006,5677,,221,70387
Situk Lower,2006,1769,,222,72156
Situk Lower,2006,1037,,223,73193
Situk Lower,2006,6663,,224,79856
Situk Lower,2006,11583,,225,91439
Situk Lower,2006,6618,,226,98057
Situk Lower,2006,16722,,227,114779
Situk Lower,2007,4,,191,4
Situk Lower,2007,5,,192,9
Situk Lower,2007,9,,194,18
Situk Lower,2007,23,,195,41
Situk Lower,2007,103,,196,144
Situk Lower,2007,296,,197,440
Situk Lower,2007,84,,198,524
Situk Lower,2007,215,,199,739
Situk Lower,2007,275,,200,1014
Situk Lower,2007,177,,201,1191
Situk Lower,2007,471,,202,1662
Situk Lower,2007,454,,203,2116
Situk Lower,2007,1243,,204,3359
Situk Lower,2007,771,,205,4130
Situk Lower,2007,2331,,206,6461
Situk Lower,2007,1424,,207,7885
Situk Lower,2007,195,,208,8080
Situk Lower,2007,4730,,209,12810
Situk Lower,2007,2897,,210,15707
Situk Lower,2007,9338,,211,25045
Situk Lower,2007,6448,,212,31493
Situk Lower,2007,18750,,213,50243
Situk Lower,2007,17009,,214,67252
Situk Lower,2007,8465,,215,75717
Situk Lower,2007,11597,,216,87314
Situk Lower,2007,9572,,217,96886
Situk Lower,2007,18224,,218,115110
Situk Lower,2007,11177,,219,126287
Situk Lower,2007,15442,,220,141729
Situk Lower,2007,29952,,221,171681
Situk Lower,2007,20682,,222,192363
Situk Lower,2007,15397,,223,207760
Situk Lower,2007,18410,,224,226170
Situk Lower,2007,2863,stopped counting at 24:00 PM,225,229033
Situk Lower,2008,2,,186,2
Situk Lower,2008,5,,187,7
Situk Lower,2008,24,,189,31
Situk Lower,2008,78,,190,109
Situk Lower,2008,14,,191,123
Situk Lower,2008,19,,192,142
Situk Lower,2008,16,,193,158
Situk Lower,2008,28,,194,186
Situk Lower,2008,24,,196,210
Situk Lower,2008,41,,197,251
Situk Lower,2008,16,,198,267
Situk Lower,2008,3,,199,270
Situk Lower,2008,59,"weir under @ 18:30, water level: 580 mm",200,329
Situk Lower,2008,142,,201,471
Situk Lower,2008,189,,202,660
Situk Lower,2008,16,,203,676
Situk Lower,2008,439,,204,1115
Situk Lower,2008,117,"weir pulled at 24:00, water level at 960 mm",205,1232
Situk Lower,2009,1,1 sh up,177,1
Situk Lower,2009,6,,181,7
Situk Lower,2009,8,,182,15
Situk Lower,2009,1,,184,16
Situk Lower,2009,4,,185,20
Situk Lower,2009,1,,186,21
Situk Lower,2009,1,,187,22
Situk Lower,2009,113,,188,135
Situk Lower,2009,1,,190,136
Situk Lower,2009,22,,191,158
Situk Lower,2009,22,,192,180
Situk Lower,2009,94,,193,274
Situk Lower,2009,68,,194,342
Situk Lower,2009,70,,195,412
Situk Lower,2009,7,,196,419
Situk Lower,2009,23,,197,442
Situk Lower,2009,64,,198,506
Situk Lower,2009,245,,199,751
Situk Lower,2009,32,,200,783
Situk Lower,2009,37,,201,820
Situk Lower,2009,16,,202,836
Situk Lower,2009,133,,203,969
Situk Lower,2009,237,,204,1206
Situk Lower,2009,74,,205,1280
Situk Lower,2009,373,,206,1653
Situk Lower,2009,6991,,207,8644
Situk Lower,2009,767,,208,9411
Situk Lower,2009,1683,,209,11094
Situk Lower,2009,6691,,210,17785
Situk Lower,2009,6150,,211,23935
Situk Lower,2009,1479,,212,25414
Situk Lower,2009,3967,Pulled trap,213,29381
Situk Lower,2009,2374,,214,31755
Situk Lower,2009,11271,,215,43026
Situk Lower,2009,12193,,216,55219
Situk Lower,2009,7568,"Pulled weir morning of August 6, 2009",217,62787
Situk Lower,2010,2,,196,2
Situk Lower,2010,4,,197,6
Situk Lower,2010,39,,198,45
Situk Lower,2010,5,,199,50
Situk Lower,2010,61,,200,111
Situk Lower,2010,1,,201,112
Situk Lower,2010,87,,202,199
Situk Lower,2010,118,,203,317
Situk Lower,2010,7,,204,324
Situk Lower,2010,37,,205,361
Situk Lower,2010,797,,206,1158
Situk Lower,2010,4559,"weir panels under water, covered in heavy moss",207,5717
Situk Lower,2010,2699,"weir panels under water, possible fish through unseen",208,8416
Situk Lower,2010,6854,,209,15270
Situk Lower,2010,13434,,210,28704
Situk Lower,2010,12274,,211,40978
Situk Lower,2010,4050,"water went up 6in in afternoon, panels under water",212,45028
Situk Lower,2010,17826,,213,62854
Situk Lower,2010,15681,,214,78535
Situk Lower,2010,10766,weir pulled on 8/5/10,215,89301
Situk Lower,2011,2,2 SH down,183,2
Situk Lower,2011,3,,189,5
Situk Lower,2011,2,2 SH down,191,7
Situk Lower,2011,3,,192,10
Situk Lower,2011,5,17 SH down,193,15
Situk Lower,2011,5,2 SH down,195,20
Situk Lower,2011,5,,196,25
Situk Lower,2011,15,,197,40
Situk Lower,2011,20,,198,60
Situk Lower,2011,16,,199,76
Situk Lower,2011,63,43 SH down,200,139
Situk Lower,2011,29,20 SH down,201,168
Situk Lower,2011,176,16 SH down,202,344
Situk Lower,2011,233,3 SH down,203,577
Situk Lower,2011,4418,,204,4995
Situk Lower,2011,7796,,205,12791
Situk Lower,2011,1568,9 SH down,206,14359
Situk Lower,2011,2788,,207,17147
Situk Lower,2011,3025,,208,20172
Situk Lower,2011,1404,,209,21576
Situk Lower,2011,10127,,210,31703
Situk Lower,2011,7920,,211,39623
Situk Lower,2011,2651,,212,42274
Situk Lower,2011,6236,,213,48510
Situk Lower,2011,8639,,214,57149
Situk Lower,2011,2663,,215,59812
Situk Lower,2011,3579,,216,63391
Situk Lower,2011,14107,,217,77498
Situk Lower,2011,90092,"1 SH down, sampling trap taken out",218,167590
Situk Lower,2011,31770,last day of counting- weir pulled 8/8/11,219,199360
Situk Lower,2012,2,,182,2
Situk Lower,2012,1,,188,3
Situk Lower,2012,1,,193,4
Situk Lower,2012,1,,195,5
Situk Lower,2012,2,,198,7
Situk Lower,2012,1,,200,8
Situk Lower,2012,9,,201,17
Situk Lower,2012,44,,203,61
Situk Lower,2012,31,,204,92
Situk Lower,2012,8,,205,100
Situk Lower,2012,18,,206,118
Situk Lower,2012,890,,207,1008
Situk Lower,2012,361,,208,1369
Situk Lower,2012,297,,209,1666
Situk Lower,2012,911,,210,2577
Situk Lower,2012,1744,,211,4321
Situk Lower,2012,1370,,212,5691
Situk Lower,2012,712,,213,6403
Situk Lower,2012,1887,,214,8290
Situk Lower,2012,7813,,215,16103
Situk Lower,2012,4168,,216,20271
Situk Lower,2012,6740,,217,27011
Situk Lower,2012,3546,,218,30557
Situk Lower,2012,1861,,219,32418
Situk Lower,2012,1211,Weir pulled after last count,220,33629
East Fork Andreafsky River,1994,8,,180,8
East Fork Andreafsky River,1994,451,,181,459
East Fork Andreafsky River,1994,409,,182,868
East Fork Andreafsky River,1994,194,,183,1062
East Fork Andreafsky River,1994,305,,184,1367
East Fork Andreafsky River,1994,780,,185,2147
East Fork Andreafsky River,1994,1027,,186,3174
East Fork Andreafsky River,1994,772,,187,3946
East Fork Andreafsky River,1994,4026,,188,7972
East Fork Andreafsky River,1994,1736,,189,9708
East Fork Andreafsky River,1994,4263,,190,13971
East Fork Andreafsky River,1994,4744,,191,18715
East Fork Andreafsky River,1994,3313,,192,22028
East Fork Andreafsky River,1994,8447,,193,30475
East Fork Andreafsky River,1994,13568,,194,44043
East Fork Andreafsky River,1994,24842,,195,68885
East Fork Andreafsky River,1994,22460,,196,91345
East Fork Andreafsky River,1994,20612,,197,111957
East Fork Andreafsky River,1994,27053,,198,139010
East Fork Andreafsky River,1994,18277,,199,157287
East Fork Andreafsky River,1994,20792,,200,178079
East Fork Andreafsky River,1994,23511,,201,201590
East Fork Andreafsky River,1994,10872,,202,212462
East Fork Andreafsky River,1994,8975,,203,221437
East Fork Andreafsky River,1994,17692,,204,239129
East Fork Andreafsky River,1994,15120,,205,254249
East Fork Andreafsky River,1994,3566,,206,257815
East Fork Andreafsky River,1994,10225,,207,268040
East Fork Andreafsky River,1994,13821,,208,281861
East Fork Andreafsky River,1994,15302,,209,297163
East Fork Andreafsky River,1994,9736,,210,306899
East Fork Andreafsky River,1994,6159,,211,313058
East Fork Andreafsky River,1994,2476,,212,315534
East Fork Andreafsky River,1994,996,,213,316530
East Fork Andreafsky River,1995,1,,178,1
East Fork Andreafsky River,1995,0,,179,1
East Fork Andreafsky River,1995,2,,180,3
East Fork Andreafsky River,1995,3,,181,6
East Fork Andreafsky River,1995,13,,182,19
East Fork Andreafsky River,1995,4,,183,23
East Fork Andreafsky River,1995,4,,184,27
East Fork Andreafsky River,1995,5,,185,32
East Fork Andreafsky River,1995,9,,186,41
East Fork Andreafsky River,1995,98,,187,139
East Fork Andreafsky River,1995,77,,188,216
East Fork Andreafsky River,1995,4,,189,220
East Fork Andreafsky River,1995,18,,190,238
East Fork Andreafsky River,1995,33,,191,271
East Fork Andreafsky River,1995,23,,192,294
East Fork Andreafsky River,1995,100,,193,394
East Fork Andreafsky River,1995,109,,194,503
East Fork Andreafsky River,1995,94,,195,597
East Fork Andreafsky River,1995,81,,196,678
East Fork Andreafsky River,1995,64,,197,742
East Fork Andreafsky River,1995,60,,198,802
East Fork Andreafsky River,1995,31,,199,833
East Fork Andreafsky River,1995,15,,200,848
East Fork Andreafsky River,1995,30,,201,878
East Fork Andreafsky River,1995,40,,202,918
East Fork Andreafsky River,1995,48,,203,966
East Fork Andreafsky River,1995,77,,204,1043
East Fork Andreafsky River,1995,25,,205,1068
East Fork Andreafsky River,1995,216,,206,1284
East Fork Andreafsky River,1995,88,,207,1372
East Fork Andreafsky River,1995,37,,208,1409
East Fork Andreafsky River,1995,20,,209,1429
East Fork Andreafsky River,1995,14,,210,1443
East Fork Andreafsky River,1995,29,,211,1472
East Fork Andreafsky River,1995,11,,212,1483
East Fork Andreafsky River,1995,22,,213,1505
East Fork Andreafsky River,1995,23,,214,1528
East Fork Andreafsky River,1995,44,,215,1572
East Fork Andreafsky River,1995,20,,216,1592
East Fork Andreafsky River,1995,17,,217,1609
East Fork Andreafsky River,1995,22,,218,1631
East Fork Andreafsky River,1995,37,,219,1668
East Fork Andreafsky River,1995,20,,220,1688
East Fork Andreafsky River,1995,29,,221,1717
East Fork Andreafsky River,1995,46,,222,1763
East Fork Andreafsky River,1995,18,,223,1781
East Fork Andreafsky River,1995,11,,224,1792
East Fork Andreafsky River,1995,12,,225,1804
East Fork Andreafsky River,1995,32,,226,1836
East Fork Andreafsky River,1995,20,,227,1856
East Fork Andreafsky River,1995,19,,228,1875
East Fork Andreafsky River,1995,17,,229,1892
East Fork Andreafsky River,1995,6,,230,1898
East Fork Andreafsky River,1995,7,,231,1905
East Fork Andreafsky River,1995,4,,232,1909
East Fork Andreafsky River,1995,7,,233,1916
East Fork Andreafsky River,1995,6,,234,1922
East Fork Andreafsky River,1995,4,,235,1926
East Fork Andreafsky River,1995,8,,236,1934
East Fork Andreafsky River,1995,3,,237,1937
East Fork Andreafsky River,1995,5,,238,1942
East Fork Andreafsky River,1995,9,,239,1951
East Fork Andreafsky River,1995,0,,240,1951
East Fork Andreafsky River,1995,7,,241,1958
East Fork Andreafsky River,1995,5,,242,1963
East Fork Andreafsky River,1995,0,,243,1963
East Fork Andreafsky River,1995,0,,244,1963
East Fork Andreafsky River,1995,2,,245,1965
East Fork Andreafsky River,1995,1,,246,1966
East Fork Andreafsky River,1995,0,,247,1966
East Fork Andreafsky River,1995,1,,248,1967
East Fork Andreafsky River,1995,1,,249,1968
East Fork Andreafsky River,1995,1,,250,1969
East Fork Andreafsky River,1995,1,,251,1970
East Fork Andreafsky River,1995,0,,252,1970
East Fork Andreafsky River,1995,1,,253,1971
East Fork Andreafsky River,1995,0,,254,1971
East Fork Andreafsky River,1995,1,,255,1972
East Fork Andreafsky River,1996,12,,171,12
East Fork Andreafsky River,1996,4,,172,16
East Fork Andreafsky River,1996,40,,173,56
East Fork Andreafsky River,1996,42,,174,98
East Fork Andreafsky River,1996,157,,175,255
East Fork Andreafsky River,1996,67,,176,322
East Fork Andreafsky River,1996,24,,177,346
East Fork Andreafsky River,1996,153,,178,499
East Fork Andreafsky River,1996,218,,179,717
East Fork Andreafsky River,1996,80,,180,797
East Fork Andreafsky River,1996,78,,181,875
East Fork Andreafsky River,1996,41,,182,916
East Fork Andreafsky River,1996,184,,183,1100
East Fork Andreafsky River,1996,107,,184,1207
East Fork Andreafsky River,1996,347,,185,1554
East Fork Andreafsky River,1996,1254,,186,2808
East Fork Andreafsky River,1996,6678,,187,9486
East Fork Andreafsky River,1996,4676,,188,14162
East Fork Andreafsky River,1996,3834,,189,17996
East Fork Andreafsky River,1996,7472,,190,25468
East Fork Andreafsky River,1996,8905,,191,34373
East Fork Andreafsky River,1996,10290,,192,44663
East Fork Andreafsky River,1996,5822,,193,50485
East Fork Andreafsky River,1996,4662,,194,55147
East Fork Andreafsky River,1996,9484,,195,64631
East Fork Andreafsky River,1996,11760,,196,76391
East Fork Andreafsky River,1996,9754,,197,86145
East Fork Andreafsky River,1996,13476,,198,99621
East Fork Andreafsky River,1996,12222,,199,111843
East Fork Andreafsky River,1996,12682,,200,124525
East Fork Andreafsky River,1996,14282,,201,138807
East Fork Andreafsky River,1996,17477,,202,156284
East Fork Andreafsky River,1996,18780,,203,175064
East Fork Andreafsky River,1996,13018,,204,188082
East Fork Andreafsky River,1996,4744,,205,192826
East Fork Andreafsky River,1996,3778,,206,196604
East Fork Andreafsky River,1996,2473,,207,199077
East Fork Andreafsky River,1996,3365,,208,202442
East Fork Andreafsky River,1996,3768,,209,206210
East Fork Andreafsky River,1996,5036,,210,211246
East Fork Andreafsky River,1996,1035,,211,212281
East Fork Andreafsky River,1996,205,,212,212486
East Fork Andreafsky River,1996,706,,213,213192
East Fork Andreafsky River,1996,169,,214,213361
East Fork Andreafsky River,1996,107,,215,213468
East Fork Andreafsky River,1996,127,,216,213595
East Fork Andreafsky River,1996,300,,217,213895
East Fork Andreafsky River,1996,237,,218,214132
East Fork Andreafsky River,1996,61,,219,214193
East Fork Andreafsky River,1996,109,,220,214302
East Fork Andreafsky River,1996,61,,221,214363
East Fork Andreafsky River,1996,55,,222,214418
East Fork Andreafsky River,1996,77,,223,214495
East Fork Andreafsky River,1996,44,,224,214539
East Fork Andreafsky River,1996,51,,225,214590
East Fork Andreafsky River,1996,25,,226,214615
East Fork Andreafsky River,1996,16,,227,214631
East Fork Andreafsky River,1996,7,,228,214638
East Fork Andreafsky River,1996,25,,229,214663
East Fork Andreafsky River,1996,8,,230,214671
East Fork Andreafsky River,1996,17,,231,214688
East Fork Andreafsky River,1996,40,,232,214728
East Fork Andreafsky River,1996,4,,233,214732
East Fork Andreafsky River,1996,2,,234,214734
East Fork Andreafsky River,1996,3,,235,214737
East Fork Andreafsky River,1996,8,,236,214745
East Fork Andreafsky River,1996,7,,237,214752
East Fork Andreafsky River,1996,16,,238,214768
East Fork Andreafsky River,1996,28,,239,214796
East Fork Andreafsky River,1996,1,,240,214797
East Fork Andreafsky River,1996,1,,241,214798
East Fork Andreafsky River,1996,1,,242,214799
East Fork Andreafsky River,1996,6,,243,214805
East Fork Andreafsky River,1996,4,,244,214809
East Fork Andreafsky River,1996,7,,245,214816
East Fork Andreafsky River,1996,4,,246,214820
East Fork Andreafsky River,1996,7,,247,214827
East Fork Andreafsky River,1996,1,,248,214828
East Fork Andreafsky River,1996,3,,249,214831
East Fork Andreafsky River,1996,0,,250,214831
East Fork Andreafsky River,1996,1,,251,214832
East Fork Andreafsky River,1996,0,,252,214832
East Fork Andreafsky River,1996,1,,253,214833
East Fork Andreafsky River,1996,0,,254,214833
East Fork Andreafsky River,1996,0,,255,214833
East Fork Andreafsky River,1996,0,,256,214833
East Fork Andreafsky River,1996,3,,257,214836
East Fork Andreafsky River,1996,0,,258,214836
East Fork Andreafsky River,1996,0,,259,214836
East Fork Andreafsky River,1996,1,,260,214837
East Fork Andreafsky River,1997,1,,178,1
East Fork Andreafsky River,1997,0,,179,1
East Fork Andreafsky River,1997,0,,180,1
East Fork Andreafsky River,1997,0,,181,1
East Fork Andreafsky River,1997,2,,182,3
East Fork Andreafsky River,1997,0,,183,3
East Fork Andreafsky River,1997,0,,184,3
East Fork Andreafsky River,1997,1,,185,4
East Fork Andreafsky River,1997,0,,186,4
East Fork Andreafsky River,1997,2,,187,6
East Fork Andreafsky River,1997,0,,188,6
East Fork Andreafsky River,1997,1,,189,7
East Fork Andreafsky River,1997,2,,190,9
East Fork Andreafsky River,1997,1,,191,10
East Fork Andreafsky River,1997,2,,192,12
East Fork Andreafsky River,1997,4,,193,16
East Fork Andreafsky River,1997,6,,194,22
East Fork Andreafsky River,1997,1,,195,23
East Fork Andreafsky River,1997,35,,196,58
East Fork Andreafsky River,1997,31,,197,89
East Fork Andreafsky River,1997,13,,198,102
East Fork Andreafsky River,1997,5,,199,107
East Fork Andreafsky River,1997,6,,200,113
East Fork Andreafsky River,1997,4,,201,117
East Fork Andreafsky River,1997,4,,202,121
East Fork Andreafsky River,1997,4,,203,125
East Fork Andreafsky River,1997,5,,204,130
East Fork Andreafsky River,1997,2,,205,132
East Fork Andreafsky River,1997,0,,206,132
East Fork Andreafsky River,1997,6,,207,138
East Fork Andreafsky River,1997,13,,208,151
East Fork Andreafsky River,1997,9,,209,160
East Fork Andreafsky River,1997,20,,210,180
East Fork Andreafsky River,1997,26,,211,206
East Fork Andreafsky River,1997,2,,212,208
East Fork Andreafsky River,1997,7,,213,215
East Fork Andreafsky River,1997,2,,214,217
East Fork Andreafsky River,1997,8,,215,225
East Fork Andreafsky River,1997,3,,216,228
East Fork Andreafsky River,1997,3,,217,231
East Fork Andreafsky River,1997,1,,218,232
East Fork Andreafsky River,1997,1,,219,233
East Fork Andreafsky River,1997,5,,220,238
East Fork Andreafsky River,1997,1,,221,239
East Fork Andreafsky River,1997,4,,222,243
East Fork Andreafsky River,1997,7,,223,250
East Fork Andreafsky River,1997,6,,224,256
East Fork Andreafsky River,1997,4,,225,260
East Fork Andreafsky River,1997,3,,226,263
East Fork Andreafsky River,1997,0,,227,263
East Fork Andreafsky River,1997,3,,228,266
East Fork Andreafsky River,1997,5,,229,271
East Fork Andreafsky River,1997,4,,230,275
East Fork Andreafsky River,1997,2,,231,277
East Fork Andreafsky River,1997,4,,232,281
East Fork Andreafsky River,1997,1,,233,282
East Fork Andreafsky River,1997,2,,234,284
East Fork Andreafsky River,1997,2,,235,286
East Fork Andreafsky River,1997,8,,236,294
East Fork Andreafsky River,1997,10,,237,304
East Fork Andreafsky River,1997,3,,238,307
East Fork Andreafsky River,1997,1,,239,308
East Fork Andreafsky River,1997,9,,240,317
East Fork Andreafsky River,1997,15,,241,332
East Fork Andreafsky River,1997,16,,242,348
East Fork Andreafsky River,1997,1,,243,349
East Fork Andreafsky River,1997,1,,244,350
East Fork Andreafsky River,1997,0,,245,350
East Fork Andreafsky River,1997,20,,246,370
East Fork Andreafsky River,1997,13,,247,383
East Fork Andreafsky River,1997,5,,248,388
East Fork Andreafsky River,1997,2,,249,390
East Fork Andreafsky River,1997,3,,250,393
East Fork Andreafsky River,1997,3,,251,396
East Fork Andreafsky River,1997,5,,252,401
East Fork Andreafsky River,1997,4,,253,405
East Fork Andreafsky River,1997,12,,254,417
East Fork Andreafsky River,1997,6,,255,423
East Fork Andreafsky River,1997,6,,256,429
East Fork Andreafsky River,1998,8,,176,8
East Fork Andreafsky River,1998,3,,177,11
East Fork Andreafsky River,1998,22,,178,33
East Fork Andreafsky River,1998,2,,179,35
East Fork Andreafsky River,1998,112,,180,147
East Fork Andreafsky River,1998,258,,181,405
East Fork Andreafsky River,1998,750,,182,1155
East Fork Andreafsky River,1998,65,,183,1220
East Fork Andreafsky River,1998,704,,184,1924
East Fork Andreafsky River,1998,1008,,185,2932
East Fork Andreafsky River,1998,3595,,186,6527
East Fork Andreafsky River,1998,4136,,187,10663
East Fork Andreafsky River,1998,4292,,188,14955
East Fork Andreafsky River,1998,2968,,189,17923
East Fork Andreafsky River,1998,1382,,190,19305
East Fork Andreafsky River,1998,1169,,191,20474
East Fork Andreafsky River,1998,9872,,192,30346
East Fork Andreafsky River,1998,21285,,193,51631
East Fork Andreafsky River,1998,11399,,194,63030
East Fork Andreafsky River,1998,5846,,195,68876
East Fork Andreafsky River,1998,21785,,196,90661
East Fork Andreafsky River,1998,11087,,197,101748
East Fork Andreafsky River,1998,23930,,198,125678
East Fork Andreafsky River,1998,31639,,199,157317
East Fork Andreafsky River,1998,27014,,200,184331
East Fork Andreafsky River,1998,7204,,201,191535
East Fork Andreafsky River,1998,4672,,202,196207
East Fork Andreafsky River,1998,2460,,203,198667
East Fork Andreafsky River,1998,3512,,204,202179
East Fork Andreafsky River,1998,7181,,205,209360
East Fork Andreafsky River,1998,5278,,206,214638
East Fork Andreafsky River,1998,3496,,207,218134
East Fork Andreafsky River,1998,1186,,208,219320
East Fork Andreafsky River,1998,1496,,209,220816
East Fork Andreafsky River,1998,1134,,210,221950
East Fork Andreafsky River,1998,982,,211,222932
East Fork Andreafsky River,1998,1315,,212,224247
East Fork Andreafsky River,1998,962,,213,225209
East Fork Andreafsky River,1998,474,,214,225683
East Fork Andreafsky River,1998,440,,215,226123
East Fork Andreafsky River,1998,303,,216,226426
East Fork Andreafsky River,1998,127,,217,226553
East Fork Andreafsky River,1998,73,,218,226626
East Fork Andreafsky River,1998,104,,219,226730
East Fork Andreafsky River,1998,140,,220,226870
East Fork Andreafsky River,1998,68,,221,226938
East Fork Andreafsky River,1998,36,,222,226974
East Fork Andreafsky River,1998,40,,223,227014
East Fork Andreafsky River,1998,43,,224,227057
East Fork Andreafsky River,1998,52,,225,227109
East Fork Andreafsky River,1998,40,,226,227149
East Fork Andreafsky River,1998,11,,227,227160
East Fork Andreafsky River,1998,18,,228,227178
East Fork Andreafsky River,1998,0,,229,227178
East Fork Andreafsky River,1998,0,,230,227178
East Fork Andreafsky River,1998,2,,231,227180
East Fork Andreafsky River,1998,0,,232,227180
East Fork Andreafsky River,1998,0,,233,227180
East Fork Andreafsky River,1998,0,,234,227180
East Fork Andreafsky River,1998,0,,235,227180
East Fork Andreafsky River,1998,0,,236,227180
East Fork Andreafsky River,1998,0,,237,227180
East Fork Andreafsky River,1998,0,,238,227180
East Fork Andreafsky River,1998,0,,239,227180
East Fork Andreafsky River,1998,0,,240,227180
East Fork Andreafsky River,1998,2,,241,227182
East Fork Andreafsky River,1998,1,,242,227183
East Fork Andreafsky River,1998,2,,243,227185
East Fork Andreafsky River,1998,2,,244,227187
East Fork Andreafsky River,1998,0,,245,227187
East Fork Andreafsky River,1998,4,,246,227191
East Fork Andreafsky River,1998,5,,247,227196
East Fork Andreafsky River,1998,0,,248,227196
East Fork Andreafsky River,1998,2,,249,227198
East Fork Andreafsky River,1998,3,,250,227201
East Fork Andreafsky River,1998,0,,251,227201
East Fork Andreafsky River,1998,2,,252,227203
East Fork Andreafsky River,1998,2,,253,227205
East Fork Andreafsky River,1998,1,,254,227206
East Fork Andreafsky River,1998,2,,255,227208
East Fork Andreafsky River,1998,0,,256,227208
East Fork Andreafsky River,1999,2,,187,2
East Fork Andreafsky River,1999,2,,188,4
East Fork Andreafsky River,1999,1,,189,5
East Fork Andreafsky River,1999,2,,190,7
East Fork Andreafsky River,1999,10,,191,17
East Fork Andreafsky River,1999,20,,192,37
East Fork Andreafsky River,1999,17,,193,54
East Fork Andreafsky River,1999,18,,194,72
East Fork Andreafsky River,1999,7,,195,79
East Fork Andreafsky River,1999,2,,196,81
East Fork Andreafsky River,1999,2,,197,83
East Fork Andreafsky River,1999,4,,198,87
East Fork Andreafsky River,1999,4,,199,91
East Fork Andreafsky River,1999,14,,200,105
East Fork Andreafsky River,1999,69,,201,174
East Fork Andreafsky River,1999,38,,202,212
East Fork Andreafsky River,1999,41,,203,253
East Fork Andreafsky River,1999,25,,204,278
East Fork Andreafsky River,1999,23,,205,301
East Fork Andreafsky River,1999,22,,206,323
East Fork Andreafsky River,1999,11,,207,334
East Fork Andreafsky River,1999,24,,208,358
East Fork Andreafsky River,1999,11,,209,369
East Fork Andreafsky River,1999,26,,210,395
East Fork Andreafsky River,1999,13,,211,408
East Fork Andreafsky River,1999,10,,212,418
East Fork Andreafsky River,1999,8,,213,426
East Fork Andreafsky River,1999,5,,214,431
East Fork Andreafsky River,1999,48,,215,479
East Fork Andreafsky River,1999,60,,216,539
East Fork Andreafsky River,1999,28,,217,567
East Fork Andreafsky River,1999,14,,218,581
East Fork Andreafsky River,1999,13,,219,594
East Fork Andreafsky River,1999,19,,220,613
East Fork Andreafsky River,1999,7,,221,620
East Fork Andreafsky River,1999,16,,222,636
East Fork Andreafsky River,1999,15,,223,651
East Fork Andreafsky River,1999,17,,224,668
East Fork Andreafsky River,1999,8,,225,676
East Fork Andreafsky River,1999,5,,226,681
East Fork Andreafsky River,1999,3,,227,684
East Fork Andreafsky River,1999,17,,228,701
East Fork Andreafsky River,1999,1,,229,702
East Fork Andreafsky River,1999,6,,230,708
East Fork Andreafsky River,1999,0,,231,708
East Fork Andreafsky River,1999,1,,232,709
East Fork Andreafsky River,1999,1,,233,710
East Fork Andreafsky River,1999,3,,234,713
East Fork Andreafsky River,1999,2,,235,715
East Fork Andreafsky River,1999,7,,236,722
East Fork Andreafsky River,1999,1,,237,723
East Fork Andreafsky River,1999,4,,238,727
East Fork Andreafsky River,1999,1,,239,728
East Fork Andreafsky River,1999,6,,240,734
East Fork Andreafsky River,1999,6,,241,740
East Fork Andreafsky River,1999,2,,242,742
East Fork Andreafsky River,1999,3,,243,745
East Fork Andreafsky River,1999,1,,244,746
East Fork Andreafsky River,1999,1,,245,747
East Fork Andreafsky River,1999,8,,246,755
East Fork Andreafsky River,1999,2,,247,757
East Fork Andreafsky River,1999,4,,248,761
East Fork Andreafsky River,1999,2,,249,763
East Fork Andreafsky River,1999,3,,250,766
East Fork Andreafsky River,1999,0,,251,766
East Fork Andreafsky River,1999,0,,252,766
East Fork Andreafsky River,1999,0,,253,766
East Fork Andreafsky River,1999,3,,254,769
East Fork Andreafsky River,2000,18,,182,18
East Fork Andreafsky River,2000,5,,183,23
East Fork Andreafsky River,2000,383,,184,406
East Fork Andreafsky River,2000,52,,185,458
East Fork Andreafsky River,2000,224,,186,682
East Fork Andreafsky River,2000,162,,187,844
East Fork Andreafsky River,2000,1228,,188,2072
East Fork Andreafsky River,2000,354,,189,2426
East Fork Andreafsky River,2000,972,,190,3398
East Fork Andreafsky River,2000,1680,,191,5078
East Fork Andreafsky River,2000,897,,192,5975
East Fork Andreafsky River,2000,7849,,193,13824
East Fork Andreafsky River,2000,2726,,194,16550
East Fork Andreafsky River,2000,7044,,195,23594
East Fork Andreafsky River,2000,1468,,196,25062
East Fork Andreafsky River,2000,966,,197,26028
East Fork Andreafsky River,2000,1206,,198,27234
East Fork Andreafsky River,2000,1446,,199,28680
East Fork Andreafsky River,2000,1686,,200,30366
East Fork Andreafsky River,2000,1926,,201,32292
East Fork Andreafsky River,2000,2170,,202,34462
East Fork Andreafsky River,2000,2549,,203,37011
East Fork Andreafsky River,2000,1143,,204,38154
East Fork Andreafsky River,2000,454,,205,38608
East Fork Andreafsky River,2000,609,,206,39217
East Fork Andreafsky River,2000,1055,,207,40272
East Fork Andreafsky River,2000,335,,208,40607
East Fork Andreafsky River,2000,731,,209,41338
East Fork Andreafsky River,2000,612,,210,41950
East Fork Andreafsky River,2000,415,,211,42365
East Fork Andreafsky River,2000,202,,212,42567
East Fork Andreafsky River,2000,244,,213,42811
East Fork Andreafsky River,2000,145,,214,42956
East Fork Andreafsky River,2000,129,,215,43085
East Fork Andreafsky River,2000,81,,216,43166
East Fork Andreafsky River,2000,65,,217,43231
East Fork Andreafsky River,2000,49,,218,43280
East Fork Andreafsky River,2000,33,,219,43313
East Fork Andreafsky River,2000,17,,220,43330
East Fork Andreafsky River,2000,17,,221,43347
East Fork Andreafsky River,2000,35,,222,43382
East Fork Andreafsky River,2000,15,,223,43397
East Fork Andreafsky River,2000,11,,224,43408
East Fork Andreafsky River,2000,8,,225,43416
East Fork Andreafsky River,2000,14,,226,43430
East Fork Andreafsky River,2000,11,,227,43441
East Fork Andreafsky River,2000,9,,228,43450
East Fork Andreafsky River,2000,2,,229,43452
East Fork Andreafsky River,2000,1,,230,43453
East Fork Andreafsky River,2000,1,,231,43454
East Fork Andreafsky River,2000,3,,232,43457
East Fork Andreafsky River,2000,3,,233,43460
East Fork Andreafsky River,2000,1,,234,43461
East Fork Andreafsky River,2000,2,,235,43463
East Fork Andreafsky River,2000,1,,236,43464
East Fork Andreafsky River,2000,4,,237,43468
East Fork Andreafsky River,2000,5,,238,43473
East Fork Andreafsky River,2000,0,,239,43473
East Fork Andreafsky River,2000,0,,240,43473
East Fork Andreafsky River,2000,2,,241,43475
East Fork Andreafsky River,2000,1,,242,43476
East Fork Andreafsky River,2000,9,,243,43485
East Fork Andreafsky River,2000,2,,244,43487
East Fork Andreafsky River,2000,1,,245,43488
East Fork Andreafsky River,2000,0,,246,43488
East Fork Andreafsky River,2000,0,,247,43488
East Fork Andreafsky River,2000,0,,248,43488
East Fork Andreafsky River,2000,0,,249,43488
East Fork Andreafsky River,2000,0,,250,43488
East Fork Andreafsky River,2000,0,,251,43488
East Fork Andreafsky River,2000,0,,252,43488
East Fork Andreafsky River,2000,0,,253,43488
East Fork Andreafsky River,2000,1,,254,43489
East Fork Andreafsky River,2000,0,,255,43489
East Fork Andreafsky River,2000,0,,256,43489
East Fork Andreafsky River,2000,0,,257,43489
East Fork Andreafsky River,2000,1,,258,43490
East Fork Andreafsky River,2000,1,,259,43491
East Fork Andreafsky River,2001,10,,227,10
East Fork Andreafsky River,2001,4,,228,14
East Fork Andreafsky River,2001,5,,229,19
East Fork Andreafsky River,2001,26,,230,45
East Fork Andreafsky River,2001,15,,231,60
East Fork Andreafsky River,2001,47,,232,107
East Fork Andreafsky River,2001,61,,233,168
East Fork Andreafsky River,2001,19,,234,187
East Fork Andreafsky River,2001,18,,235,205
East Fork Andreafsky River,2001,38,,236,243
East Fork Andreafsky River,2001,124,,237,367
East Fork Andreafsky River,2001,53,,238,420
East Fork Andreafsky River,2001,68,,239,488
East Fork Andreafsky River,2001,94,,240,582
East Fork Andreafsky River,2001,56,,241,638
East Fork Andreafsky River,2001,22,,242,660
East Fork Andreafsky River,2001,10,,243,670
East Fork Andreafsky River,2001,17,,244,687
East Fork Andreafsky River,2001,19,,245,706
East Fork Andreafsky River,2001,17,,246,723
East Fork Andreafsky River,2001,12,,247,735
East Fork Andreafsky River,2001,5,,248,740
East Fork Andreafsky River,2001,10,,249,750
East Fork Andreafsky River,2001,10,,250,760
East Fork Andreafsky River,2001,0,,251,760
East Fork Andreafsky River,2001,3,,252,763
East Fork Andreafsky River,2001,6,,253,769
East Fork Andreafsky River,2001,10,,254,779
East Fork Andreafsky River,2001,3,,255,782
East Fork Andreafsky River,2001,8,,256,790
East Fork Andreafsky River,2001,6,,257,796
East Fork Andreafsky River,2001,2,,258,798
East Fork Andreafsky River,2001,1,,259,799
East Fork Andreafsky River,2001,1,,260,800
East Fork Andreafsky River,2001,1,,261,801
East Fork Andreafsky River,2001,6,,262,807
East Fork Andreafsky River,2001,1,,263,808
East Fork Andreafsky River,2001,0,,264,808
East Fork Andreafsky River,2001,1,,265,809
East Fork Andreafsky River,2001,3,,266,812
East Fork Andreafsky River,2001,1,,267,813
East Fork Andreafsky River,2001,0,,268,813
East Fork Andreafsky River,2001,1,,269,814
East Fork Andreafsky River,2001,0,,270,814
East Fork Andreafsky River,2001,0,,271,814
East Fork Andreafsky River,2001,0,,272,814
East Fork Andreafsky River,2001,3,,273,817
East Fork Andreafsky River,2001,0,,274,817
East Fork Andreafsky River,2001,0,,275,817
East Fork Andreafsky River,2001,0,,276,817
East Fork Andreafsky River,2001,0,,277,817
East Fork Andreafsky River,2001,0,,278,817
East Fork Andreafsky River,2001,0,,279,817
East Fork Andreafsky River,2001,0,,280,817
East Fork Andreafsky River,2001,0,,281,817
East Fork Andreafsky River,2001,0,,282,817
East Fork Andreafsky River,2001,0,,283,817
East Fork Andreafsky River,2001,0,,284,817
East Fork Andreafsky River,2001,0,,285,817
East Fork Andreafsky River,2001,2,,286,819
East Fork Andreafsky River,2001,0,,287,819
East Fork Andreafsky River,2001,1,,288,820
East Fork Andreafsky River,2002,52,,172,52
East Fork Andreafsky River,2002,462,,173,514
East Fork Andreafsky River,2002,0,,174,514
East Fork Andreafsky River,2002,22,,175,536
East Fork Andreafsky River,2002,148,,176,684
East Fork Andreafsky River,2002,338,,177,1022
East Fork Andreafsky River,2002,431,,178,1453
East Fork Andreafsky River,2002,7808,,179,9261
East Fork Andreafsky River,2002,5076,,180,14337
East Fork Andreafsky River,2002,1509,,181,15846
East Fork Andreafsky River,2002,6192,,182,22038
East Fork Andreafsky River,2002,3345,,183,25383
East Fork Andreafsky River,2002,6876,,184,32259
East Fork Andreafsky River,2002,257,,185,32516
East Fork Andreafsky River,2002,1626,,186,34142
East Fork Andreafsky River,2002,13433,,187,47575
East Fork Andreafsky River,2002,10268,,188,57843
East Fork Andreafsky River,2002,4815,,189,62658
East Fork Andreafsky River,2002,8765,,190,71423
East Fork Andreafsky River,2002,12942,,191,84365
East Fork Andreafsky River,2002,10764,,192,95129
East Fork Andreafsky River,2002,9207,,193,104336
East Fork Andreafsky River,2002,9161,,194,113497
East Fork Andreafsky River,2002,7819,,195,121316
East Fork Andreafsky River,2002,6958,,196,128274
East Fork Andreafsky River,2002,8224,,197,136498
East Fork Andreafsky River,2002,6724,,198,143222
East Fork Andreafsky River,2002,8701,,199,151923
East Fork Andreafsky River,2002,6058,,200,157981
East Fork Andreafsky River,2002,1983,,201,159964
East Fork Andreafsky River,2002,1239,,202,161203
East Fork Andreafsky River,2002,564,,203,161767
East Fork Andreafsky River,2002,1060,,204,162827
East Fork Andreafsky River,2002,1092,,205,163919
East Fork Andreafsky River,2002,385,,206,164304
East Fork Andreafsky River,2002,429,,207,164733
East Fork Andreafsky River,2002,232,,208,164965
East Fork Andreafsky River,2002,305,,209,165270
East Fork Andreafsky River,2002,49,,210,165319
East Fork Andreafsky River,2002,62,,211,165381
East Fork Andreafsky River,2002,232,,212,165613
East Fork Andreafsky River,2002,131,,213,165744
East Fork Andreafsky River,2002,61,,214,165805
East Fork Andreafsky River,2002,73,,215,165878
East Fork Andreafsky River,2002,34,,216,165912
East Fork Andreafsky River,2002,11,,217,165923
East Fork Andreafsky River,2002,13,,218,165936
East Fork Andreafsky River,2002,7,,219,165943
East Fork Andreafsky River,2002,4,,220,165947
East Fork Andreafsky River,2002,5,,221,165952
East Fork Andreafsky River,2002,9,,222,165961
East Fork Andreafsky River,2002,2,,223,165963
East Fork Andreafsky River,2002,4,,224,165967
East Fork Andreafsky River,2002,1,,225,165968
East Fork Andreafsky River,2002,4,,226,165972
East Fork Andreafsky River,2002,1,,227,165973
East Fork Andreafsky River,2002,0,,228,165973
East Fork Andreafsky River,2002,1,,229,165974
East Fork Andreafsky River,2002,0,,230,165974
East Fork Andreafsky River,2002,0,,231,165974
East Fork Andreafsky River,2002,0,,232,165974
East Fork Andreafsky River,2002,1,,233,165975
East Fork Andreafsky River,2002,1,,234,165976
East Fork Andreafsky River,2002,2,,235,165978
East Fork Andreafsky River,2002,3,,236,165981
East Fork Andreafsky River,2002,1,,237,165982
East Fork Andreafsky River,2002,0,,238,165982
East Fork Andreafsky River,2002,0,,239,165982
East Fork Andreafsky River,2002,0,,240,165982
East Fork Andreafsky River,2002,0,,241,165982
East Fork Andreafsky River,2002,1,,242,165983
East Fork Andreafsky River,2002,0,,243,165983
East Fork Andreafsky River,2002,1,,244,165984
East Fork Andreafsky River,2002,1,,245,165985
East Fork Andreafsky River,2002,0,,246,165985
East Fork Andreafsky River,2002,0,,247,165985
East Fork Andreafsky River,2002,2,,248,165987
East Fork Andreafsky River,2002,0,,249,165987
East Fork Andreafsky River,2002,0,,250,165987
East Fork Andreafsky River,2002,0,,251,165987
East Fork Andreafsky River,2002,1,,252,165988
East Fork Andreafsky River,2002,0,,253,165988
East Fork Andreafsky River,2002,1,,254,165989
East Fork Andreafsky River,2002,2,,255,165991
East Fork Andreafsky River,2003,3,,176,3
East Fork Andreafsky River,2003,0,,177,3
East Fork Andreafsky River,2003,6,,178,9
East Fork Andreafsky River,2003,4,,179,13
East Fork Andreafsky River,2003,3,,180,16
East Fork Andreafsky River,2003,0,,181,16
East Fork Andreafsky River,2003,16,,182,32
East Fork Andreafsky River,2003,12,,183,44
East Fork Andreafsky River,2003,13,,184,57
East Fork Andreafsky River,2003,13,,185,70
East Fork Andreafsky River,2003,16,,186,86
East Fork Andreafsky River,2003,24,,187,110
East Fork Andreafsky River,2003,94,,188,204
East Fork Andreafsky River,2003,172,,189,376
East Fork Andreafsky River,2003,259,,190,635
East Fork Andreafsky River,2003,16,,191,651
East Fork Andreafsky River,2003,43,,192,694
East Fork Andreafsky River,2003,185,,193,879
East Fork Andreafsky River,2003,173,,194,1052
East Fork Andreafsky River,2003,189,,195,1241
East Fork Andreafsky River,2003,28,,196,1269
East Fork Andreafsky River,2003,13,,197,1282
East Fork Andreafsky River,2003,96,,198,1378
East Fork Andreafsky River,2003,702,,199,2080
East Fork Andreafsky River,2003,459,,200,2539
East Fork Andreafsky River,2003,288,,201,2827
East Fork Andreafsky River,2003,98,,202,2925
East Fork Andreafsky River,2003,18,,203,2943
East Fork Andreafsky River,2003,107,,204,3050
East Fork Andreafsky River,2003,107,,205,3157
East Fork Andreafsky River,2003,124,,206,3281
East Fork Andreafsky River,2003,43,,207,3324
East Fork Andreafsky River,2003,47,,208,3371
East Fork Andreafsky River,2003,130,,209,3501
East Fork Andreafsky River,2003,140,,210,3641
East Fork Andreafsky River,2003,29,,211,3670
East Fork Andreafsky River,2003,65,,212,3735
East Fork Andreafsky River,2003,69,,213,3804
East Fork Andreafsky River,2003,54,,214,3858
East Fork Andreafsky River,2003,33,,215,3891
East Fork Andreafsky River,2003,34,,216,3925
East Fork Andreafsky River,2003,35,,217,3960
East Fork Andreafsky River,2003,17,,218,3977
East Fork Andreafsky River,2003,20,,219,3997
East Fork Andreafsky River,2003,9,,220,4006
East Fork Andreafsky River,2003,8,,221,4014
East Fork Andreafsky River,2003,9,,222,4023
East Fork Andreafsky River,2003,6,,223,4029
East Fork Andreafsky River,2003,10,,224,4039
East Fork Andreafsky River,2003,14,,225,4053
East Fork Andreafsky River,2003,21,,226,4074
East Fork Andreafsky River,2003,16,,227,4090
East Fork Andreafsky River,2003,11,,228,4101
East Fork Andreafsky River,2003,6,,229,4107
East Fork Andreafsky River,2003,1,,230,4108
East Fork Andreafsky River,2003,14,,231,4122
East Fork Andreafsky River,2003,18,,232,4140
East Fork Andreafsky River,2003,10,,233,4150
East Fork Andreafsky River,2003,8,,234,4158
East Fork Andreafsky River,2003,12,,235,4170
East Fork Andreafsky River,2003,13,,236,4183
East Fork Andreafsky River,2003,10,,237,4193
East Fork Andreafsky River,2003,9,,238,4202
East Fork Andreafsky River,2003,2,,239,4204
East Fork Andreafsky River,2003,4,,240,4208
East Fork Andreafsky River,2003,3,,241,4211
East Fork Andreafsky River,2003,1,,242,4212
East Fork Andreafsky River,2003,0,,243,4212
East Fork Andreafsky River,2003,10,,244,4222
East Fork Andreafsky River,2003,2,,245,4224
East Fork Andreafsky River,2003,6,,246,4230
East Fork Andreafsky River,2003,8,,247,4238
East Fork Andreafsky River,2003,5,,248,4243
East Fork Andreafsky River,2003,4,,249,4247
East Fork Andreafsky River,2003,8,,250,4255
East Fork Andreafsky River,2003,12,,251,4267
East Fork Andreafsky River,2003,7,,252,4274
East Fork Andreafsky River,2003,5,,253,4279
East Fork Andreafsky River,2003,6,,254,4285
East Fork Andreafsky River,2003,4,,255,4289
East Fork Andreafsky River,2003,7,,256,4296
East Fork Andreafsky River,2003,3,,257,4299
East Fork Andreafsky River,2003,4,,258,4303
East Fork Andreafsky River,2004,19,,175,19
East Fork Andreafsky River,2004,15,,176,34
East Fork Andreafsky River,2004,24,,177,58
East Fork Andreafsky River,2004,102,,178,160
East Fork Andreafsky River,2004,189,,179,349
East Fork Andreafsky River,2004,341,,180,690
East Fork Andreafsky River,2004,374,,181,1064
East Fork Andreafsky River,2004,1671,,182,2735
East Fork Andreafsky River,2004,1049,,183,3784
East Fork Andreafsky River,2004,140,,184,3924
East Fork Andreafsky River,2004,1186,,185,5110
East Fork Andreafsky River,2004,2327,,186,7437
East Fork Andreafsky River,2004,5175,,187,12612
East Fork Andreafsky River,2004,4203,,188,16815
East Fork Andreafsky River,2004,17994,,189,34809
East Fork Andreafsky River,2004,13079,,190,47888
East Fork Andreafsky River,2004,16044,,191,63932
East Fork Andreafsky River,2004,22171,,192,86103
East Fork Andreafsky River,2004,15664,,193,101767
East Fork Andreafsky River,2004,15661,,194,117428
East Fork Andreafsky River,2004,15313,,195,132741
East Fork Andreafsky River,2004,25780,,196,158521
East Fork Andreafsky River,2004,16578,,197,175099
East Fork Andreafsky River,2004,22322,,198,197421
East Fork Andreafsky River,2004,16143,,199,213564
East Fork Andreafsky River,2004,14713,,200,228277
East Fork Andreafsky River,2004,15635,,201,243912
East Fork Andreafsky River,2004,28631,,202,272543
East Fork Andreafsky River,2004,19851,,203,292394
East Fork Andreafsky River,2004,12446,,204,304840
East Fork Andreafsky River,2004,9880,,205,314720
East Fork Andreafsky River,2004,9973,,206,324693
East Fork Andreafsky River,2004,12352,,207,337045
East Fork Andreafsky River,2004,12184,,208,349229
East Fork Andreafsky River,2004,10978,,209,360207
East Fork Andreafsky River,2004,9686,,210,369893
East Fork Andreafsky River,2004,7911,,211,377804
East Fork Andreafsky River,2004,5421,,212,383225
East Fork Andreafsky River,2004,4258,,213,387483
East Fork Andreafsky River,2004,2669,,214,390152
East Fork Andreafsky River,2004,2342,,215,392494
East Fork Andreafsky River,2004,1206,,216,393700
East Fork Andreafsky River,2004,843,,217,394543
East Fork Andreafsky River,2004,890,,218,395433
East Fork Andreafsky River,2004,729,,219,396162
East Fork Andreafsky River,2004,789,,220,396951
East Fork Andreafsky River,2004,513,,221,397464
East Fork Andreafsky River,2004,439,,222,397903
East Fork Andreafsky River,2004,384,,223,398287
East Fork Andreafsky River,2004,205,,224,398492
East Fork Andreafsky River,2004,152,,225,398644
East Fork Andreafsky River,2004,140,,226,398784
East Fork Andreafsky River,2004,128,,227,398912
East Fork Andreafsky River,2004,116,,228,399028
East Fork Andreafsky River,2004,104,,229,399132
East Fork Andreafsky River,2004,96,,230,399228
East Fork Andreafsky River,2004,34,,231,399262
East Fork Andreafsky River,2004,35,,232,399297
East Fork Andreafsky River,2004,17,,233,399314
East Fork Andreafsky River,2004,17,,234,399331
East Fork Andreafsky River,2004,7,,235,399338
East Fork Andreafsky River,2004,5,,236,399343
East Fork Andreafsky River,2004,6,,237,399349
East Fork Andreafsky River,2004,7,,238,399356
East Fork Andreafsky River,2004,12,,239,399368
East Fork Andreafsky River,2004,4,,240,399372
East Fork Andreafsky River,2004,4,,241,399376
East Fork Andreafsky River,2004,5,,242,399381
East Fork Andreafsky River,2004,11,,243,399392
East Fork Andreafsky River,2004,18,,244,399410
East Fork Andreafsky River,2004,13,,245,399423
East Fork Andreafsky River,2004,35,,246,399458
East Fork Andreafsky River,2004,6,,247,399464
East Fork Andreafsky River,2004,11,,248,399475
East Fork Andreafsky River,2004,34,,249,399509
East Fork Andreafsky River,2004,47,,250,399556
East Fork Andreafsky River,2004,30,,251,399586
East Fork Andreafsky River,2004,24,,252,399610
East Fork Andreafsky River,2004,22,,253,399632
East Fork Andreafsky River,2004,13,,254,399645
East Fork Andreafsky River,2004,6,,255,399651
East Fork Andreafsky River,2004,4,,256,399655
East Fork Andreafsky River,2004,1,,257,399656
East Fork Andreafsky River,2004,3,,258,399659
East Fork Andreafsky River,2004,3,,259,399662
East Fork Andreafsky River,2004,3,,260,399665
East Fork Andreafsky River,2004,2,,261,399667
East Fork Andreafsky River,2004,3,,262,399670
East Fork Andreafsky River,2004,0,,263,399670
East Fork Andreafsky River,2005,2,,178,2
East Fork Andreafsky River,2005,10,,179,12
East Fork Andreafsky River,2005,27,,180,39
East Fork Andreafsky River,2005,97,,181,136
East Fork Andreafsky River,2005,15,,182,151
East Fork Andreafsky River,2005,89,,183,240
East Fork Andreafsky River,2005,453,,184,693
East Fork Andreafsky River,2005,652,,185,1345
East Fork Andreafsky River,2005,985,,186,2330
East Fork Andreafsky River,2005,2334,,187,4664
East Fork Andreafsky River,2005,3071,,188,7735
East Fork Andreafsky River,2005,2443,,189,10178
East Fork Andreafsky River,2005,1692,,190,11870
East Fork Andreafsky River,2005,1266,,191,13136
East Fork Andreafsky River,2005,1453,,192,14589
East Fork Andreafsky River,2005,385,,193,14974
East Fork Andreafsky River,2005,2865,,194,17839
East Fork Andreafsky River,2005,5106,,195,22945
East Fork Andreafsky River,2005,2489,,196,25434
East Fork Andreafsky River,2005,1992,,197,27426
East Fork Andreafsky River,2005,678,,198,28104
East Fork Andreafsky River,2005,945,,199,29049
East Fork Andreafsky River,2005,450,,200,29499
East Fork Andreafsky River,2005,1140,,201,30639
East Fork Andreafsky River,2005,1852,,202,32491
East Fork Andreafsky River,2005,814,,203,33305
East Fork Andreafsky River,2005,723,,204,34028
East Fork Andreafsky River,2005,256,,205,34284
East Fork Andreafsky River,2005,158,,206,34442
East Fork Andreafsky River,2005,425,,207,34867
East Fork Andreafsky River,2005,307,,208,35174
East Fork Andreafsky River,2005,889,,209,36063
East Fork Andreafsky River,2005,744,,210,36807
East Fork Andreafsky River,2005,687,,211,37494
East Fork Andreafsky River,2005,341,,212,37835
East Fork Andreafsky River,2005,430,,213,38265
East Fork Andreafsky River,2005,140,,214,38405
East Fork Andreafsky River,2005,79,,215,38484
East Fork Andreafsky River,2005,55,,216,38539
East Fork Andreafsky River,2005,91,,217,38630
East Fork Andreafsky River,2005,114,,218,38744
East Fork Andreafsky River,2005,41,,219,38785
East Fork Andreafsky River,2005,68,,220,38853
East Fork Andreafsky River,2005,39,,221,38892
East Fork Andreafsky River,2005,17,,222,38909
East Fork Andreafsky River,2005,23,,223,38932
East Fork Andreafsky River,2005,10,,224,38942
East Fork Andreafsky River,2005,3,,225,38945
East Fork Andreafsky River,2005,11,,226,38956
East Fork Andreafsky River,2005,10,,227,38966
East Fork Andreafsky River,2005,12,,228,38978
East Fork Andreafsky River,2005,5,,229,38983
East Fork Andreafsky River,2005,3,,230,38986
East Fork Andreafsky River,2005,1,,231,38987
East Fork Andreafsky River,2005,0,,232,38987
East Fork Andreafsky River,2005,3,,233,38990
East Fork Andreafsky River,2005,0,,234,38990
East Fork Andreafsky River,2005,0,,235,38990
East Fork Andreafsky River,2005,2,,236,38992
East Fork Andreafsky River,2005,2,,237,38994
East Fork Andreafsky River,2005,1,,238,38995
East Fork Andreafsky River,2005,2,,239,38997
East Fork Andreafsky River,2005,7,,240,39004
East Fork Andreafsky River,2005,3,,241,39007
East Fork Andreafsky River,2005,1,,242,39008
East Fork Andreafsky River,2005,2,,243,39010
East Fork Andreafsky River,2005,3,,244,39013
East Fork Andreafsky River,2005,2,,245,39015
East Fork Andreafsky River,2005,1,,246,39016
East Fork Andreafsky River,2005,0,,247,39016
East Fork Andreafsky River,2005,2,,248,39018
East Fork Andreafsky River,2005,0,,249,39018
East Fork Andreafsky River,2005,1,,250,39019
East Fork Andreafsky River,2005,0,,251,39019
East Fork Andreafsky River,2005,2,,252,39021
East Fork Andreafsky River,2005,3,,253,39024
East Fork Andreafsky River,2005,6,,254,39030
East Fork Andreafsky River,2006,43,,179,43
East Fork Andreafsky River,2006,54,,180,97
East Fork Andreafsky River,2006,314,,181,411
East Fork Andreafsky River,2006,281,,182,692
East Fork Andreafsky River,2006,134,,183,826
East Fork Andreafsky River,2006,326,,184,1152
East Fork Andreafsky River,2006,1431,,185,2583
East Fork Andreafsky River,2006,1325,,186,3908
East Fork Andreafsky River,2006,3092,,187,7000
East Fork Andreafsky River,2006,8096,,188,15096
East Fork Andreafsky River,2006,13219,,189,28315
East Fork Andreafsky River,2006,7941,,190,36256
East Fork Andreafsky River,2006,11605,,191,47861
East Fork Andreafsky River,2006,13327,,192,61188
East Fork Andreafsky River,2006,14844,,193,76032
East Fork Andreafsky River,2006,7204,,194,83236
East Fork Andreafsky River,2006,1117,,195,84353
East Fork Andreafsky River,2006,2858,,196,87211
East Fork Andreafsky River,2006,2816,,197,90027
East Fork Andreafsky River,2006,8969,,198,98996
East Fork Andreafsky River,2006,17205,,199,116201
East Fork Andreafsky River,2006,18690,,200,134891
East Fork Andreafsky River,2006,18357,,201,153248
East Fork Andreafsky River,2006,13319,,202,166567
East Fork Andreafsky River,2006,16186,,203,182753
East Fork Andreafsky River,2006,11435,,204,194188
East Fork Andreafsky River,2006,9612,,205,203800
East Fork Andreafsky River,2006,6890,,206,210690
East Fork Andreafsky River,2006,4746,,207,215436
East Fork Andreafsky River,2006,5299,,208,220735
Buskin River,1985,5,,182,5
Buskin River,1985,0,,183,5
Buskin River,1985,1,,184,6
Buskin River,1985,1,,185,7
Buskin River,1985,0,,186,7
Buskin River,1985,3,,187,10
Buskin River,1985,12,,188,22
Buskin River,1985,7,,189,29
Buskin River,1985,5,,190,34
Buskin River,1985,0,,191,34
Buskin River,1985,7,,192,41
Buskin River,1985,2,,193,43
Buskin River,1985,3,,194,46
Buskin River,1985,2,,195,48
Buskin River,1985,38,,196,86
Buskin River,1985,11,,197,97
Buskin River,1985,18,,198,115
Buskin River,1985,150,,199,265
Buskin River,1985,810,,200,1075
Buskin River,1985,810,,201,1885
Buskin River,1985,811,,202,2696
Buskin River,1985,811,,203,3507
Buskin River,1985,834,,204,4341
Buskin River,1985,1918,,205,6259
Buskin River,1985,825,,206,7084
Buskin River,1985,1507,,207,8591
Buskin River,1985,2803,,208,11394
Buskin River,1985,2393,,209,13787
Buskin River,1985,3863,,210,17650
Buskin River,1985,4466,,211,22116
Buskin River,1985,2247,,212,24363
Buskin River,1985,854,,213,25217
Buskin River,1985,4979,,214,30196
Buskin River,1985,12408,,215,42604
Buskin River,1985,11414,,216,54018
Buskin River,1985,10505,,217,64523
Buskin River,1985,11021,,218,75544
Buskin River,1985,7630,,219,83174
Buskin River,1985,5392,,220,88566
Buskin River,1985,8448,,221,97014
Buskin River,1985,9255,,222,106269
Buskin River,1985,4349,,223,110618
Buskin River,1985,5838,,224,116456
Buskin River,1985,3619,,225,120075
Buskin River,1985,2883,,226,122958
Buskin River,1985,2945,,227,125903
Buskin River,1985,1311,,228,127214
Buskin River,1985,908,,229,128122
Buskin River,1985,810,,230,128932
Buskin River,1985,819,,231,129751
Buskin River,1985,239,,232,129990
Buskin River,1985,534,,233,130524
Buskin River,1985,2069,,234,132593
Buskin River,1985,426,,235,133019
Buskin River,1985,266,,236,133285
Buskin River,1985,385,,237,133670
Buskin River,1985,546,,238,134216
Buskin River,1985,658,,239,134874
Buskin River,1985,778,,240,135652
Buskin River,1985,1124,,241,136776
Buskin River,1985,2585,,242,139361
Buskin River,1985,1515,,243,140876
Buskin River,1985,945,,244,141821
Buskin River,1985,888,,245,142709
Buskin River,1985,2020,,246,144729
Buskin River,1985,1096,,247,145825
Buskin River,1985,881,,248,146706
Buskin River,1985,700,,249,147406
Buskin River,1985,1030,,250,148436
Buskin River,1985,975,,251,149411
Buskin River,1985,342,,252,149753
Buskin River,1985,547,,253,150300
Buskin River,1985,224,,254,150524
Buskin River,1985,420,,255,150944
Buskin River,1985,366,,256,151310
Buskin River,1985,489,,257,151799
Buskin River,1985,171,,258,151970
Buskin River,1985,141,,259,152111
Buskin River,1985,187,,260,152298
Buskin River,1985,238,,261,152536
Buskin River,1985,33,,262,152569
Buskin River,1985,18,,263,152587
Buskin River,1985,56,,264,152643
Buskin River,1985,310,,265,152953
Buskin River,1985,7,,266,152960
Buskin River,1985,40,,267,153000
Buskin River,1985,0,,268,153000
Buskin River,1985,24,,269,153024
Buskin River,1985,2,,270,153026
Buskin River,1985,0,,271,153026
Buskin River,1985,0,,272,153026
Buskin River,1985,0,,273,153026
Buskin River,1985,0,,274,153026
Buskin River,1986,1,,190,1
Buskin River,1986,5,,191,6
Buskin River,1986,17,,192,23
Buskin River,1986,12,,193,35
Buskin River,1986,11,,194,46
Buskin River,1986,70,,195,116
Buskin River,1986,11,,196,127
Buskin River,1986,13,,197,140
Buskin River,1986,60,,198,200
Buskin River,1986,74,,199,274
Buskin River,1986,154,,200,428
Buskin River,1986,314,,201,742
Buskin River,1986,204,,202,946
Buskin River,1986,228,,203,1174
Buskin River,1986,331,,204,1505
Buskin River,1986,107,,205,1612
Buskin River,1986,359,,206,1971
Buskin River,1986,331,,207,2302
Buskin River,1986,286,,208,2588
Buskin River,1986,942,,209,3530
Buskin River,1986,629,,210,4159
Buskin River,1986,1063,,211,5222
Buskin River,1986,1457,,212,6679
Buskin River,1986,897,,213,7576
Buskin River,1986,1676,,214,9252
Buskin River,1986,5406,,215,14658
Buskin River,1986,3312,,216,17970
Buskin River,1986,4266,,217,22236
Buskin River,1986,3576,,218,25812
Buskin River,1986,3745,,219,29557
Buskin River,1986,3946,,220,33503
Buskin River,1986,4148,,221,37651
Buskin River,1986,2833,,222,40484
Buskin River,1986,8024,,223,48508
Buskin River,1986,5063,,224,53571
Buskin River,1986,2743,,225,56314
Buskin River,1986,1575,,226,57889
Buskin River,1986,3008,,227,60897
Buskin River,1986,1027,,228,61924
Buskin River,1986,781,,229,62705
Buskin River,1986,2488,,230,65193
Buskin River,1986,537,,231,65730
Buskin River,1986,180,,232,65910
Buskin River,1986,225,,233,66135
Buskin River,1986,577,,234,66712
Buskin River,1986,1065,,235,67777
Buskin River,1986,565,,236,68342
Buskin River,1986,2073,,237,70415
Buskin River,1986,6104,,238,76519
Buskin River,1986,4191,,239,80710
Buskin River,1986,1058,,240,81768
Buskin River,1986,530,,241,82298
Buskin River,1986,1357,,242,83655
Buskin River,1986,1565,,243,85220
Buskin River,1986,874,,244,86094
Buskin River,1986,968,,245,87062
Buskin River,1986,770,,246,87832
Buskin River,1986,427,,247,88259
Buskin River,1986,1298,,248,89557
Buskin River,1986,1860,,249,91417
Buskin River,1986,3463,,250,94880
Buskin River,1986,221,,251,95101
Buskin River,1986,150,,252,95251
Buskin River,1986,209,,253,95460
Buskin River,1986,585,,254,96045
Buskin River,1986,680,,255,96725
Buskin River,1986,716,,256,97441
Buskin River,1986,456,,257,97897
Buskin River,1986,345,,258,98242
Buskin River,1986,209,,259,98451
Buskin River,1986,132,,260,98583
Buskin River,1986,94,,261,98677
Buskin River,1986,75,,262,98752
Buskin River,1986,87,,263,98839
Buskin River,1986,29,,264,98868
Buskin River,1986,21,,265,98889
Buskin River,1986,4,,266,98893
Buskin River,1986,2,,267,98895
Buskin River,1986,2,,268,98897
Buskin River,1986,34,,269,98931
Buskin River,1986,14,,270,98945
Buskin River,1986,2,,271,98947
Buskin River,1986,2,,272,98949
Buskin River,1986,0,,273,98949
Buskin River,1986,9,,274,98958
Buskin River,1987,1,,183,1
Buskin River,1987,2,,184,3
Buskin River,1987,1,,185,4
Buskin River,1987,0,,186,4
Buskin River,1987,0,,187,4
Buskin River,1987,1,,188,5
Buskin River,1987,0,,189,5
Buskin River,1987,4,,190,9
Buskin River,1987,0,,191,9
Buskin River,1987,2,,192,11
Buskin River,1987,2,,193,13
Buskin River,1987,3,,194,16
Buskin River,1987,2,,195,18
Buskin River,1987,13,,196,31
Buskin River,1987,6,,197,37
Buskin River,1987,17,,198,54
Buskin River,1987,6,,199,60
Buskin River,1987,7,,200,67
Buskin River,1987,41,,201,108
Buskin River,1987,35,,202,143
Buskin River,1987,104,,203,247
Buskin River,1987,30,,204,277
Buskin River,1987,46,,205,323
Buskin River,1987,154,,206,477
Buskin River,1987,127,,207,604
Buskin River,1987,159,,208,763
Buskin River,1987,178,,209,941
Buskin River,1987,346,,210,1287
Buskin River,1987,727,,211,2014
Buskin River,1987,1244,,212,3258
Buskin River,1987,1494,,213,4752
Buskin River,1987,864,,214,5616
Buskin River,1987,1378,,215,6994
Buskin River,1987,1117,,216,8111
Buskin River,1987,926,,217,9037
Buskin River,1987,781,,218,9818
Buskin River,1987,928,,219,10746
Buskin River,1987,693,,220,11439
Buskin River,1987,771,,221,12210
Buskin River,1987,661,,222,12871
Buskin River,1987,2135,,223,15006
Buskin River,1987,1208,,224,16214
Buskin River,1987,731,,225,16945
Buskin River,1987,394,,226,17339
Buskin River,1987,214,,227,17553
Buskin River,1987,251,,228,17804
Buskin River,1987,261,,229,18065
Buskin River,1987,229,,230,18294
Buskin River,1987,346,,231,18640
Buskin River,1987,481,,232,19121
Buskin River,1987,409,,233,19530
Buskin River,1987,405,,234,19935
Buskin River,1987,360,,235,20295
Buskin River,1987,856,,236,21151
Buskin River,1987,497,,237,21648
Buskin River,1987,602,,238,22250
Buskin River,1987,199,,239,22449
Buskin River,1987,214,,240,22663
Buskin River,1987,433,,241,23096
Buskin River,1987,402,,242,23498
Buskin River,1987,230,,243,23728
Buskin River,1987,439,,244,24167
Buskin River,1987,554,,245,24721
Buskin River,1987,331,,246,25052
Buskin River,1987,333,,247,25385
Buskin River,1987,273,,248,25658
Buskin River,1987,933,,249,26591
Buskin River,1987,722,,250,27313
Buskin River,1987,0,,251,27313
Buskin River,1987,306,,252,27619
Buskin River,1987,110,,253,27729
Buskin River,1987,23,,254,27752
Buskin River,1987,5,,255,27757
Buskin River,1987,21,,256,27778
Buskin River,1987,3,,257,27781
Buskin River,1987,34,,258,27815
Buskin River,1987,57,,259,27872
Buskin River,1987,12,,260,27884
Buskin River,1987,5,,261,27889
Buskin River,1987,3,,262,27892
Buskin River,1987,0,,263,27892
Buskin River,1988,1,,183,1
Buskin River,1988,0,,184,1
Buskin River,1988,0,,185,1
Buskin River,1988,1,,186,2
Buskin River,1988,0,,187,2
Buskin River,1988,2,,188,4
Buskin River,1988,0,,189,4
Buskin River,1988,0,,190,4
Buskin River,1988,1,,191,5
Buskin River,1988,4,,192,9
Buskin River,1988,3,,193,12
Buskin River,1988,3,,194,15
Buskin River,1988,16,,195,31
Buskin River,1988,2,,196,33
Buskin River,1988,19,,197,52
Buskin River,1988,16,,198,68
Buskin River,1988,29,,199,97
Buskin River,1988,3,,200,100
Buskin River,1988,68,,201,168
Buskin River,1988,47,,202,215
Buskin River,1988,100,,203,315
Buskin River,1988,247,,204,562
Buskin River,1988,233,,205,795
Buskin River,1988,315,,206,1110
Buskin River,1988,644,,207,1754
Buskin River,1988,785,,208,2539
Buskin River,1988,955,,209,3494
Buskin River,1988,1189,,210,4683
Buskin River,1988,3459,,211,8142
Buskin River,1988,3344,,212,11486
Buskin River,1988,5956,,213,17442
Buskin River,1988,6190,,214,23632
Buskin River,1988,11061,,215,34693
Buskin River,1988,11938,,216,46631
Buskin River,1988,15513,,217,62144
Buskin River,1988,10183,,218,72327
Buskin River,1988,10741,,219,83068
Buskin River,1988,20936,,220,104004
Buskin River,1988,9330,,221,113334
Buskin River,1988,16595,,222,129929
Buskin River,1988,13714,,223,143643
Buskin River,1988,7981,,224,151624
Buskin River,1988,5825,,225,157449
Buskin River,1988,4553,,226,162002
Buskin River,1988,3857,,227,165859
Buskin River,1988,3074,,228,168933
Buskin River,1988,4472,,229,173405
Buskin River,1988,9132,,230,182537
Buskin River,1988,2271,,231,184808
Buskin River,1988,977,,232,185785
Buskin River,1988,2311,,233,188096
Buskin River,1988,2870,,234,190966
Buskin River,1988,491,,235,191457
Buskin River,1988,776,,236,192233
Buskin River,1988,713,,237,192946
Buskin River,1988,1172,,238,194118
Buskin River,1988,5392,,239,199510
Buskin River,1988,589,,240,200099
Buskin River,1988,500,,241,200599
Buskin River,1988,700,,242,201299
Buskin River,1988,600,,243,201899
Buskin River,1988,567,,244,202466
Buskin River,1988,464,,245,202930
Buskin River,1988,0,,246,202930
Buskin River,1988,0,,247,202930
Buskin River,1988,0,,248,202930
Buskin River,1988,0,,249,202930
Buskin River,1988,79,,250,203009
Buskin River,1988,569,,251,203578
Buskin River,1988,0,,252,203578
Buskin River,1989,0,,182,0
Buskin River,1989,3,,183,3
Buskin River,1989,3,,184,6
Buskin River,1989,4,,185,10
Buskin River,1989,3,,186,13
Buskin River,1989,0,,187,13
Buskin River,1989,23,,188,36
Buskin River,1989,9,,189,45
Buskin River,1989,31,,190,76
Buskin River,1989,19,,191,95
Buskin River,1989,0,,192,95
Buskin River,1989,18,,193,113
Buskin River,1989,14,,194,127
Buskin River,1989,2,,195,129
Buskin River,1989,10,,196,139
Buskin River,1989,62,,197,201
Buskin River,1989,91,,198,292
Buskin River,1989,110,,199,402
Buskin River,1989,106,,200,508
Buskin River,1989,92,,201,600
Buskin River,1989,284,,202,884
Buskin River,1989,157,,203,1041
Buskin River,1989,342,,204,1383
Buskin River,1989,650,,205,2033
Buskin River,1989,615,,206,2648
Buskin River,1989,1967,,207,4615
Buskin River,1989,1639,,208,6254
Buskin River,1989,2896,,209,9150
Buskin River,1989,4019,,210,13169
Buskin River,1989,3387,,211,16556
Buskin River,1989,2790,,212,19346
Buskin River,1989,5000,,213,24346
Buskin River,1989,3430,,214,27776
Buskin River,1989,6797,,215,34573
Buskin River,1989,4530,,216,39103
Buskin River,1989,7280,,217,46383
Buskin River,1989,9465,,218,55848
Buskin River,1989,9280,,219,65128
Buskin River,1989,8295,,220,73423
Buskin River,1989,8860,,221,82283
Buskin River,1989,7246,,222,89529
Buskin River,1989,2204,,223,91733
Buskin River,1989,4251,,224,95984
Buskin River,1989,0,,225,95984
Buskin River,1989,6296,,226,102280
Buskin River,1989,3332,,227,105612
Buskin River,1989,5613,,228,111225
Buskin River,1989,2895,,229,114120
Buskin River,1989,12056,,230,126176
Buskin River,1989,6374,,231,132550
Buskin River,1989,2150,,232,134700
Buskin River,1989,1400,,233,136100
Buskin River,1989,1135,,234,137235
Buskin River,1989,904,,235,138139
Buskin River,1989,1454,,236,139593
Buskin River,1989,4365,,237,143958
Buskin River,1989,3089,,238,147047
Buskin River,1989,825,,239,147872
Buskin River,1989,562,,240,148434
Buskin River,1989,565,,241,148999
Buskin River,1989,969,,242,149968
Buskin River,1989,1303,,243,151271
Buskin River,1989,2124,,244,153395
Buskin River,1989,1883,,245,155278
Buskin River,1989,295,,246,155573
Buskin River,1989,100,,247,155673
Buskin River,1989,290,,248,155963
Buskin River,1989,352,,249,156315
Buskin River,1989,700,,250,157015
Buskin River,1989,398,,251,157413
Buskin River,1989,807,,252,158220
Buskin River,1989,115,,253,158335
Buskin River,1989,241,,254,158576
Buskin River,1989,155,,255,158731
Buskin River,1989,88,,256,158819
Buskin River,1989,52,,257,158871
Buskin River,1989,38,,258,158909
Buskin River,1989,34,,259,158943
Buskin River,1989,80,,260,159023
Buskin River,1989,57,,261,159080
Buskin River,1989,30,,262,159110
Buskin River,1989,5,,263,159115
Buskin River,1989,0,,264,159115
Buskin River,1989,4,,265,159119
Buskin River,1989,1,,266,159120
Buskin River,1989,1,,267,159121
Buskin River,1989,0,,268,159121
Buskin River,1989,1,,269,159122
Buskin River,1989,0,,270,159122
Buskin River,1989,1,,271,159123
Buskin River,1989,0,,272,159123
Buskin River,1990,1,,195,1
Buskin River,1990,0,,196,1
Buskin River,1990,0,,197,1
Buskin River,1990,0,,198,1
Buskin River,1990,1,,199,2
Buskin River,1990,4,,200,6
Buskin River,1990,38,,201,44
Buskin River,1990,492,,202,536
Buskin River,1990,69,,203,605
Buskin River,1990,21,,204,626
Buskin River,1990,52,,205,678
Buskin River,1990,65,,206,743
Buskin River,1990,8,,207,751
Buskin River,1990,145,,208,896
Buskin River,1990,937,,209,1833
Buskin River,1990,758,,210,2591
Buskin River,1990,729,,211,3320
Buskin River,1990,297,,212,3617
Buskin River,1990,731,,213,4348
Buskin River,1990,1422,,214,5770
Buskin River,1990,1422,,215,7192
Buskin River,1990,1422,,216,8614
Buskin River,1990,1422,,217,10036
Buskin River,1990,1422,,218,11458
Buskin River,1990,1422,,219,12880
Buskin River,1990,1422,,220,14302
Buskin River,1990,1422,,221,15724
Buskin River,1990,1422,,222,17146
Buskin River,1990,1422,,223,18568
Buskin River,1990,1422,,224,19990
Buskin River,1990,1422,,225,21412
Buskin River,1990,1422,,226,22834
Buskin River,1990,1422,,227,24256
Buskin River,1990,1652,,228,25908
Buskin River,1990,551,,229,26459
Buskin River,1990,1151,,230,27610
Buskin River,1990,1102,,231,28712
Buskin River,1990,482,,232,29194
Buskin River,1990,194,,233,29388
Buskin River,1990,518,,234,29906
Buskin River,1990,190,,235,30096
Buskin River,1990,326,,236,30422
Buskin River,1990,1001,,237,31423
Buskin River,1990,538,,238,31961
Buskin River,1990,1098,,239,33059
Buskin River,1990,842,,240,33901
Buskin River,1990,791,,241,34692
Buskin River,1990,141,,242,34833
Buskin River,1990,376,,243,35209
Buskin River,1990,367,,244,35576
Buskin River,1990,521,,245,36097
Buskin River,1990,2653,,246,38750
Buskin River,1990,638,,247,39388
Buskin River,1990,377,,248,39765
Buskin River,1990,226,,249,39991
Buskin River,1990,147,,250,40138
Buskin River,1990,832,,251,40970
Buskin River,1990,441,,252,41411
Buskin River,1990,35,,253,41446
Buskin River,1990,599,,254,42045
Buskin River,1990,360,,255,42405
Buskin River,1990,239,,256,42644
Buskin River,1990,124,,257,42768
Buskin River,1990,84,,258,42852
Buskin River,1990,0,,259,42852
Buskin River,1990,0,,260,42852
Buskin River,1990,0,,261,42852
Buskin River,1990,0,,262,42852
Buskin River,1990,0,,263,42852
Buskin River,1990,0,,264,42852
Buskin River,1990,0,,265,42852
Buskin River,1990,11,,266,42863
Buskin River,1990,15,,267,42878
Buskin River,1990,7,,268,42885
Buskin River,1990,4,,269,42889
Nushagak River (Portage Creek),1987,58,,216,58
Nushagak River (Portage Creek),1987,178,,217,236
Nushagak River (Portage Creek),1987,240,,218,476
Nushagak River (Portage Creek),1987,80,,219,556
Nushagak River (Portage Creek),1987,30,,220,586
Nushagak River (Portage Creek),1987,14,,221,600
Nushagak River (Portage Creek),1987,15,,222,615
Nushagak River (Portage Creek),1987,10,,223,625
Nushagak River (Portage Creek),1987,4,,224,629
Nushagak River (Portage Creek),1987,3,,225,632
Nushagak River (Portage Creek),1987,7,,226,639
Nushagak River (Portage Creek),1987,11,,227,650
Nushagak River (Portage Creek),1987,12,,228,662
Nushagak River (Portage Creek),1987,9,,229,671
Nushagak River (Portage Creek),1988,227,,191,227
Nushagak River (Portage Creek),1988,134,,192,361
Nushagak River (Portage Creek),1988,191,,193,552
Nushagak River (Portage Creek),1988,0,,194,552
Nushagak River (Portage Creek),1988,0,,195,552
Nushagak River (Portage Creek),1988,304,,196,856
Nushagak River (Portage Creek),1988,107,,197,963
Nushagak River (Portage Creek),1988,113,,198,1076
Nushagak River (Portage Creek),1988,275,,199,1351
Nushagak River (Portage Creek),1988,331,,200,1682
Nushagak River (Portage Creek),1988,140,,201,1822
Nushagak River (Portage Creek),1988,279,,202,2101
Nushagak River (Portage Creek),1988,451,,203,2552
Nushagak River (Portage Creek),1988,432,,204,2984
Nushagak River (Portage Creek),1988,4209,,205,7193
Nushagak River (Portage Creek),1988,6170,,206,13363
Nushagak River (Portage Creek),1988,8514,,207,21877
Nushagak River (Portage Creek),1988,14669,,208,36546
Nushagak River (Portage Creek),1988,13728,,209,50274
Nushagak River (Portage Creek),1988,9722,,210,59996
Nushagak River (Portage Creek),1988,7873,,211,67869
Nushagak River (Portage Creek),1988,17365,,212,85234
Nushagak River (Portage Creek),1988,38549,,213,123783
Nushagak River (Portage Creek),1988,23238,,214,147021
Nushagak River (Portage Creek),1988,32460,,215,179481
Nushagak River (Portage Creek),1988,55663,,216,235144
Nushagak River (Portage Creek),1988,60774,,217,295918
Nushagak River (Portage Creek),1988,19695,,218,315613
Nushagak River (Portage Creek),1988,17049,,219,332662
Nushagak River (Portage Creek),1988,23977,,220,356639
Nushagak River (Portage Creek),1988,80869,,221,437508
Nushagak River (Portage Creek),1988,17246,,222,454754
Nushagak River (Portage Creek),1988,6451,,223,461205
Nushagak River (Portage Creek),1988,6699,,224,467904
Nushagak River (Portage Creek),1988,9763,,225,477667
Nushagak River (Portage Creek),1988,3195,,226,480862
Nushagak River (Portage Creek),1988,3491,,227,484353
Nushagak River (Portage Creek),1988,1957,,228,486310
Nushagak River (Portage Creek),1988,1636,,229,487946
Nushagak River (Portage Creek),1988,2762,,230,490708
Nushagak River (Portage Creek),1988,1432,,231,492140
Nushagak River (Portage Creek),1988,706,,232,492846
Nushagak River (Portage Creek),1988,438,,233,493284
Nushagak River (Portage Creek),1988,718,,234,494002
Nushagak River (Portage Creek),1988,392,,235,494394
Nushagak River (Portage Creek),1988,216,,236,494610
Nushagak River (Portage Creek),1989,169,,184,169
Nushagak River (Portage Creek),1989,0,,185,169
Nushagak River (Portage Creek),1990,179,,195,179
Nushagak River (Portage Creek),1990,72,,196,251
Nushagak River (Portage Creek),1990,63,,197,314
Nushagak River (Portage Creek),1990,112,,198,426
Nushagak River (Portage Creek),1990,97,,199,523
Nushagak River (Portage Creek),1990,106,,200,629
Nushagak River (Portage Creek),1990,110,,201,739
Nushagak River (Portage Creek),1990,151,,202,890
Nushagak River (Portage Creek),1990,348,,203,1238
Nushagak River (Portage Creek),1990,447,,204,1685
Nushagak River (Portage Creek),1990,410,,205,2095
Nushagak River (Portage Creek),1990,665,,206,2760
Nushagak River (Portage Creek),1990,676,,207,3436
Nushagak River (Portage Creek),1990,647,,208,4083
Nushagak River (Portage Creek),1990,1053,,209,5136
Nushagak River (Portage Creek),1990,17893,,210,23029
Nushagak River (Portage Creek),1990,17770,,211,40799
Nushagak River (Portage Creek),1990,11070,,212,51869
Nushagak River (Portage Creek),1990,32017,,213,83886
Nushagak River (Portage Creek),1990,39470,,214,123356
Nushagak River (Portage Creek),1990,64515,,215,187871
Nushagak River (Portage Creek),1990,86613,,216,274484
Nushagak River (Portage Creek),1990,193407,,217,467891
Nushagak River (Portage Creek),1990,90081,,218,557972
Nushagak River (Portage Creek),1990,76456,,219,634428
Nushagak River (Portage Creek),1990,88089,,220,722517
Nushagak River (Portage Creek),1990,38446,,221,760963
Nushagak River (Portage Creek),1990,9279,,222,770242
Nushagak River (Portage Creek),1990,11861,,223,782103
Nushagak River (Portage Creek),1990,9429,,224,791532
Nushagak River (Portage Creek),1990,2350,,225,793882
Nushagak River (Portage Creek),1990,1257,,226,795139
Nushagak River (Portage Creek),1990,555,,227,795694
Nushagak River (Portage Creek),1990,178,,228,795872
Nushagak River (Portage Creek),1990,405,,229,796277
Nushagak River (Portage Creek),1990,580,,230,796857
Nushagak River (Portage Creek),1990,232,,231,797089
Nushagak River (Portage Creek),1990,442,,232,797531
Nushagak River (Portage Creek),1990,353,,233,797884
Nushagak River (Portage Creek),1990,297,,234,798181
Nushagak River (Portage Creek),1990,1137,,235,799318
Nushagak River (Portage Creek),1990,587,,236,799905
Nushagak River (Portage Creek),1990,462,,237,800367
Nushagak River (Portage Creek),1990,802,,238,801169
Nushagak River (Portage Creek),1990,289,,239,801458
Nushagak River (Portage Creek),1990,148,,240,801606
Nushagak River (Portage Creek),1990,119,,241,801725
Nushagak River (Portage Creek),1990,0,,242,801725
Nushagak River (Portage Creek),1992,568,,193,568
Nushagak River (Portage Creek),1992,1465,,194,2033
Nushagak River (Portage Creek),1992,2625,,195,4658
Nushagak River (Portage Creek),1992,1262,,196,5920
Nushagak River (Portage Creek),1992,684,,197,6604
Nushagak River (Portage Creek),1992,517,,198,7121
Nushagak River (Portage Creek),1992,423,,199,7544
Nushagak River (Portage Creek),1992,222,,200,7766
Nushagak River (Portage Creek),1992,205,,201,7971
Nushagak River (Portage Creek),1992,210,,202,8181
Nushagak River (Portage Creek),1992,295,,203,8476
Nushagak River (Portage Creek),1992,124,,204,8600
Afognak River Litnik,2006,4,,192,4
Afognak River Litnik,2006,0,,193,4
Afognak River Litnik,2006,0,,194,4
Afognak River Litnik,2006,0,,195,4
Afognak River Litnik,2006,0,,196,4
Afognak River Litnik,2006,0,,197,4
Afognak River Litnik,2006,0,,198,4
Afognak River Litnik,2006,2,,199,6
Afognak River Litnik,2006,1,,200,7
Afognak River Litnik,2006,26,,201,33
Afognak River Litnik,2006,3,,202,36
Afognak River Litnik,2006,82,,203,118
Afognak River Litnik,2006,21,,204,139
Afognak River Litnik,2006,598,,205,737
Afognak River Litnik,2006,261,,206,998
Afognak River Litnik,2006,120,,207,1118
Afognak River Litnik,2006,331,,208,1449
Afognak River Litnik,2006,98,,209,1547
Afognak River Litnik,2006,205,,210,1752
Afognak River Litnik,2006,1355,,211,3107
Afognak River Litnik,2006,506,,212,3613
Afognak River Litnik,2006,81,,213,3694
Afognak River Litnik,2006,342,,214,4036
Afognak River Litnik,2006,2981,,215,7017
Afognak River Litnik,2006,2218,,216,9235
Afognak River Litnik,2006,0,Wier pulled,217,9235
Afognak River Litnik,2007,2,,195,2
Afognak River Litnik,2007,0,,196,2
Afognak River Litnik,2007,0,,197,2
Afognak River Litnik,2007,0,,198,2
Afognak River Litnik,2007,0,,199,2
Afognak River Litnik,2007,0,,200,2
Afognak River Litnik,2007,1,,201,3
Afognak River Litnik,2007,0,,202,3
Afognak River Litnik,2007,0,,203,3
Afognak River Litnik,2007,0,,204,3
Afognak River Litnik,2007,8,,205,11
Afognak River Litnik,2007,321,,206,332
Afognak River Litnik,2007,300,,207,632
Afognak River Litnik,2007,9,,208,641
Afognak River Litnik,2007,20,,209,661
Afognak River Litnik,2007,39,,210,700
Afognak River Litnik,2007,27,,211,727
Afognak River Litnik,2007,19,,212,746
Afognak River Litnik,2007,27,,213,773
Afognak River Litnik,2007,30,,214,803
Afognak River Litnik,2007,9,,215,812
Afognak River Litnik,2007,31,,216,843
Afognak River Litnik,2007,188,,217,1031
Afognak River Litnik,2007,43,,218,1074
Afognak River Litnik,2007,35,,219,1109
Afognak River Litnik,2007,38,,220,1147
Afognak River Litnik,2007,50,,221,1197
Afognak River Litnik,2007,81,,222,1278
Afognak River Litnik,2007,80,,223,1358
Afognak River Litnik,2007,64,,224,1422
Afognak River Litnik,2007,27,,225,1449
Afognak River Litnik,2007,132,,226,1581
Afognak River Litnik,2007,144,,227,1725
Afognak River Litnik,2007,52,,228,1777
Afognak River Litnik,2007,10000,Wier closed,229,11777
Afognak River Litnik,2008,1,,182,1
Afognak River Litnik,2008,0,,183,1
Afognak River Litnik,2008,0,,184,1
Afognak River Litnik,2008,3,,185,4
Afognak River Litnik,2008,13,,186,17
Afognak River Litnik,2008,25,,187,42
Afognak River Litnik,2008,16,,188,58
Afognak River Litnik,2008,7,,189,65
Afognak River Litnik,2008,24,,190,89
Afognak River Litnik,2008,1,,191,90
Afognak River Litnik,2008,3,,192,93
Afognak River Litnik,2008,10,,193,103
Afognak River Litnik,2008,2,,194,105
Afognak River Litnik,2008,4,,195,109
Afognak River Litnik,2008,1,,196,110
Afognak River Litnik,2008,281,,197,391
Afognak River Litnik,2008,103,,198,494
Afognak River Litnik,2008,420,,199,914
Afognak River Litnik,2008,115,,200,1029
Afognak River Litnik,2008,81,,201,1110
Afognak River Litnik,2008,55,,202,1165
Afognak River Litnik,2008,104,,203,1269
Afognak River Litnik,2008,44,,204,1313
Afognak River Litnik,2008,17,,205,1330
Afognak River Litnik,2008,280,,206,1610
Afognak River Litnik,2008,72,,207,1682
Afognak River Litnik,2008,77,,208,1759
Afognak River Litnik,2008,125,,209,1884
Afognak River Litnik,2008,111,,210,1995
Afognak River Litnik,2008,232,,211,2227
Afognak River Litnik,2008,144,,212,2371
Afognak River Litnik,2008,91,,213,2462
Afognak River Litnik,2008,76,,214,2538
Afognak River Litnik,2008,31,,215,2569
Afognak River Litnik,2008,17,,216,2586
Afognak River Litnik,2008,6,,217,2592
Afognak River Litnik,2008,57,,218,2649
Afognak River Litnik,2008,45,,219,2694
Afognak River Litnik,2008,22,,220,2716
Afognak River Litnik,2008,13000,"Wier closed, post wier estimate",221,15716
Afognak River Litnik,2009,5,,203,5
Afognak River Litnik,2009,10,,204,15
Afognak River Litnik,2009,1,,205,16
Afognak River Litnik,2009,6,,206,22
Afognak River Litnik,2009,22,,207,44
Afognak River Litnik,2009,0,,208,44
Afognak River Litnik,2009,1,,209,45
Afognak River Litnik,2009,12,,210,57
Afognak River Litnik,2009,14,,211,71
Afognak River Litnik,2009,2,,212,73
Afognak River Litnik,2009,1,,213,74
Afognak River Litnik,2009,10,,214,84
Afognak River Litnik,2009,19,,215,103
Afognak River Litnik,2009,604,,216,707
Afognak River Litnik,2009,132,,217,839
Afognak River Litnik,2009,56,,218,895
Afognak River Litnik,2009,0,Wier closed,219,895
Afognak River Litnik,2010,2,,192,2
Afognak River Litnik,2010,0,,193,2
Afognak River Litnik,2010,2,,194,4
Afognak River Litnik,2010,0,,195,4
Afognak River Litnik,2010,4,,196,8
Afognak River Litnik,2010,9,,197,17
Afognak River Litnik,2010,3,,198,20
Afognak River Litnik,2010,0,,199,20
Afognak River Litnik,2010,0,,200,20
Afognak River Litnik,2010,0,,201,20
Afognak River Litnik,2010,2,,202,22
Afognak River Litnik,2010,0,,203,22
Afognak River Litnik,2010,1,,204,23
Afognak River Litnik,2010,1,,205,24
Afognak River Litnik,2010,3,,206,27
Afognak River Litnik,2010,0,,207,27
Afognak River Litnik,2010,5,,208,32
Afognak River Litnik,2010,1,,209,33
Afognak River Litnik,2010,4,,210,37
Afognak River Litnik,2010,1135,,211,1172
Afognak River Litnik,2010,864,,212,2036
Afognak River Litnik,2010,9,,213,2045
Afognak River Litnik,2010,37,,214,2082
Afognak River Litnik,2010,163,,215,2245
Afognak River Litnik,2010,141,,216,2386
Afognak River Litnik,2010,156,,217,2542
Afognak River Litnik,2010,897,,218,3439
Afognak River Litnik,2010,182,,219,3621
Afognak River Litnik,2010,3929,,220,7550
Afognak River Litnik,2010,1322,,221,8872
Afognak River Litnik,2010,316,,222,9188
Afognak River Litnik,2010,93,,223,9281
Afognak River Litnik,2010,535,,224,9816
Afognak River Litnik,2010,8,,225,9824
Afognak River Litnik,2010,5,,226,9829
Afognak River Litnik,2010,17974,,227,27803
Afognak River Litnik,2010,2370,,228,30173
Afognak River Litnik,2010,3639,,229,33812
Afognak River Litnik,2010,1525,,230,35337
Afognak River Litnik,2010,376,,231,35713
Afognak River Litnik,2010,41,,232,35754
Afognak River Litnik,2010,337,,233,36091
Afognak River Litnik,2010,2016,,234,38107
Afognak River Litnik,2010,16,,235,38123
Afognak River Litnik,2010,172,,236,38295
Afognak River Litnik,2010,443,,237,38738
Afognak River Litnik,2010,1089,,238,39827
Afognak River Litnik,2010,975,,239,40802
Afognak River Litnik,2010,752,,240,41554
Afognak River Litnik,2010,1131,,241,42685
Afognak River Litnik,2010,825,,242,43510
Afognak River Litnik,2010,1390,,243,44900
Afognak River Litnik,2010,1010,,244,45910
Afognak River Litnik,2010,1109,,245,47019
Afognak River Litnik,2010,1409,,246,48428
Afognak River Litnik,2010,3241,,247,51669
Afognak River Litnik,2010,5454,,248,57123
Afognak River Litnik,2010,614,,249,57737
Afognak River Litnik,2010,4500,"Wier closed, post wier estimate",250,62237
Afognak River Litnik,2011,1,,212,1
Afognak River Litnik,2011,21,,213,22
Afognak River Litnik,2011,3,,214,25
Afognak River Litnik,2011,12,,215,37
Afognak River Litnik,2011,2,,216,39
Afognak River Litnik,2011,2,,217,41
Afognak River Litnik,2011,0,,218,41
Afognak River Litnik,2011,8,,219,49
Afognak River Litnik,2011,15,,220,64
Afognak River Litnik,2011,15,,221,79
Afognak River Litnik,2011,14,,222,93
Afognak River Litnik,2011,12,,223,105
Afognak River Litnik,2011,44,,224,149
Afognak River Litnik,2011,5,,225,154
Afognak River Litnik,2011,23,,226,177
Afognak River Litnik,2011,2,,227,179
Afognak River Litnik,2011,34,,228,213
Afognak River Litnik,2011,20,,229,233
Afognak River Litnik,2011,545,,230,778
Afognak River Litnik,2011,1899,,231,2677
Afognak River Litnik,2011,764,Wier pulled for season,232,3441
Afognak River Litnik,2012,3,,193,3
Afognak River Litnik,2012,9,,194,12
Afognak River Litnik,2012,8,,195,20
Afognak River Litnik,2012,2,,196,22
Afognak River Litnik,2012,13,,197,35
Afognak River Litnik,2012,8,,198,43
Afognak River Litnik,2012,1,,199,44
Afognak River Litnik,2012,10,,200,54
Afognak River Litnik,2012,3,,201,57
Afognak River Litnik,2012,6,,202,63
Afognak River Litnik,2012,15,,203,78
Afognak River Litnik,2012,10,,204,88
Afognak River Litnik,2012,1,,205,89
Afognak River Litnik,2012,5,,206,94
Afognak River Litnik,2012,1,,207,95
Afognak River Litnik,2012,2,,208,97
Afognak River Litnik,2012,0,,209,97
Afognak River Litnik,2012,1,,210,98
Afognak River Litnik,2012,2,,211,100
Afognak River Litnik,2012,886,,212,986
Afognak River Litnik,2012,42,,213,1028
Afognak River Litnik,2012,13,,214,1041
Afognak River Litnik,2012,3,,215,1044
Afognak River Litnik,2012,19,,216,1063
Afognak River Litnik,2012,57,,217,1120
Afognak River Litnik,2012,190,,218,1310
Afognak River Litnik,2012,298,,219,1608
Afognak River Litnik,2012,78,,220,1686
Afognak River Litnik,2012,84,,221,1770
Afognak River Litnik,2012,72,,222,1842
Afognak River Litnik,2012,39,,223,1881
Afognak River Litnik,2012,32,,224,1913
Afognak River Litnik,2012,1128,,225,3041
Afognak River Litnik,2012,1734,,226,4775
Afognak River Litnik,2012,19687,,227,24462
Afognak River Litnik,2012,15746,,228,40208
Afognak River Litnik,2012,2327,,229,42535
Afognak River Litnik,2012,1768,,230,44303
Afognak River Litnik,2012,1386,,231,45689
Afognak River Litnik,2012,1658,,232,47347
Afognak River Litnik,2012,833,,233,48180
Afognak River Litnik,2012,425,,234,48605
Afognak River Litnik,2012,600,,235,49205
Afognak River Litnik,2012,1936,,236,51141
Afognak River Litnik,2012,787,,237,51928
Afognak River Litnik,2012,60000,"Wier pulled for season, post wier estimate",238,111928
Ayakulik River,2006,12,,170,12
Ayakulik River,2006,0,,171,12
Ayakulik River,2006,0,,172,12
Ayakulik River,2006,0,,173,12
Ayakulik River,2006,0,,174,12
Ayakulik River,2006,0,,175,12
Ayakulik River,2006,0,,176,12
Ayakulik River,2006,0,,177,12
Ayakulik River,2006,0,,178,12
Ayakulik River,2006,0,,179,12
Ayakulik River,2006,0,,180,12
Ayakulik River,2006,0,,181,12
Ayakulik River,2006,6,,182,18
Ayakulik River,2006,3,,183,21
Ayakulik River,2006,11,,184,32
Ayakulik River,2006,0,,185,32
Ayakulik River,2006,0,,186,32
Ayakulik River,2006,0,,187,32
Ayakulik River,2006,0,,188,32
Ayakulik River,2006,1,,189,33
Ayakulik River,2006,7,,190,40
Ayakulik River,2006,10,,191,50
Ayakulik River,2006,144,,192,194
Ayakulik River,2006,60,,193,254
Ayakulik River,2006,14,,194,268
Ayakulik River,2006,0,,195,268
Ayakulik River,2006,6,,196,274
Ayakulik River,2006,19,,197,293
Ayakulik River,2006,21,,198,314
Ayakulik River,2006,60,,199,374
Ayakulik River,2006,706,,200,1080
Ayakulik River,2006,158,,201,1238
Ayakulik River,2006,1876,,202,3114
Ayakulik River,2006,214,,203,3328
Ayakulik River,2006,0,,204,3328
Ayakulik River,2006,1044,,205,4372
Ayakulik River,2006,1473,,206,5845
Ayakulik River,2006,2541,,207,8386
Ayakulik River,2006,2239,,208,10625
Ayakulik River,2006,4209,,209,14834
Ayakulik River,2006,1760,,210,16594
Ayakulik River,2006,0,,211,16594
Ayakulik River,2006,1781,,212,18375
Ayakulik River,2006,295,,213,18670
Ayakulik River,2006,20200,,214,38870
Ayakulik River,2006,32835,,215,71705
Ayakulik River,2006,20735,,216,92440
Ayakulik River,2006,2515,,217,94955
Ayakulik River,2006,16790,,218,111745
Ayakulik River,2006,14269,,219,126014
Ayakulik River,2006,46134,,220,172148
Ayakulik River,2006,27697,,221,199845
Ayakulik River,2006,3092,,222,202937
Ayakulik River,2006,21619,,223,224556
Ayakulik River,2006,16827,,224,241383
Ayakulik River,2006,37480,,225,278863
Ayakulik River,2006,45469,,226,324332
Ayakulik River,2006,45482,,227,369814
Ayakulik River,2006,50000,Wier closed,228,419814
Ayakulik River,2006,31364,Wier closed,230,451178
Ayakulik River,2007,28,,181,28
Ayakulik River,2007,12,,182,40
Ayakulik River,2007,0,,183,40
Ayakulik River,2007,5,,184,45
Ayakulik River,2007,0,,185,45
Ayakulik River,2007,0,,186,45
Ayakulik River,2007,3,,187,48
Ayakulik River,2007,1,,188,49
Ayakulik River,2007,59,,189,108
Ayakulik River,2007,9,,190,117
Ayakulik River,2007,3,,191,120
Ayakulik River,2007,44,,192,164
Ayakulik River,2007,45,,193,209
Ayakulik River,2007,21,,194,230
Ayakulik River,2007,80,,195,310
Ayakulik River,2007,54,,196,364
Ayakulik River,2007,64,,197,428
Ayakulik River,2007,5,,198,433
Ayakulik River,2007,443,,199,876
Ayakulik River,2007,177,,200,1053
Ayakulik River,2007,202,,201,1255
Ayakulik River,2007,62,,202,1317
Ayakulik River,2007,111,,203,1428
Ayakulik River,2007,149,,204,1577
Ayakulik River,2007,137,,205,1714
Ayakulik River,2007,519,,206,2233
Ayakulik River,2007,1131,,207,3364
Ayakulik River,2007,1126,,208,4490
Ayakulik River,2007,345,,209,4835
Ayakulik River,2007,25,,210,4860
Ayakulik River,2007,20,,211,4880
Ayakulik River,2007,141,,212,5021
Ayakulik River,2007,934,,213,5955
Ayakulik River,2007,120,,214,6075
Ayakulik River,2007,1184,,215,7259
Ayakulik River,2007,125,,216,7384
Ayakulik River,2007,0,,217,7384
Ayakulik River,2007,55,,218,7439
Ayakulik River,2007,885,,219,8324
Ayakulik River,2007,625,,220,8949
Ayakulik River,2007,374,,221,9323
Ayakulik River,2007,2539,,222,11862
Ayakulik River,2007,754,,223,12616
Ayakulik River,2007,499,,224,13115
Ayakulik River,2007,1198,,225,14313
Ayakulik River,2007,769,,226,15082
Ayakulik River,2007,113,,227,15195
Ayakulik River,2007,166,,228,15361
Ayakulik River,2007,208,,229,15569
Ayakulik River,2007,69,,230,15638
Ayakulik River,2007,92,,231,15730
Ayakulik River,2007,305,,232,16035
Ayakulik River,2007,138,,233,16173
Ayakulik River,2007,11,,234,16184
Ayakulik River,2007,659,,235,16843
Ayakulik River,2007,318,,236,17161
Ayakulik River,2007,803,,237,17964
Ayakulik River,2007,384,,238,18348
Ayakulik River,2007,576,,239,18924
Ayakulik River,2007,36,,240,18960
Ayakulik River,2007,625,,241,19585
Ayakulik River,2007,504,,242,20089
Ayakulik River,2007,457,,244,20546
Ayakulik River,2007,481,,245,21027
Ayakulik River,2007,640,,246,21667
Ayakulik River,2007,1989,,247,23656
Ayakulik River,2007,578,,248,24234
Ayakulik River,2007,513,,249,24747
Ayakulik River,2007,1948,,250,26695
Ayakulik River,2007,1200,"estimate, wier out",251,27895
Ayakulik River,2007,900,"estimate, wier out",252,28795
Ayakulik River,2007,600,"estimate, wier out",253,29395
Ayakulik River,2007,600,"estimate, wier out",254,29995
Ayakulik River,2007,800,"estimate, wier out",255,30795
Ayakulik River,2007,400,"estimate, wier out",256,31195
Ayakulik River,2007,600,wier closed,257,31795
Ayakulik River,2008,7,,184,7
Ayakulik River,2008,57,,185,64
Ayakulik River,2008,16,,186,80
Ayakulik River,2008,41,,187,121
Ayakulik River,2008,2,,188,123
Ayakulik River,2008,22,,189,145
Ayakulik River,2008,21,,190,166
Ayakulik River,2008,9,,191,175
Ayakulik River,2008,23,,192,198
Ayakulik River,2008,668,,193,866
Ayakulik River,2008,2957,,194,3823
Ayakulik River,2008,1435,,195,5258
Ayakulik River,2008,588,,196,5846
Ayakulik River,2008,1427,,197,7273
Ayakulik River,2008,6709,,198,13982
Ayakulik River,2008,93,,199,14075
Ayakulik River,2008,25,,200,14100
Ayakulik River,2008,595,,201,14695
Ayakulik River,2008,287,,202,14982
Ayakulik River,2008,140,,203,15122
Ayakulik River,2008,0,,204,15122
Ayakulik River,2008,314,,205,15436
Ayakulik River,2008,938,,206,16374
Ayakulik River,2008,2815,,207,19189
Ayakulik River,2008,2671,,208,21860
Ayakulik River,2008,25120,,209,46980
Ayakulik River,2008,18971,,210,65951
Ayakulik River,2008,15360,,211,81311
Ayakulik River,2008,2105,,212,83416
Ayakulik River,2008,378,,213,83794
Ayakulik River,2008,2460,,214,86254
Ayakulik River,2008,36582,,215,122836
Ayakulik River,2008,21428,,216,144264
Ayakulik River,2008,1760,,217,146024
Ayakulik River,2008,58746,,218,204770
Ayakulik River,2008,66627,,219,271397
Ayakulik River,2008,49766,,220,321163
Ayakulik River,2008,19399,,221,340562
Ayakulik River,2008,58845,,222,399407
Ayakulik River,2008,40621,,223,440028
Ayakulik River,2008,36848,,224,476876
Ayakulik River,2008,59622,,225,536498
Ayakulik River,2008,9889,,226,546387
Ayakulik River,2008,6778,,227,553165
Ayakulik River,2008,45614,,228,598779
Ayakulik River,2008,24804,,229,623583
Ayakulik River,2008,35542,,230,659125
Ayakulik River,2008,1116,,231,660241
Ayakulik River,2008,345,,232,660586
Ayakulik River,2008,4917,,233,665503
Ayakulik River,2008,13356,,234,678859
Ayakulik River,2008,1815,,235,680674
Ayakulik River,2008,17983,,236,698657
Ayakulik River,2008,1622,,237,700279
Ayakulik River,2008,5136,,238,705415
Ayakulik River,2008,6559,,239,711974
Ayakulik River,2008,4400,,240,716374
Ayakulik River,2008,5676,,241,722050
Ayakulik River,2008,3594,,242,725644
Ayakulik River,2008,1300,,243,726944
Ayakulik River,2008,1886,,244,728830
Ayakulik River,2008,2323,,245,731153
Ayakulik River,2008,923,,246,732076
Ayakulik River,2008,889,,247,732965
Ayakulik River,2008,508,,248,733473
Ayakulik River,2008,763,,249,734236
Ayakulik River,2008,527,,250,734763
Ayakulik River,2008,3034,"Wier closed, post wier estimate",251,737797
Ayakulik River,2008,1000,"Wier closed, post wier estimate",252,738797
Ayakulik River,2008,1000,"Wier closed, post wier estimate",253,739797
Ayakulik River,2008,1000,"Wier closed, post wier estimate",254,740797
Ayakulik River,2008,1000,"Wier closed, post wier estimate",255,741797
Ayakulik River,2009,2,,175,2
Ayakulik River,2009,0,,176,2
Ayakulik River,2009,0,,177,2
Ayakulik River,2009,1,,178,3
Ayakulik River,2009,0,,179,3
Ayakulik River,2009,13,,180,16
Ayakulik River,2009,8,,181,24
Ayakulik River,2009,7,,182,31
Ayakulik River,2009,39,,183,70
Ayakulik River,2009,24,,184,94
Ayakulik River,2009,143,,185,237
Ayakulik River,2009,91,,186,328
Ayakulik River,2009,19,,187,347
Ayakulik River,2009,65,,188,412
Ayakulik River,2009,79,,189,491
Ayakulik River,2009,71,,190,562
Ayakulik River,2009,183,,191,745
Ayakulik River,2009,148,,192,893
Ayakulik River,2009,366,,193,1259
Ayakulik River,2009,11,,194,1270
Ayakulik River,2009,283,,195,1553
Ayakulik River,2009,165,,196,1718
Ayakulik River,2009,94,,197,1812
Ayakulik River,2009,562,,198,2374
Ayakulik River,2009,12,,199,2386
Ayakulik River,2009,396,,200,2782
Ayakulik River,2009,481,,201,3263
Ayakulik River,2009,279,,202,3542
Ayakulik River,2009,3,,203,3545
Ayakulik River,2009,0,,204,3545
Ayakulik River,2009,23,,205,3568
Ayakulik River,2009,35,,206,3603
Ayakulik River,2009,47,,207,3650
Ayakulik River,2009,10,,208,3660
Ayakulik River,2009,2,,209,3662
Ayakulik River,2009,99,,210,3761
Ayakulik River,2009,44,,211,3805
Ayakulik River,2009,777,,212,4582
Ayakulik River,2009,137,,213,4719
Ayakulik River,2009,837,,214,5556
Ayakulik River,2009,418,,215,5974
Ayakulik River,2009,2053,"wier out, high water",216,8027
Ayakulik River,2009,700,"estimate, wier out, high water",217,8727
Ayakulik River,2009,50,"estimate, wier out, high water",218,8777
Ayakulik River,2009,30,"estimate, wier out, high water",219,8807
Ayakulik River,2009,165,,220,8972
Ayakulik River,2009,585,,221,9557
Ayakulik River,2009,14,,222,9571
Ayakulik River,2009,6,,223,9577
Ayakulik River,2009,1616,,224,11193
Ayakulik River,2009,3865,,225,15058
Ayakulik River,2009,1214,,226,16272
Ayakulik River,2009,988,,227,17260
Ayakulik River,2009,386,,228,17646
Ayakulik River,2009,922,,229,18568
Ayakulik River,2009,1689,,230,20257
Ayakulik River,2009,268,,231,20525
Ayakulik River,2009,105,,232,20630
Ayakulik River,2009,258,,233,20888
Ayakulik River,2009,31,,234,20919
Ayakulik River,2009,2,,235,20921
Ayakulik River,2009,374,,236,21295
Ayakulik River,2009,644,,237,21939
Ayakulik River,2009,78,,238,22017
Ayakulik River,2009,1728,,239,23745
Ayakulik River,2009,608,,240,24353
Ayakulik River,2009,568,,241,24921
Ayakulik River,2009,223,,242,25144
Ayakulik River,2009,276,,243,25420
Ayakulik River,2009,119,,244,25539
Ayakulik River,2009,458,,245,25997
Ayakulik River,2009,924,,246,26921
Ayakulik River,2009,2,,247,26923
Ayakulik River,2009,109,,248,27032
Ayakulik River,2009,99,,249,27131
Ayakulik River,2009,88,,250,27219
Ayakulik River,2009,121,,251,27340
Ayakulik River,2009,103,,252,27443
Ayakulik River,2009,21,,253,27464
Ayakulik River,2009,92,,254,27556
Ayakulik River,2009,8,,255,27564
Ayakulik River,2009,139,,256,27703
Ayakulik River,2009,50,,257,27753
Ayakulik River,2009,20,,258,27773
Ayakulik River,2009,20,,259,27793
Ayakulik River,2009,20,"Wier closed, post wier estimate",260,27813
Ayakulik River,2010,1,,174,1
Ayakulik River,2010,0,,175,1
Ayakulik River,2010,9,,176,10
Ayakulik River,2010,4,,177,14
Ayakulik River,2010,4,,178,18
Ayakulik River,2010,4,,179,22
Ayakulik River,2010,12,,180,34
Ayakulik River,2010,3,,181,37
Ayakulik River,2010,3,,182,40
Ayakulik River,2010,0,,183,40
Ayakulik River,2010,1,,184,41
Ayakulik River,2010,16,,185,57
Ayakulik River,2010,13,,186,70
Ayakulik River,2010,9,,187,79
Ayakulik River,2010,165,,188,244
Ayakulik River,2010,59,,189,303
Ayakulik River,2010,146,,190,449
Ayakulik River,2010,410,,191,859
Ayakulik River,2010,306,,192,1165
Ayakulik River,2010,4,,193,1169
Ayakulik River,2010,88,,194,1257
Ayakulik River,2010,781,,195,2038
Ayakulik River,2010,110,,196,2148
Ayakulik River,2010,907,,197,3055
Ayakulik River,2010,1262,,198,4317
Ayakulik River,2010,1573,,199,5890
Ayakulik River,2010,332,,200,6222
Ayakulik River,2010,367,,201,6589
Ayakulik River,2010,3300,"estimate, weir out",202,9889
Ayakulik River,2010,917,,203,10806
Ayakulik River,2010,22,,204,10828
Ayakulik River,2010,105,,205,10933
Ayakulik River,2010,105,,206,11038
Ayakulik River,2010,2100,estimate,207,13138
Ayakulik River,2010,28849,,208,41987
Ayakulik River,2010,12188,,209,54175
Ayakulik River,2010,25444,,210,79619
Ayakulik River,2010,44211,,211,123830
Ayakulik River,2010,49000,estimate,212,172830
Ayakulik River,2010,6900,estimate,213,179730
Ayakulik River,2010,14478,,214,194208
Ayakulik River,2010,8175,,215,202383
Ayakulik River,2010,2728,,216,205111
Ayakulik River,2010,12820,,217,217931
Ayakulik River,2010,52982,,218,270913
Ayakulik River,2010,42510,,219,313423
Ayakulik River,2010,36000,estimate,220,349423
Ayakulik River,2010,28000,estimate,221,377423
Ayakulik River,2010,38000,estimate,222,415423
Ayakulik River,2010,31000,estimate,223,446423
Ayakulik River,2010,32000,estimate,224,478423
Ayakulik River,2010,41000,estimate,225,519423
Ayakulik River,2010,13000,estimate,226,532423
Ayakulik River,2010,0,Wier closed,227,532423
Ayakulik River,2011,7,,172,7
Ayakulik River,2011,9,,173,16
Ayakulik River,2011,0,,174,16
Ayakulik River,2011,15,,175,31
Ayakulik River,2011,21,,176,52
Ayakulik River,2011,64,,177,116
Ayakulik River,2011,2,,178,118
Ayakulik River,2011,72,,179,190
Ayakulik River,2011,9,,180,199
Ayakulik River,2011,35,,181,234
Ayakulik River,2011,14,,182,248
Ayakulik River,2011,13,,183,261
Ayakulik River,2011,23,,184,284
Ayakulik River,2011,6,,185,290
Ayakulik River,2011,6,,186,296
Ayakulik River,2011,20,,187,316
Ayakulik River,2011,6,,188,322
Ayakulik River,2011,65,,189,387
Ayakulik River,2011,269,,190,656
Ayakulik River,2011,74,,191,730
Ayakulik River,2011,59,,192,789
Ayakulik River,2011,195,,193,984
Ayakulik River,2011,40,,194,1024
Ayakulik River,2011,124,,195,1148
Ayakulik River,2011,132,,196,1280
Ayakulik River,2011,336,,197,1616
Ayakulik River,2011,335,,198,1951
Ayakulik River,2011,83,,199,2034
Ayakulik River,2011,41,,200,2075
Ayakulik River,2011,29,,201,2104
Ayakulik River,2011,81,,202,2185
Ayakulik River,2011,199,,203,2384
Ayakulik River,2011,327,,204,2711
Ayakulik River,2011,300,"estimate, wier out, high water",205,3011
Ayakulik River,2011,89,,206,3100
Ayakulik River,2011,7,,207,3107
Ayakulik River,2011,58,,208,3165
Ayakulik River,2011,66,,209,3231
Ayakulik River,2011,150,,210,3381
Ayakulik River,2011,286,,211,3667
Ayakulik River,2011,887,,212,4554
Ayakulik River,2011,594,,213,5148
Ayakulik River,2011,961,,214,6109
Ayakulik River,2011,35,,215,6144
Ayakulik River,2011,35,,216,6179
Ayakulik River,2011,25,,217,6204
Ayakulik River,2011,65,,218,6269
Ayakulik River,2011,50,,219,6319
Ayakulik River,2011,90,,220,6409
Ayakulik River,2011,300,,221,6709
Ayakulik River,2011,927,,222,7636
Ayakulik River,2011,312,,223,7948
Ayakulik River,2011,471,,224,8419
Ayakulik River,2011,115,,225,8534
Ayakulik River,2011,336,,226,8870
Ayakulik River,2011,19,,227,8889
Ayakulik River,2011,111,,228,9000
Ayakulik River,2011,268,,229,9268
Ayakulik River,2011,807,,230,10075
Ayakulik River,2011,893,,231,10968
Ayakulik River,2011,2025,"Wier out, estimate",232,12993
Ayakulik River,2011,700,"Wier out, estimate",233,13693
Ayakulik River,2011,487,,234,14180
Ayakulik River,2011,365,,235,14545
Ayakulik River,2011,193,,236,14738
Ayakulik River,2011,364,,237,15102
Ayakulik River,2011,418,,238,15520
Ayakulik River,2011,598,,239,16118
Ayakulik River,2011,240,,240,16358
Ayakulik River,2011,733,,241,17091
Ayakulik River,2011,213,,242,17304
Ayakulik River,2011,402,,243,17706
Ayakulik River,2011,537,,244,18243
Ayakulik River,2011,231,,245,18474
Ayakulik River,2011,291,,246,18765
Ayakulik River,2011,183,,247,18948
Ayakulik River,2011,196,,248,19144
Ayakulik River,2011,203,,249,19347
Ayakulik River,2011,216,,250,19563
Ayakulik River,2011,615,"Wier pulled for season, post wier estimate",251,20178
Ayakulik River,2011,250,Post wier estimate,252,20428
Ayakulik River,2012,5,,173,5
Ayakulik River,2012,7,,174,12
Ayakulik River,2012,0,,175,12
Ayakulik River,2012,0,,176,12
Ayakulik River,2012,5,,177,17
Ayakulik River,2012,2,,178,19
Ayakulik River,2012,19,,179,38
Ayakulik River,2012,8,,180,46
Ayakulik River,2012,14,,181,60
Ayakulik River,2012,12,,182,72
Ayakulik River,2012,12,,183,84
Ayakulik River,2012,7,,184,91
Ayakulik River,2012,40,,185,131
Ayakulik River,2012,24,,186,155
Ayakulik River,2012,12,,187,167
Ayakulik River,2012,37,,188,204
Ayakulik River,2012,9,,189,213
Ayakulik River,2012,15,,190,228
Ayakulik River,2012,123,,191,351
Ayakulik River,2012,267,,192,618
Ayakulik River,2012,713,,193,1331
Ayakulik River,2012,700,,194,2031
Ayakulik River,2012,855,,195,2886
Ayakulik River,2012,96,,196,2982
Ayakulik River,2012,809,,197,3791
Ayakulik River,2012,7,,198,3798
Ayakulik River,2012,144,,199,3942
Ayakulik River,2012,324,,200,4266
Ayakulik River,2012,2112,,201,6378
Ayakulik River,2012,3700,,202,10078
Ayakulik River,2012,2529,,203,12607
Ayakulik River,2012,1173,,204,13780
Ayakulik River,2012,9794,,205,23574
Ayakulik River,2012,22316,,206,45890
Ayakulik River,2012,11408,,207,57298
Ayakulik River,2012,8102,,208,65400
Ayakulik River,2012,6902,,209,72302
Ayakulik River,2012,22784,,210,95086
Ayakulik River,2012,13252,,211,108338
Ayakulik River,2012,18630,,212,126968
Ayakulik River,2012,3284,,213,130252
Ayakulik River,2012,3606,,214,133858
Ayakulik River,2012,368,,215,134226
Ayakulik River,2012,28798,,216,163024
Ayakulik River,2012,10202,,217,173226
Ayakulik River,2012,31955,,218,205181
Ayakulik River,2012,17073,,219,222254
Ayakulik River,2012,40306,,220,262560
Ayakulik River,2012,31209,,221,293769
Ayakulik River,2012,13229,,222,306998
Ayakulik River,2012,18407,,223,325405
Ayakulik River,2012,6799,,224,332204
Ayakulik River,2012,19604,,225,351808
Ayakulik River,2012,12105,,226,363913
Ayakulik River,2012,4912,,227,368825
Ayakulik River,2012,9668,,228,378493
Ayakulik River,2012,1527,,229,380020
Ayakulik River,2012,6713,,230,386733
Ayakulik River,2012,1941,,231,388674
Ayakulik River,2012,6003,,232,394677
Ayakulik River,2012,7941,,233,402618
Ayakulik River,2012,2585,,234,405203
Ayakulik River,2012,2345,,235,407548
Ayakulik River,2012,6611,,236,414159
Ayakulik River,2012,5280,,237,419439
Ayakulik River,2012,5875,,238,425314
Ayakulik River,2012,4532,,239,429846
Ayakulik River,2012,3125,,240,432971
Ayakulik River,2012,3501,,241,436472
Ayakulik River,2012,3603,,242,440075
Ayakulik River,2012,12533,,243,452608
Ayakulik River,2012,3000,"estimate, high water",244,455608
Ayakulik River,2012,4300,"estimate, high water",245,459908
Ayakulik River,2012,0,Wier pulled for season,246,459908
Coghill River,2011,3,Water level 0,179,3
Coghill River,2011,3,Water level 0,184,6
Coghill River,2011,57,Water level 0,185,63
Coghill River,2011,21,Water level 0,186,84
Coghill River,2011,16,Water level 0,187,100
Coghill River,2011,7,Water level 0,188,107
Coghill River,2011,55,Water level 0,189,162
Coghill River,2011,508,Water level 0,190,670
Coghill River,2011,365,Water level 0,191,1035
Coghill River,2011,321,Water level 0,192,1356
Coghill River,2011,1639,Water level 0,193,2995
Coghill River,2011,61,Water level 0,194,3056
Coghill River,2011,4481,Water level 0,195,7537
Coghill River,2011,1579,Water level 0,196,9116
Coghill River,2011,3700,Water level 0,197,12816
Coghill River,2011,2864,Water level 0,198,15680
Coghill River,2011,2172,Water level 0,199,17852
Coghill River,2011,2599,Water level 0,200,20451
Coghill River,2011,3372,Water level 0,201,23823
Coghill River,2011,7250,Water level 0,202,31073
Coghill River,2012,3,A lot of days missing I don't know why (KO note),184,3
Coghill River,2012,4,A lot of days missing I don't know why (KO note),185,7
Coghill River,2012,2,A lot of days missing I don't know why (KO note),195,9
Coghill River,2012,25,A lot of days missing I don't know why (KO note),197,34
Coghill River,2012,12,A lot of days missing I don't know why (KO note),198,46
Coghill River,2012,3018,A lot of days missing I don't know why (KO note),204,3064
Coghill River,2012,911,A lot of days missing I don't know why (KO note),205,3975
Coghill River,2012,256,A lot of days missing I don't know why (KO note),206,4231
Coghill River,2012,631,A lot of days missing I don't know why (KO note),207,4862
Coghill River,2012,5206,A lot of days missing I don't know why (KO note),208,10068
Coghill River,2012,2231,A lot of days missing I don't know why (KO note),209,12299
Bear River,2006,3,,180,3
Bear River,2006,0,,181,3
Bear River,2006,2,,182,5
Bear River,2006,1,,183,6
Bear River,2006,0,,184,6
Bear River,2006,1,,185,7
Bear River,2006,6,,186,13
Bear River,2006,7,,187,20
Bear River,2006,10,,188,30
Bear River,2006,13,,189,43
Bear River,2006,17,,190,60
Bear River,2006,64,,191,124
Bear River,2006,15,,192,139
Bear River,2006,22,,193,161
Bear River,2006,14,,194,175
Bear River,2006,0,,195,175
Bear River,2006,0,,196,175
Bear River,2006,0,,197,175
Bear River,2006,22,,198,197
Bear River,2006,25,,199,222
Bear River,2006,38,,200,260
Bear River,2007,1,,179,1
Bear River,2007,0,,180,1
Bear River,2007,0,,181,1
Bear River,2007,0,,182,1
Bear River,2007,0,,183,1
Bear River,2007,0,,184,1
Bear River,2007,0,,185,1
Bear River,2007,0,,186,1
Bear River,2007,0,,187,1
Bear River,2007,0,,188,1
Bear River,2007,0,,189,1
Bear River,2007,0,,190,1
Bear River,2007,3,,191,4
Bear River,2007,0,,192,4
Bear River,2007,0,,193,4
Bear River,2007,0,,194,4
Bear River,2007,0,,195,4
Bear River,2007,20,,196,24
Bear River,2007,8,,197,32
Bear River,2007,6,,198,38
Bear River,2007,2,,199,40
Bear River,2007,4,,200,44
Bear River,2007,7,,201,51
Bear River,2007,13,,202,64
Bear River,2007,9,,203,73
Bear River,2007,17,,204,90
Bear River,2007,7,,205,97
Bear River,2007,0,,206,97
Bear River,2007,32,,207,129
Bear River,2007,27,,208,156
Bear River,2007,26,,209,182
Bear River,2007,19,,210,201
Bear River,2007,8,,211,209
Bear River,2007,37,,212,246
Bear River,2007,38,,213,284
Bear River,2007,16,,214,300
Bear River,2007,25,,215,325
Bear River,2007,10,,216,335
Bear River,2007,12,,217,347
Bear River,2007,11,,218,358
Bear River,2007,6,,219,364
Bear River,2007,8,,220,372
Bear River,2007,5,,221,377
Bear River,2007,15,,222,392
Bear River,2007,18,,223,410
Bear River,2007,11,,224,421
Bear River,2007,24,,225,445
Bear River,2007,40,,226,485
Bear River,2007,16,,227,501
Bear River,2007,31,,228,532
Bear River,2007,15,,229,547
Bear River,2007,21,,230,568
Bear River,2007,31,,231,599
Bear River,2007,14,,232,613
Bear River,2007,25,,233,638
Bear River,2007,0,Wier closed,234,638
Bear River,2008,1,,189,1
Bear River,2008,1,,190,2
Bear River,2008,1,,191,3
Bear River,2008,4,,192,7
Bear River,2008,4,,193,11
Bear River,2008,12,,194,23
Bear River,2008,1,,195,24
Bear River,2008,3,,196,27
Bear River,2008,2,,197,29
Bear River,2008,3,,198,32
Bear River,2008,2,,199,34
Bear River,2008,12,,200,46
Bear River,2008,8,,201,54
Bear River,2008,5,,202,59
Bear River,2008,1,,203,60
Bear River,2008,17,,204,77
Bear River,2008,17,,205,94
Bear River,2008,11,,206,105
Bear River,2008,17,,207,122
Bear River,2008,10,,208,132
Bear River,2008,22,,209,154
Bear River,2008,0,,210,154
Bear River,2008,14,,211,168
Bear River,2008,20,,212,188
Bear River,2008,6,,213,194
Bear River,2008,8,,214,202
Bear River,2008,22,,215,224
Bear River,2008,19,,216,243
Bear River,2008,37,,217,280
Bear River,2008,40,,218,320
Bear River,2008,21,,219,341
Bear River,2008,77,,220,418
Bear River,2008,38,,221,456
Bear River,2008,89,,222,545
Bear River,2008,88,,223,633
Bear River,2008,92,,224,725
Bear River,2008,12,,225,737
Bear River,2008,2,,226,739
Bear River,2008,21,,227,760
Bear River,2008,115,,228,875
Bear River,2008,58,,229,933
Bear River,2008,23,,230,956
Bear River,2008,23,,231,979
Bear River,2008,0,no count,232,979
Bear River,2008,21,,233,1000
Bear River,2008,27,,234,1027
Bear River,2008,23,,235,1050
Bear River,2008,19,,236,1069
Bear River,2008,6,,237,1075
Bear River,2008,0,Wier closed,238,1075
Bear River,2008,0,Wier closed,239,1075
Bear River,2009,1,,182,1
Bear River,2009,2,,183,3
Bear River,2009,2,,184,5
Bear River,2009,7,,185,12
Bear River,2009,5,,186,17
Bear River,2009,3,,187,20
Bear River,2009,3,,188,23
Bear River,2009,0,,189,23
Bear River,2009,1,,190,24
Bear River,2009,3,,191,27
Bear River,2009,2,,192,29
Bear River,2009,0,,193,29
Bear River,2009,7,,194,36
Bear River,2009,6,,195,42
Bear River,2009,9,,196,51
Bear River,2009,11,,197,62
Bear River,2009,25,,198,87
Bear River,2009,14,,199,101
Bear River,2009,11,,200,112
Bear River,2009,16,,201,128
Bear River,2009,8,,202,136
Bear River,2009,2,,203,138
Bear River,2009,2,,204,140
Bear River,2009,20,,205,160
Bear River,2009,14,,206,174
Bear River,2009,17,,207,191
Bear River,2009,15,,208,206
Bear River,2009,8,,209,214
Bear River,2009,3,,210,217
Bear River,2009,16,,211,233
Bear River,2009,25,,212,258
Bear River,2009,33,,213,291
Bear River,2009,14,,214,305
Bear River,2009,6,,215,311
Bear River,2009,25,,216,336
Bear River,2009,8,,217,344
Bear River,2009,12,,218,356
Bear River,2009,21,,219,377
Bear River,2009,9,,220,386
Bear River,2009,104,,221,490
Bear River,2009,51,,222,541
Bear River,2009,45,,223,586
Bear River,2009,34,,224,620
Bear River,2009,17,,225,637
Bear River,2009,12,,226,649
Bear River,2009,15,,227,664
Bear River,2009,26,,228,690
Bear River,2009,27,,229,717
Bear River,2009,18,,230,735
Bear River,2009,19,,231,754
Bear River,2009,31,,232,785
Bear River,2009,27,,233,812
Bear River,2009,15,,234,827
Bear River,2009,5,,235,832
Bear River,2009,18,,236,850
Bear River,2009,13,,237,863
Bear River,2009,17,Wier closed,238,880
Bear River,2010,3,,182,3
Bear River,2010,8,,183,11
Bear River,2010,15,,184,26
Bear River,2010,7,,185,33
Bear River,2010,11,,186,44
Bear River,2010,7,,187,51
Bear River,2010,24,,188,75
Bear River,2010,3,,189,78
Bear River,2010,17,,190,95
Bear River,2010,26,,191,121
Bear River,2010,16,,192,137
Bear River,2010,0,,193,137
Bear River,2010,11,,194,148
Bear River,2010,8,,195,156
Bear River,2010,22,,196,178
Bear River,2010,51,,197,229
Bear River,2010,30,,198,259
Bear River,2010,12,,199,271
Bear River,2010,35,,200,306
Bear River,2010,32,,201,338
Bear River,2010,16,,202,354
Bear River,2010,5,,203,359
Bear River,2010,7,,204,366
Bear River,2010,11,,205,377
Bear River,2010,31,,206,408
Bear River,2010,17,,207,425
Bear River,2010,23,,208,448
Bear River,2010,20,,209,468
Bear River,2010,19,,210,487
Bear River,2010,11,,211,498
Bear River,2010,11,,212,509
Bear River,2010,21,,213,530
Bear River,2010,25,,214,555
Bear River,2010,34,,215,589
Bear River,2010,29,,216,618
Bear River,2010,26,,217,644
Bear River,2010,34,,218,678
Bear River,2010,23,,219,701
Bear River,2010,23,,220,724
Bear River,2010,4,,221,728
Bear River,2010,12,,222,740
Bear River,2010,19,,223,759
Bear River,2010,44,,224,803
Bear River,2010,62,,225,865
Bear River,2010,0,"No count, wier out due to high water",226,865
Bear River,2010,0,"No count, wier out due to high water",227,865
Bear River,2010,0,"No count, wier out due to high water",228,865
Bear River,2010,0,"No count, wier out due to high water",229,865
Bear River,2010,0,"No count, wier out due to high water",230,865
Bear River,2010,0,"No count, wier out due to high water",231,865
Bear River,2010,0,"No count, wier out due to high water",232,865
Bear River,2010,0,"No count, wier out due to high water",233,865
Bear River,2010,0,"No count, wier out due to high water",234,865
Bear River,2010,0,"No count, wier out due to high water",235,865
Bear River,2010,0,"No count, wier out due to high water",236,865
Bear River,2010,0,"No count, wier out due to high water",237,865
Bear River,2010,0,"No count, wier out due to high water",238,865
Bear River,2011,2,,189,2
Bear River,2011,1,,190,3
Bear River,2011,0,,191,3
Bear River,2011,0,,192,3
Bear River,2011,1,,193,4
Bear River,2011,0,,194,4
Bear River,2011,5,,195,9
Bear River,2011,0,,196,9
Bear River,2011,5,,197,14
Bear River,2011,4,,198,18
Bear River,2011,0,,199,18
Bear River,2011,2,,200,20
Bear River,2011,2,,201,22
Bear River,2011,2,,202,24
Bear River,2011,11,,203,35
Bear River,2011,18,,204,53
Bear River,2011,5,,205,58
Bear River,2011,7,,206,65
Bear River,2011,16,,207,81
Bear River,2011,12,,208,93
Bear River,2011,12,,209,105
Bear River,2011,20,,210,125
Bear River,2011,53,,211,178
Bear River,2011,31,,213,209
Bear River,2011,6,,214,215
Bear River,2011,2,,215,217
Bear River,2011,2,,216,219
Bear River,2011,37,,217,256
Bear River,2011,17,,218,273
Bear River,2011,15,,219,288
Bear River,2011,16,,220,304
Bear River,2011,16,,221,320
Bear River,2011,24,,222,344
Bear River,2011,24,,223,368
Bear River,2011,37,,224,405
Bear River,2011,87,,225,492
Bear River,2011,51,,226,543
Bear River,2011,35,,227,578
Bear River,2011,32,,228,610
Bear River,2011,67,,229,677
Bear River,2011,91,,230,768
Bear River,2011,38,,235,806
Bear River,2011,35,,236,841
Bear River,2011,56,,237,897
Bear River,2011,0,Wier pulled for season,238,897
Bear River,2012,7,,190,7
Bear River,2012,3,,191,10
Bear River,2012,4,,192,14
Bear River,2012,3,,193,17
Bear River,2012,7,,194,24
Bear River,2012,8,,195,32
Bear River,2012,11,,196,43
Bear River,2012,13,,197,56
Bear River,2012,26,,198,82
Bear River,2012,21,,199,103
Bear River,2012,12,,200,115
Bear River,2012,24,,201,139
Bear River,2012,47,,202,186
Bear River,2012,38,,203,224
Bear River,2012,28,,204,252
Bear River,2012,40,,205,292
Bear River,2012,36,,206,328
Bear River,2012,82,,207,410
Bear River,2012,93,,208,503
Bear River,2012,75,,209,578
Bear River,2012,90,,210,668
Bear River,2012,110,,211,778
Bear River,2012,58,,212,836
Bear River,2012,57,,213,893
Bear River,2012,52,,214,945
Bear River,2012,53,,215,998
Bear River,2012,22,,216,1020
Bear River,2012,21,,217,1041
Bear River,2012,2,,218,1043
Bear River,2012,34,,219,1077
Bear River,2012,17,,220,1094
Bear River,2012,13,,221,1107
Bear River,2012,19,,222,1126
Bear River,2012,18,,223,1144
Bear River,2012,14,,224,1158
Bear River,2012,20,,225,1178
Bear River,2012,20,,226,1198
Bear River,2012,6,,227,1204
Bear River,2012,6,,228,1210
Bear River,2012,20,,229,1230
Bear River,2012,12,,230,1242
Bear River,2012,10,,231,1252
Bear River,2012,6,,232,1258
Bear River,2012,2,,233,1260
Bear River,2012,8,,234,1268
Bear River,2012,17,,235,1285
Bear River,2012,10,,236,1295
Bear River,2012,6,,237,1301
Bear River,2012,0,Wier pulled for season,238,1301
Buskin River ,2006,1,,189,1
Buskin River ,2006,1,,190,2
Buskin River ,2006,0,,191,2
Buskin River ,2006,0,,192,2
Buskin River ,2006,0,,193,2
Buskin River ,2006,0,,194,2
Buskin River ,2006,0,,195,2
Buskin River ,2006,0,,196,2
Buskin River ,2006,0,,197,2
Buskin River ,2006,0,,198,2
Buskin River ,2006,0,,199,2
Buskin River ,2006,1,,200,3
Buskin River ,2006,5,,201,8
Buskin River ,2006,0,,202,8
Buskin River ,2006,0,Wier out,203,8
Buskin River ,2006,0,,204,8
Buskin River ,2006,0,,205,8
Buskin River ,2006,0,,206,8
Buskin River ,2006,1,,207,9
Buskin River ,2006,12,,208,21
Buskin River ,2006,87,,209,108
Buskin River ,2006,186,,210,294
Buskin River ,2006,29,,211,323
Buskin River ,2006,542,Wier moved from lake to bridge,212,865
Buskin River ,2006,1101,,213,1966
Buskin River ,2006,6882,,214,8848
Buskin River ,2006,1063,,215,9911
Buskin River ,2006,2899,,216,12810
Buskin River ,2006,6512,,217,19322
Buskin River ,2006,6048,,218,25370
Buskin River ,2006,8165,,219,33535
Buskin River ,2006,7708,,220,41243
Buskin River ,2006,9963,,221,51206
Buskin River ,2006,6915,,222,58121
Buskin River ,2006,7512,,223,65633
Buskin River ,2006,7355,,224,72988
Buskin River ,2006,4680,,225,77668
Buskin River ,2006,7407,,226,85075
Buskin River ,2006,5800,,227,90875
Buskin River ,2006,4042,,228,94917
Buskin River ,2006,4471,,229,99388
Buskin River ,2006,3704,,230,103092
Buskin River ,2006,4381,,231,107473
Buskin River ,2006,5930,,232,113403
Buskin River ,2006,2827,,233,116230
Buskin River ,2006,1587,,234,117817
Buskin River ,2006,1728,,235,119545
Buskin River ,2006,26076,,236,145621
Buskin River ,2006,2895,,237,148516
Buskin River ,2006,4607,,238,153123
Buskin River ,2006,3415,,239,156538
Buskin River ,2006,1324,,240,157862
Buskin River ,2006,2414,,241,160276
Buskin River ,2006,19068,,242,179344
Buskin River ,2006,6423,,243,185767
Buskin River ,2006,5163,,244,190930
Buskin River ,2006,2553,,245,193483
Buskin River ,2006,3658,,246,197141
Buskin River ,2006,3147,,247,200288
Buskin River ,2006,2530,,248,202818
Buskin River ,2006,4253,,249,207071
Buskin River ,2006,2104,,250,209175
Buskin River ,2006,2793,,251,211968
Buskin River ,2006,2338,,252,214306
Buskin River ,2006,2110,,253,216416
Buskin River ,2006,1421,,254,217837
Buskin River ,2006,545,,255,218382
Buskin River ,2006,757,,256,219139
Buskin River ,2006,969,"wier out, high water",257,220108
Buskin River ,2006,295,,259,220403
Buskin River ,2006,27,,263,220430
Buskin River ,2006,8,Wier out,264,220438
Buskin River ,2007,1,,188,1
Buskin River ,2007,0,,189,1
Buskin River ,2007,2,,190,3
Buskin River ,2007,0,,191,3
Buskin River ,2007,2,,192,5
Buskin River ,2007,4,,193,9
Buskin River ,2007,0,,194,9
Buskin River ,2007,0,,195,9
Buskin River ,2007,0,,196,9
Buskin River ,2007,2,,197,11
Buskin River ,2007,0,,198,11
Buskin River ,2007,1,,199,12
Buskin River ,2007,0,,200,12
Buskin River ,2007,1,,201,13
Buskin River ,2007,11,,202,24
Buskin River ,2007,43,,203,67
Buskin River ,2007,22,,204,89
Buskin River ,2007,7,,205,96
Buskin River ,2007,0,,206,96
Buskin River ,2007,0,,207,96
Buskin River ,2007,0,,208,96
Buskin River ,2007,12,,209,108
Buskin River ,2007,86,,210,194
Buskin River ,2007,22,,211,216
Buskin River ,2007,40,,212,256
Buskin River ,2007,6,,213,262
Buskin River ,2007,135,,214,397
Buskin River ,2007,9766,,215,10163
Buskin River ,2007,2905,,216,13068
Buskin River ,2007,4003,,217,17071
Buskin River ,2007,4956,,218,22027
Buskin River ,2007,3100,,219,25127
Buskin River ,2007,3781,,220,28908
Buskin River ,2007,4743,,221,33651
Buskin River ,2007,5766,,222,39417
Buskin River ,2007,3269,,223,42686
Buskin River ,2007,3882,,224,46568
Buskin River ,2007,2290,,225,48858
Buskin River ,2007,3435,,226,52293
Buskin River ,2007,1934,,227,54227
Buskin River ,2007,597,,228,54824
Buskin River ,2007,1112,,229,55936
Buskin River ,2007,3759,,230,59695
Buskin River ,2007,2282,,231,61977
Buskin River ,2007,457,,232,62434
Buskin River ,2007,849,,233,63283
Buskin River ,2007,533,,234,63816
Buskin River ,2007,900,,235,64716
Buskin River ,2007,815,,236,65531
Buskin River ,2007,1081,,237,66612
Buskin River ,2007,825,,238,67437
Buskin River ,2007,5004,,239,72441
Buskin River ,2007,0,"wier out, high water",240,72441
Buskin River ,2007,0,"wier out, high water",241,72441
Buskin River ,2007,1127,,242,73568
Buskin River ,2007,1702,,244,75270
Buskin River ,2007,534,,245,75804
Buskin River ,2007,1557,,246,77361
Buskin River ,2007,1912,,247,79273
Buskin River ,2007,1168,,248,80441
Buskin River ,2007,1211,,249,81652
Buskin River ,2007,763,,250,82415
Buskin River ,2007,1210,,251,83625
Buskin River ,2007,531,,252,84156
Buskin River ,2007,505,,253,84661
Buskin River ,2007,903,,254,85564
Buskin River ,2007,844,,255,86408
Buskin River ,2007,242,,256,86650
Buskin River ,2007,239,,257,86889
Buskin River ,2007,197,,258,87086
Buskin River ,2007,167,,259,87253
Buskin River ,2007,72,,260,87325
Buskin River ,2007,96,,261,87421
Buskin River ,2007,84,,262,87505
Buskin River ,2007,36,,263,87541
Buskin River ,2007,29,,264,87570
Buskin River ,2007,18,,265,87588
Buskin River ,2007,76,,266,87664
Buskin River ,2007,37,,267,87701
Buskin River ,2007,21,,268,87722
Buskin River ,2007,22,,269,87744
Buskin River ,2007,27,,270,87771
Buskin River ,2007,11,,271,87782
Buskin River ,2007,5,,272,87787
Buskin River ,2007,0,Wier closed,273,87787
Buskin River ,2008,17,,206,17
Buskin River ,2008,9,,207,26
Buskin River ,2008,5,,208,31
Buskin River ,2008,2,,209,33
Buskin River ,2008,1,,210,34
Buskin River ,2008,1887,River estimate included in count,211,1921
Buskin River ,2008,332,,212,2253
Buskin River ,2008,1520,,213,3773
Buskin River ,2008,1004,,214,4777
Buskin River ,2008,742,,215,5519
Buskin River ,2008,1376,,216,6895
Buskin River ,2008,1847,,217,8742
Buskin River ,2008,3047,,218,11789
Buskin River ,2008,1982,,219,13771
Buskin River ,2008,1164,,220,14935
Buskin River ,2008,1387,,221,16322
Buskin River ,2008,339,,222,16661
Buskin River ,2008,933,,223,17594
Buskin River ,2008,2932,,224,20526
Buskin River ,2008,2720,,225,23246
Buskin River ,2008,29,"Partial count, weir out, high water",226,23275
Buskin River ,2008,5843,,227,29118
Buskin River ,2008,758,,228,29876
Buskin River ,2008,1632,,229,31508
Buskin River ,2008,371,,230,31879
Buskin River ,2008,179,"Partial count, weir out, high water",231,32058
Buskin River ,2008,0,"No count, wier out",232,32058
Buskin River ,2008,0,,233,32058
Buskin River ,2008,312,,234,32370
Buskin River ,2008,154,,235,32524
Buskin River ,2008,791,,236,33315
Buskin River ,2008,294,,237,33609
Buskin River ,2008,497,,238,34106
Buskin River ,2008,356,,239,34462
Buskin River ,2008,411,,240,34873
Buskin River ,2008,347,,241,35220
Buskin River ,2008,372,,242,35592
Buskin River ,2008,538,,243,36130
Buskin River ,2008,2362,,244,38492
Buskin River ,2008,1848,,245,40340
Buskin River ,2008,820,,246,41160
Buskin River ,2008,568,,247,41728
Buskin River ,2008,342,,248,42070
Buskin River ,2008,201,,249,42271
Buskin River ,2008,72,"estimate, high water",250,42343
Buskin River ,2008,0,"estimate, high water",251,42343
Buskin River ,2008,0,"wier out, high water",252,42343
Buskin River ,2008,87,,253,42430
Buskin River ,2008,81,,254,42511
Buskin River ,2008,59,,255,42570
Buskin River ,2008,61,,256,42631
Buskin River ,2008,88,,257,42719
Buskin River ,2008,38,,258,42757
Buskin River ,2008,9,,259,42766
Buskin River ,2008,20,,260,42786
Buskin River ,2008,3,,261,42789
Buskin River ,2008,26,,262,42815
Buskin River ,2008,5,,263,42820
Buskin River ,2008,7,,264,42827
Buskin River ,2008,4,,265,42831
Buskin River ,2008,4,,266,42835
Buskin River ,2008,7,,267,42842
Buskin River ,2008,1,,268,42843
Buskin River ,2008,0,,269,42843
Buskin River ,2008,0,,270,42843
Buskin River ,2008,0,,271,42843
Buskin River ,2008,0,,272,42843
Buskin River ,2008,0,Wier closed,273,42843
Buskin River ,2009,4,,202,4
Buskin River ,2009,5,,203,9
Buskin River ,2009,1,,204,10
Buskin River ,2009,0,,205,10
Buskin River ,2009,14,,206,24
Buskin River ,2009,17,,207,41
Buskin River ,2009,11,,208,52
Buskin River ,2009,36,,209,88
Buskin River ,2009,80,,210,168
Buskin River ,2009,115,,211,283
Buskin River ,2009,720,,212,1003
Buskin River ,2009,220,,213,1223
Buskin River ,2009,8,,214,1231
Buskin River ,2009,7130,,215,8361
Buskin River ,2009,368,,216,8729
Buskin River ,2009,197,,217,8926
Buskin River ,2009,2088,,218,11014
Buskin River ,2009,11986,,219,23000
Buskin River ,2009,6919,,220,29919
Buskin River ,2009,7286,,221,37205
Buskin River ,2009,1819,,222,39024
Buskin River ,2009,4238,,223,43262
Buskin River ,2009,5300,,224,48562
Buskin River ,2009,1853,,225,50415
Buskin River ,2009,2213,,226,52628
Buskin River ,2009,2581,,227,55209
Buskin River ,2009,2154,,228,57363
Buskin River ,2009,2210,,229,59573
Buskin River ,2009,1871,,230,61444
Buskin River ,2009,2189,,231,63633
Buskin River ,2009,1308,,232,64941
Buskin River ,2009,1206,,233,66147
Buskin River ,2009,1025,,234,67172
Buskin River ,2009,1510,,235,68682
Buskin River ,2009,422,,236,69104
Buskin River ,2009,1171,,237,70275
Buskin River ,2009,2409,,238,72684
Buskin River ,2009,6958,,239,79642
Buskin River ,2009,0,"wier out, high water",240,79642
Buskin River ,2009,0,"wier out, high water",241,79642
Buskin River ,2009,626,,242,80268
Buskin River ,2009,1589,,243,81857
Buskin River ,2009,1107,,244,82964
Buskin River ,2009,1210,,245,84174
Buskin River ,2009,1662,,246,85836
Buskin River ,2009,1843,,247,87679
Buskin River ,2009,579,,248,88258
Buskin River ,2009,526,,249,88784
Buskin River ,2009,458,,250,89242
Buskin River ,2009,0,"wier out, high water",251,89242
Buskin River ,2009,0,"wier out, high water",252,89242
Buskin River ,2009,0,"wier out, high water",253,89242
Buskin River ,2009,0,"wier out, high water",254,89242
Buskin River ,2009,0,,255,89242
Buskin River ,2009,30,fish tight 11:00am,256,89272
Buskin River ,2009,34,,257,89306
Buskin River ,2009,79,,258,89385
Buskin River ,2010,1,,198,1
Buskin River ,2010,0,,199,1
Buskin River ,2010,0,,200,1
Buskin River ,2010,0,,201,1
Buskin River ,2010,0,,202,1
Buskin River ,2010,23,,203,24
Buskin River ,2010,1,,204,25
Buskin River ,2010,0,,205,25
Buskin River ,2010,0,,206,25
Buskin River ,2010,35,ESTIMATE,207,60
Buskin River ,2010,7,,208,67
Buskin River ,2010,0,,209,67
Buskin River ,2010,1,,210,68
Buskin River ,2010,52,,211,120
Buskin River ,2010,517,,212,637
Buskin River ,2010,289,,213,926
Buskin River ,2010,452,,214,1378
Buskin River ,2010,119,,215,1497
Buskin River ,2010,145,,216,1642
Buskin River ,2010,240,,217,1882
Buskin River ,2010,268,,218,2150
Buskin River ,2010,670,,219,2820
Buskin River ,2010,142,,220,2962
Buskin River ,2010,774,,221,3736
Buskin River ,2010,1175,,222,4911
Buskin River ,2010,295,,223,5206
Buskin River ,2010,274,,224,5480
Buskin River ,2010,295,,225,5775
Buskin River ,2010,301,,226,6076
Buskin River ,2010,0,"No count, wier out due to high water",227,6076
Buskin River ,2010,0,"No count, wier out due to high water",228,6076
Buskin River ,2010,171,,229,6247
Buskin River ,2010,137,,230,6384
Buskin River ,2010,112,,231,6496
Buskin River ,2010,50,,232,6546
Buskin River ,2010,71,,233,6617
Buskin River ,2010,260,,234,6877
Buskin River ,2010,50,,235,6927
Buskin River ,2010,240,,236,7167
Buskin River ,2010,195,,237,7362
Buskin River ,2010,356,,238,7718
Buskin River ,2010,261,,239,7979
Buskin River ,2010,388,,240,8367
Buskin River ,2010,498,,241,8865
Buskin River ,2010,635,,242,9500
Buskin River ,2010,1053,,243,10553
Buskin River ,2010,881,,244,11434
Buskin River ,2010,715,,245,12149
Buskin River ,2010,506,,246,12655
Buskin River ,2010,1732,,247,14387
Buskin River ,2010,617,,248,15004
Buskin River ,2010,154,,249,15158
Buskin River ,2010,238,,250,15396
Buskin River ,2010,75,,251,15471
Buskin River ,2010,173,,252,15644
Buskin River ,2010,37,,253,15681
Buskin River ,2010,32,,254,15713
Buskin River ,2010,18,,255,15731
Buskin River ,2010,7,,256,15738
Buskin River ,2010,22,,257,15760
Buskin River ,2010,3,,258,15763
Buskin River ,2010,8,,259,15771
Buskin River ,2010,0,,260,15771
Buskin River ,2010,3,,261,15774
Buskin River ,2010,5,,262,15779
Buskin River ,2010,0,,263,15779
Buskin River ,2010,0,,264,15779
Buskin River ,2010,0,,265,15779
Buskin River ,2010,0,,266,15779
Buskin River ,2010,2,,267,15781
Buskin River ,2010,0,,268,15781
Buskin River ,2010,0,,269,15781
Buskin River ,2010,0,,270,15781
Buskin River ,2010,0,,271,15781
Buskin River ,2010,0,,272,15781
Buskin River ,2011,1,,197,1
Buskin River ,2011,0,,198,1
Buskin River ,2011,0,,199,1
Buskin River ,2011,1,,200,2
Buskin River ,2011,0,,201,2
Buskin River ,2011,0,,202,2
Buskin River ,2011,3,,203,5
Buskin River ,2011,0,,204,5
Buskin River ,2011,0,,205,5
Buskin River ,2011,2,,206,7
Buskin River ,2011,3,,207,10
Buskin River ,2011,1,,208,11
Buskin River ,2011,1,,209,12
Buskin River ,2011,0,,210,12
Buskin River ,2011,2,,211,14
Buskin River ,2011,5,,212,19
Buskin River ,2011,13,,213,32
Buskin River ,2011,34,,214,66
Buskin River ,2011,11,,215,77
Buskin River ,2011,11,,216,88
Buskin River ,2011,14,,217,102
Buskin River ,2011,3,,218,105
Buskin River ,2011,1,,219,106
Buskin River ,2011,17,,220,123
Buskin River ,2011,7,,221,130
Buskin River ,2011,12,,222,142
Buskin River ,2011,4,,223,146
Buskin River ,2011,8,,224,154
Buskin River ,2011,9,,225,163
Buskin River ,2011,78,,226,241
Buskin River ,2011,36,,227,277
Buskin River ,2011,32,,228,309
Buskin River ,2011,49,,229,358
Buskin River ,2011,4024,,230,4382
Buskin River ,2011,511,,231,4893
Buskin River ,2011,232,,232,5125
Buskin River ,2011,52,,233,5177
Buskin River ,2011,198,,234,5375
Buskin River ,2011,75,,235,5450
Buskin River ,2011,83,,236,5533
Buskin River ,2011,1415,,237,6948
Buskin River ,2011,916,,238,7864
Buskin River ,2011,163,,239,8027
Buskin River ,2011,469,,240,8496
Buskin River ,2011,78,,241,8574
Buskin River ,2011,190,,242,8764
Buskin River ,2011,128,,243,8892
Buskin River ,2011,183,,244,9075
Buskin River ,2011,4,"estimate, high water",245,9079
Buskin River ,2011,7,"estimate, high water",246,9086
Buskin River ,2011,123,"estimate, high water",247,9209
Buskin River ,2011,9,"estimate, high water",248,9218
Buskin River ,2011,0,"estimate, high water",249,9218
Buskin River ,2011,141,"estimate, high water",250,9359
Buskin River ,2011,70,"estimate, high water",251,9429
Buskin River ,2011,48,,252,9477
Buskin River ,2011,55,,253,9532
Buskin River ,2011,22,,254,9554
Buskin River ,2011,0,"estimate, high water",255,9554
Buskin River ,2011,0,"estimate, high water",256,9554
Buskin River ,2011,18,"estimate, high water",257,9572
Buskin River ,2011,0,,258,9572
Buskin River ,2011,0,Wier pulled for season,259,9572
Buskin River ,2012,1,,187,1
Buskin River ,2012,0,,188,1
Buskin River ,2012,0,,189,1
Buskin River ,2012,0,,190,1
Buskin River ,2012,0,,191,1
Buskin River ,2012,0,,192,1
Buskin River ,2012,0,,193,1
Buskin River ,2012,0,,194,1
Buskin River ,2012,0,,195,1
Buskin River ,2012,0,,196,1
Buskin River ,2012,0,,197,1
Buskin River ,2012,2,,198,3
Buskin River ,2012,1,,199,4
Buskin River ,2012,2,,200,6
Buskin River ,2012,3,,201,9
Buskin River ,2012,11,,202,20
Buskin River ,2012,0,,203,20
Buskin River ,2012,3,,204,23
Buskin River ,2012,114,,205,137
Buskin River ,2012,89,,206,226
Buskin River ,2012,70,,207,296
Buskin River ,2012,105,,208,401
Buskin River ,2012,159,,209,560
Buskin River ,2012,197,,210,757
Buskin River ,2012,26,,211,783
Buskin River ,2012,56,,212,839
Buskin River ,2012,83,,213,922
Buskin River ,2012,8,,214,930
Buskin River ,2012,12,,215,942
Buskin River ,2012,28,,216,970
Buskin River ,2012,75,,217,1045
Buskin River ,2012,142,,218,1187
Buskin River ,2012,59,,219,1246
Buskin River ,2012,34,,220,1280
Buskin River ,2012,21,,221,1301
Buskin River ,2012,69,,222,1370
Buskin River ,2012,1408,,223,2778
Buskin River ,2012,811,,224,3589
Buskin River ,2012,811,,225,4400
Buskin River ,2012,42,,226,4442
Buskin River ,2012,785,,227,5227
Buskin River ,2012,57602,,228,62829
Buskin River ,2012,151,,229,62980
Buskin River ,2012,339,,230,63319
Buskin River ,2012,46,,231,63365
Buskin River ,2012,736,,232,64101
Buskin River ,2012,230,,233,64331
Buskin River ,2012,99,,234,64430
Buskin River ,2012,51,,235,64481
Buskin River ,2012,20,,236,64501
Buskin River ,2012,100,,237,64601
Buskin River ,2012,70,,238,64671
Buskin River ,2012,207,,239,64878
Buskin River ,2012,361,,240,65239
Buskin River ,2012,373,,241,65612
Buskin River ,2012,451,,242,66063
Buskin River ,2012,2044,,243,68107
Buskin River ,2012,522,,244,68629
Buskin River ,2012,921,,245,69550
Buskin River ,2012,167,,246,69717
Buskin River ,2012,989,,247,70706
Buskin River ,2012,903,,248,71609
Buskin River ,2012,597,,249,72206
Buskin River ,2012,425,,250,72631
Buskin River ,2012,381,,251,73012
Buskin River ,2012,245,,252,73257
Buskin River ,2012,533,,253,73790
Buskin River ,2012,376,,254,74166
Buskin River ,2012,1739,,255,75905
Buskin River ,2012,840,,256,76745
Buskin River ,2012,75,,257,76820
Buskin River ,2012,101,,258,76921
Buskin River ,2012,1538,,259,78459
Buskin River ,2012,195,,260,78654
Buskin River ,2012,63,,261,78717
Buskin River ,2012,154,,262,78871
Buskin River ,2012,193,,263,79064
Buskin River ,2012,48,,264,79112
Buskin River ,2012,12,,265,79124
Buskin River ,2012,0,,266,79124
Buskin River ,2012,0,,267,79124
Buskin River ,2012,0,,268,79124
Buskin River ,2012,0,"no count, high water",269,79124
Chignik River,2006,12,,171,12
Chignik River,2006,12,,172,24
Chignik River,2006,0,,173,24
Chignik River,2006,0,,174,24
Chignik River,2006,0,,175,24
Chignik River,2006,60,,176,84
Chignik River,2006,6,,177,90
Chignik River,2006,18,,178,108
Chignik River,2006,36,,179,144
Chignik River,2006,0,,180,144
Chignik River,2006,0,,181,144
Chignik River,2006,0,,182,144
Chignik River,2006,0,,183,144
Chignik River,2006,0,,184,144
Chignik River,2006,0,,185,144
Chignik River,2006,0,,186,144
Chignik River,2006,0,,187,144
Chignik River,2006,0,,188,144
Chignik River,2006,0,,189,144
Chignik River,2006,0,,190,144
Chignik River,2006,0,,191,144
Chignik River,2006,0,,192,144
Chignik River,2006,0,,193,144
Chignik River,2006,0,,194,144
Chignik River,2006,0,,195,144
Chignik River,2006,0,,196,144
Chignik River,2006,0,,197,144
Chignik River,2006,0,,198,144
Chignik River,2006,0,,199,144
Chignik River,2006,12,,200,156
Chignik River,2006,0,,201,156
Chignik River,2006,0,,202,156
Chignik River,2006,0,,203,156
Chignik River,2006,0,,204,156
Chignik River,2006,12,,205,168
Chignik River,2006,24,,206,192
Chignik River,2006,6,,207,198
Chignik River,2006,31,,208,229
Chignik River,2006,1,,209,230
Chignik River,2006,42,,210,272
Chignik River,2006,6,,211,278
Chignik River,2006,25,,212,303
Chignik River,2006,42,,213,345
Chignik River,2006,55,,214,400
Chignik River,2006,84,,215,484
Chignik River,2006,174,,216,658
Chignik River,2006,71,,217,729
Chignik River,2006,69,,218,798
Chignik River,2006,24,,219,822
Chignik River,2006,33,,220,855
Chignik River,2006,67,,221,922
Chignik River,2006,25,,222,947
Chignik River,2006,186,,223,1133
Chignik River,2006,379,,224,1512
Chignik River,2006,94,,225,1606
Chignik River,2006,363,,226,1969
Chignik River,2006,238,,227,2207
Chignik River,2006,131,,228,2338
Chignik River,2006,961,,229,3299
Chignik River,2006,780,,230,4079
Chignik River,2006,783,,231,4862
Chignik River,2006,2524,,232,7386
Chignik River,2006,1140,,233,8526
Chignik River,2006,378,,234,8904
Chignik River,2006,224,,235,9128
Chignik River,2006,3272,,236,12400
Chignik River,2006,422,,237,12822
Chignik River,2006,1079,,238,13901
Chignik River,2006,514,,239,14415
Chignik River,2006,307,,240,14722
Chignik River,2006,384,,241,15106
Chignik River,2006,586,,242,15692
Chignik River,2006,567,,243,16259
Chignik River,2006,629,,244,16888
Chignik River,2006,231,,245,17119
Chignik River,2006,384,,246,17503
Chignik River,2006,304,,247,17807
Chignik River,2006,0,Wier closed,248,17807
Chignik River,2007,18,,170,18
Chignik River,2007,0,,171,18
Chignik River,2007,0,,172,18
Chignik River,2007,6,,173,24
Chignik River,2007,0,,174,24
Chignik River,2007,6,,175,30
Chignik River,2007,0,,176,30
Chignik River,2007,0,,177,30
Chignik River,2007,6,,178,36
Chignik River,2007,5,,179,41
Chignik River,2007,18,,180,59
Chignik River,2007,6,,181,65
Chignik River,2007,0,,182,65
Chignik River,2007,12,,183,77
Chignik River,2007,12,,184,89
Chignik River,2007,18,,185,107
Chignik River,2007,0,,186,107
Chignik River,2007,6,,187,113
Chignik River,2007,12,,188,125
Chignik River,2007,12,,189,137
Chignik River,2007,6,,190,143
Chignik River,2007,18,,191,161
Chignik River,2007,18,,192,179
Chignik River,2007,48,,193,227
Chignik River,2007,18,,194,245
Chignik River,2007,7,,195,252
Chignik River,2007,7,,196,259
Chignik River,2007,25,,197,284
Chignik River,2007,24,,198,308
Chignik River,2007,54,,199,362
Chignik River,2007,44,,200,406
Chignik River,2007,66,,201,472
Chignik River,2007,54,,202,526
Chignik River,2007,24,,203,550
Chignik River,2007,63,,204,613
Chignik River,2007,149,,205,762
Chignik River,2007,32,,206,794
Chignik River,2007,138,,207,932
Chignik River,2007,74,,208,1006
Chignik River,2007,131,,209,1137
Chignik River,2007,60,,210,1197
Chignik River,2007,31,,211,1228
Chignik River,2007,91,,212,1319
Chignik River,2007,121,,213,1440
Chignik River,2007,100,,214,1540
Chignik River,2007,55,,215,1595
Chignik River,2007,162,,216,1757
Chignik River,2007,126,,217,1883
Chignik River,2007,174,,218,2057
Chignik River,2007,162,,219,2219
Chignik River,2007,160,,220,2379
Chignik River,2007,132,,221,2511
Chignik River,2007,146,,222,2657
Chignik River,2007,216,,223,2873
Chignik River,2007,163,,224,3036
Chignik River,2007,242,,225,3278
Chignik River,2007,364,,226,3642
Chignik River,2007,400,,227,4042
Chignik River,2007,636,,228,4678
Chignik River,2007,1404,,229,6082
Chignik River,2007,1092,,230,7174
Chignik River,2007,2330,,231,9504
Chignik River,2007,612,,232,10116
Chignik River,2007,744,,233,10860
Chignik River,2007,430,,234,11290
Chignik River,2007,384,,235,11674
Chignik River,2007,601,,236,12275
Chignik River,2007,972,,237,13247
Chignik River,2007,2720,,238,15967
Chignik River,2007,1057,,239,17024
Chignik River,2007,684,,240,17708
Chignik River,2007,666,,241,18374
Chignik River,2007,708,,242,19082
Chignik River,2007,376,,244,19458
Chignik River,2007,312,,245,19770
Chignik River,2007,376,,246,20146
Chignik River,2008,6,,186,6
Chignik River,2008,12,,187,18
Chignik River,2008,6,,188,24
Chignik River,2008,0,,189,24
Chignik River,2008,0,,190,24
Chignik River,2008,0,,191,24
Chignik River,2008,6,,192,30
Chignik River,2008,0,,193,30
Chignik River,2008,12,,194,42
Chignik River,2008,18,,195,60
Chignik River,2008,12,,196,72
Chignik River,2008,6,,197,78
Chignik River,2008,12,,198,90
Chignik River,2008,30,,199,120
Chignik River,2008,0,,200,120
Chignik River,2008,6,,201,126
Chignik River,2008,18,,202,144
Chignik River,2008,0,,203,144
Chignik River,2008,12,,204,156
Chignik River,2008,36,,205,192
Chignik River,2008,41,,206,233
Chignik River,2008,108,,207,341
Chignik River,2008,318,,208,659
Chignik River,2008,264,,209,923
Chignik River,2008,324,,210,1247
Chignik River,2008,192,,211,1439
Chignik River,2008,48,,212,1487
Chignik River,2008,186,,213,1673
Chignik River,2008,402,,214,2075
Chignik River,2008,636,,215,2711
Chignik River,2008,354,,216,3065
Chignik River,2008,306,,217,3371
Chignik River,2008,400,,218,3771
Chignik River,2008,489,,219,4260
Chignik River,2008,456,,220,4716
Chignik River,2008,342,,221,5058
Chignik River,2008,537,,222,5595
Chignik River,2008,558,,223,6153
Chignik River,2008,1598,,224,7751
Chignik River,2008,2460,,225,10211
Chignik River,2008,3588,,226,13799
Chignik River,2008,1230,,227,15029
Chignik River,2008,307,,228,15336
Chignik River,2008,851,,229,16187
Chignik River,2008,991,,230,17178
Chignik River,2008,3338,,231,20516
Chignik River,2008,889,,232,21405
Chignik River,2008,292,,233,21697
Chignik River,2008,300,,234,21997
Chignik River,2008,196,,235,22193
Chignik River,2008,130,,236,22323
Chignik River,2008,0,,237,22323
Chignik River,2008,0,,238,22323
Chignik River,2008,0,,239,22323
Chignik River,2008,0,,240,22323
Chignik River,2008,0,,241,22323
Chignik River,2008,0,,242,22323
Chignik River,2008,0,,243,22323
Chignik River,2008,0,,244,22323
Chignik River,2008,0,,245,22323
Chignik River,2008,0,,246,22323
Chignik River,2008,0,Wier closed,247,22323
Chignik River,2009,8,,179,8
Chignik River,2009,12,,180,20
Chignik River,2009,0,,181,20
Chignik River,2009,6,,182,26
Chignik River,2009,6,,183,32
Chignik River,2009,6,,184,38
Chignik River,2009,36,,185,74
Chignik River,2009,36,,186,110
Chignik River,2009,6,,187,116
Chignik River,2009,49,,188,165
Chignik River,2009,36,,189,201
Chignik River,2009,72,,190,273
Chignik River,2009,78,,191,351
Chignik River,2009,96,,192,447
Chignik River,2009,54,,193,501
Chignik River,2009,24,,194,525
Chignik River,2009,96,,195,621
Chignik River,2009,168,,196,789
Chignik River,2009,132,,197,921
Chignik River,2009,408,,198,1329
Chignik River,2009,620,,199,1949
Chignik River,2009,932,,200,2881
Chignik River,2009,390,,201,3271
Chignik River,2009,471,,202,3742
Chignik River,2009,299,,203,4041
Chignik River,2009,232,,204,4273
Chignik River,2009,296,,205,4569
Chignik River,2009,526,,206,5095
Chignik River,2009,379,,207,5474
Chignik River,2009,311,,208,5785
Chignik River,2009,394,,209,6179
Chignik River,2009,516,,210,6695
Chignik River,2009,455,,211,7150
Chignik River,2009,358,,212,7508
Chignik River,2009,361,,213,7869
Chignik River,2009,481,,214,8350
Chignik River,2009,507,,215,8857
Chignik River,2009,333,,216,9190
Chignik River,2009,219,,217,9409
Chignik River,2009,75,,218,9484
Chignik River,2009,2,,219,9486
Chignik River,2009,84,,220,9570
Chignik River,2009,67,,221,9637
Chignik River,2009,54,,222,9691
Chignik River,2009,110,,223,9801
Chignik River,2009,156,,224,9957
Chignik River,2009,101,,225,10058
Chignik River,2009,61,,226,10119
Chignik River,2009,30,,227,10149
Chignik River,2009,75,,228,10224
Chignik River,2009,133,,229,10357
Chignik River,2009,162,,230,10519
Chignik River,2009,66,,231,10585
Chignik River,2009,165,,232,10750
Chignik River,2009,152,,233,10902
Chignik River,2009,139,,234,11041
Chignik River,2009,138,,235,11179
Chignik River,2009,166,,236,11345
Chignik River,2009,172,,237,11517
Chignik River,2009,156,,238,11673
Chignik River,2009,241,,239,11914
Chignik River,2009,249,,240,12163
Chignik River,2009,116,,241,12279
Chignik River,2009,347,,242,12626
Chignik River,2009,252,"last count, wier closed",243,12878
Chignik River,2010,6,,182,6
Chignik River,2010,0,,183,6
Chignik River,2010,0,,184,6
Chignik River,2010,0,,185,6
Chignik River,2010,0,,186,6
Chignik River,2010,0,,187,6
Chignik River,2010,0,,188,6
Chignik River,2010,0,,189,6
Chignik River,2010,6,,190,12
Chignik River,2010,30,,191,42
Chignik River,2010,30,,192,72
Chignik River,2010,24,,193,96
Chignik River,2010,6,,194,102
Chignik River,2010,0,,195,102
Chignik River,2010,6,,196,108
Chignik River,2010,18,,197,126
Chignik River,2010,6,,198,132
Chignik River,2010,0,,199,132
Chignik River,2010,0,,200,132
Chignik River,2010,42,,201,174
Chignik River,2010,54,,202,228
Chignik River,2010,12,,203,240
Chignik River,2010,0,,204,240
Chignik River,2010,48,,205,288
Chignik River,2010,78,,206,366
Chignik River,2010,30,,207,396
Chignik River,2010,67,,208,463
Chignik River,2010,54,,209,517
Chignik River,2010,30,,210,547
Chignik River,2010,108,,211,655
Chignik River,2010,24,,212,679
Chignik River,2010,24,,213,703
Chignik River,2010,12,,214,715
Chignik River,2010,25,,215,740
Chignik River,2010,24,,216,764
Chignik River,2010,42,,217,806
Chignik River,2010,12,,218,818
Chignik River,2010,77,,219,895
Chignik River,2010,134,,220,1029
Chignik River,2010,211,,221,1240
Chignik River,2010,132,,222,1372
Chignik River,2010,135,,223,1507
Chignik River,2010,168,,224,1675
Chignik River,2010,9,,225,1684
Chignik River,2010,346,,226,2030
Chignik River,2010,471,,227,2501
Chignik River,2010,264,,228,2765
Chignik River,2010,96,,229,2861
Chignik River,2010,103,,230,2964
Chignik River,2010,78,,231,3042
Chignik River,2010,12,,232,3054
Chignik River,2010,12,,233,3066
Chignik River,2010,12,,234,3078
Chignik River,2010,24,,235,3102
Chignik River,2010,42,,236,3144
Chignik River,2010,158,,237,3302
Chignik River,2010,72,,238,3374
Chignik River,2010,144,,239,3518
Chignik River,2010,36,,240,3554
Chignik River,2010,78,,241,3632
Chignik River,2010,20,,242,3652
Chignik River,2010,48,,243,3700
Chignik River,2010,0,,244,3700
Chignik River,2010,0,Wier closed,245,3700
Chignik River,2011,30,,182,30
Chignik River,2011,157,,183,187
Chignik River,2011,66,,184,253
Chignik River,2011,30,,185,283
Chignik River,2011,18,,186,301
Chignik River,2011,84,,187,385
Chignik River,2011,234,,188,619
Chignik River,2011,150,,189,769
Chignik River,2011,12,,190,781
Chignik River,2011,49,,191,830
Chignik River,2011,30,,192,860
Chignik River,2011,79,,193,939
Chignik River,2011,108,,194,1047
Chignik River,2011,859,,195,1906
Chignik River,2011,210,,196,2116
Chignik River,2011,36,,197,2152
Chignik River,2011,120,,198,2272
Chignik River,2011,144,,199,2416
Chignik River,2011,48,,200,2464
Chignik River,2011,327,,201,2791
Chignik River,2011,253,,202,3044
Chignik River,2011,1156,,203,4200
Chignik River,2011,508,,204,4708
Chignik River,2011,560,,205,5268
Chignik River,2011,580,,206,5848
Chignik River,2011,446,,207,6294
Chignik River,2011,833,,208,7127
Chignik River,2011,956,,209,8083
Chignik River,2011,1115,,210,9198
Chignik River,2011,879,,211,10077
Chignik River,2011,397,,212,10474
Chignik River,2011,300,,213,10774
Chignik River,2011,737,,214,11511
Chignik River,2011,414,,215,11925
Chignik River,2011,150,,216,12075
Chignik River,2011,400,,217,12475
Chignik River,2011,229,,218,12704
Chignik River,2011,103,,219,12807
Chignik River,2011,193,,220,13000
Chignik River,2011,161,,221,13161
Chignik River,2011,283,,222,13444
Chignik River,2011,84,,223,13528
Chignik River,2011,143,,224,13671
Chignik River,2011,190,,225,13861
Chignik River,2011,178,,226,14039
Chignik River,2011,91,,227,14130
Chignik River,2011,32,,228,14162
Chignik River,2011,104,,229,14266
Chignik River,2011,8,,230,14274
Chignik River,2011,73,,231,14347
Chignik River,2011,36,,232,14383
Chignik River,2011,10,,233,14393
Chignik River,2011,114,,234,14507
Chignik River,2011,9,,235,14516
Chignik River,2011,36,,236,14552
Chignik River,2011,5,,237,14557
Chignik River,2011,192,,238,14749
Chignik River,2011,504,,239,15253
Chignik River,2011,277,,240,15530
Chignik River,2011,150,,241,15680
Chignik River,2011,183,,242,15863
Chignik River,2011,219,,243,16082
Chignik River,2011,156,,244,16238
Chignik River,2011,60,,245,16298
Chignik River,2012,24,,195,24
Chignik River,2012,0,,196,24
Chignik River,2012,6,,197,30
Chignik River,2012,6,,198,36
Chignik River,2012,18,,199,54
Chignik River,2012,12,,200,66
Chignik River,2012,6,,201,72
Chignik River,2012,0,,202,72
Chignik River,2012,0,,203,72
Chignik River,2012,0,,204,72
Chignik River,2012,0,,205,72
Chignik River,2012,0,,206,72
Chignik River,2012,0,,207,72
Chignik River,2012,6,,208,78
Chignik River,2012,42,,209,120
Chignik River,2012,18,,210,138
Chignik River,2012,12,,211,150
Chignik River,2012,81,,212,231
Chignik River,2012,24,,213,255
Chignik River,2012,6,,214,261
Chignik River,2012,7,,215,268
Chignik River,2012,12,,216,280
Chignik River,2012,10,,217,290
Chignik River,2012,30,,218,320
Chignik River,2012,7,,219,327
Chignik River,2012,24,,220,351
Chignik River,2012,6,,221,357
Chignik River,2012,12,,222,369
Chignik River,2012,6,,223,375
Chignik River,2012,13,,224,388
Chignik River,2012,49,,225,437
Chignik River,2012,156,,226,593
Chignik River,2012,369,,227,962
Chignik River,2012,240,,228,1202
Chignik River,2012,96,,229,1298
Chignik River,2012,24,,230,1322
Chignik River,2012,64,,231,1386
Chignik River,2012,48,,232,1434
Chignik River,2012,31,,233,1465
Chignik River,2012,102,,234,1567
Chignik River,2012,72,,235,1639
Chignik River,2012,185,,236,1824
Chignik River,2012,162,,237,1986
Chignik River,2012,216,,238,2202
Chignik River,2012,136,,239,2338
Chignik River,2012,175,,240,2513
Chignik River,2012,240,,241,2753
Chignik River,2012,96,,242,2849
Deshka,1996,0,,144,0
Deshka,1996,0,,145,0
Deshka,1996,0,,146,0
Deshka,1996,0,,147,0
Deshka,1996,0,,148,0
Deshka,1996,0,,149,0
Deshka,1996,0,,150,0
Deshka,1996,0,,151,0
Deshka,1996,0,,152,0
Deshka,1996,0,,153,0
Deshka,1996,0,,154,0
Deshka,1996,0,,155,0
Deshka,1996,0,,156,0
Deshka,1996,0,,157,0
Deshka,1996,0,,158,0
Deshka,1996,0,,159,0
Deshka,1996,0,,160,0
Deshka,1996,0,,161,0
Deshka,1996,0,,162,0
Deshka,1996,0,,163,0
Deshka,1996,0,,164,0
Deshka,1996,0,,165,0
Deshka,1996,0,,166,0
Deshka,1996,0,,167,0
Deshka,1996,0,,168,0
Deshka,1996,0,,169,0
Deshka,1996,0,,170,0
Deshka,1996,0,,171,0
Deshka,1996,0,,172,0
Deshka,1996,0,,173,0
Deshka,1996,0,,174,0
Deshka,1996,0,,175,0
Deshka,1996,0,,176,0
Deshka,1996,0,,177,0
Deshka,1996,0,,178,0
Deshka,1996,0,,179,0
Deshka,1996,0,,180,0
Deshka,1996,0,,181,0
Deshka,1996,0,,182,0
Deshka,1996,0,,183,0
Deshka,1996,0,,184,0
Deshka,1996,0,,185,0
Deshka,1996,0,,186,0
Deshka,1996,0,,187,0
Deshka,1996,0,,188,0
Deshka,1996,0,,189,0
Deshka,1996,0,,190,0
Deshka,1996,0,,191,0
Deshka,1996,0,,192,0
Deshka,1996,0,,193,0
Deshka,1996,0,,194,0
Deshka,1996,0,,195,0
Deshka,1996,0,,196,0
Deshka,1996,0,,197,0
Deshka,1996,0,,198,0
Deshka,1996,2,,199,2
Deshka,1996,4,,200,6
Deshka,1996,7,,201,13
Deshka,1996,199,,202,212
Deshka,1996,840,,203,1052
Deshka,1996,630,,204,1682
Deshka,1996,2677,,205,4359
Deshka,1996,5298,,206,9657
Deshka,1996,8869,,207,18526
Deshka,1996,12818,,208,31344
Deshka,1996,6122,,209,37466
Deshka,1996,16,,210,37482
Deshka,1997,0,,146,0
Deshka,1997,0,,147,0
Deshka,1997,0,,148,0
Deshka,1997,0,,149,0
Deshka,1997,0,,150,0
Deshka,1997,0,,151,0
Deshka,1997,0,,152,0
Deshka,1997,0,,153,0
Deshka,1997,0,,154,0
Deshka,1997,0,,155,0
Deshka,1997,0,,156,0
Deshka,1997,0,,157,0
Deshka,1997,0,,158,0
Deshka,1997,0,,159,0
Deshka,1997,0,,160,0
Deshka,1997,0,,161,0
Deshka,1997,0,,162,0
Deshka,1997,0,,163,0
Deshka,1997,0,,164,0
Deshka,1997,0,,165,0
Deshka,1997,0,,166,0
Deshka,1997,0,,167,0
Deshka,1997,0,,168,0
Deshka,1997,0,,169,0
Deshka,1997,0,,170,0
Deshka,1997,0,,171,0
Deshka,1997,0,,172,0
Deshka,1997,0,,173,0
Deshka,1997,0,,174,0
Deshka,1997,0,,175,0
Deshka,1997,0,,176,0
Deshka,1997,0,,177,0
Deshka,1997,0,,178,0
Deshka,1997,0,,179,0
Deshka,1997,0,,180,0
Deshka,1997,0,,181,0
Deshka,1997,0,,182,0
Deshka,1997,0,,183,0
Deshka,1997,0,,184,0
Deshka,1997,0,,185,0
Deshka,1997,0,,186,0
Deshka,1997,0,,187,0
Deshka,1997,0,,188,0
Deshka,1997,0,,189,0
Deshka,1997,0,,190,0
Deshka,1997,1,,191,1
Deshka,1997,0,,192,1
Deshka,1997,0,,193,1
Deshka,1997,0,,194,1
Deshka,1997,0,,195,1
Deshka,1997,0,,196,1
Deshka,1997,0,,197,1
Deshka,1997,0,,198,1
Deshka,1997,0,,199,1
Deshka,1997,0,,200,1
Deshka,1997,0,,201,1
Deshka,1997,1,,202,2
Deshka,1997,0,,203,2
Deshka,1997,1,,204,3
Deshka,1997,7,,205,10
Deshka,1997,32,,206,42
Deshka,1997,4,,207,46
Deshka,1997,3,,208,49
Deshka,1997,4,,209,53
Deshka,1997,10,,210,63
Deshka,1997,8,,211,71
Deshka,1997,0,,212,71
Deshka,1997,0,,213,71
Deshka,1997,25,,214,96
Deshka,1997,14,,215,110
Deshka,1997,5,,216,115
Deshka,1997,9,,217,124
Deshka,1997,9,,218,133
Deshka,1997,6,,219,139
Deshka,1997,8,,220,147
Deshka,1997,8,,221,155
Deshka,1997,164,,222,319
Deshka,1997,95,,223,414
Deshka,1997,138,,224,552
Deshka,1997,69,,225,621
Deshka,1997,123,,226,744
Deshka,1997,97,,227,841
Deshka,1997,51,,228,892
Deshka,1997,55,,229,947
Deshka,1997,41,,230,988
Deshka,1997,31,,231,1019
Deshka,1997,23,,232,1042
Deshka,1997,10,,233,1052
Deshka,1997,37,,234,1089
Deshka,1997,1,,235,1090
Deshka,1997,2,,236,1092
Deshka,1997,0,,237,1092
Deshka,1997,4,,238,1096
Deshka,1997,0,,239,1096
Deshka,1997,2,,240,1098
Deshka,1997,1,,241,1099
Deshka,1997,1,,242,1100
Deshka,1997,0,,243,1100
Deshka,1997,1,,244,1101
Deshka,1997,0,,245,1101
Deshka,1997,0,,246,1101
Deshka,1997,0,,247,1101
Deshka,1997,0,,248,1101
Deshka,1997,0,,249,1101
Deshka,1997,0,,250,1101
Deshka,1997,0,,251,1101
Deshka,1998,0,,165,0
Deshka,1998,0,,166,0
Deshka,1998,0,,167,0
Deshka,1998,0,,168,0
Deshka,1998,0,,169,0
Deshka,1998,0,,170,0
Deshka,1998,0,,171,0
Deshka,1998,0,,172,0
Deshka,1998,0,,173,0
Deshka,1998,0,,174,0
Deshka,1998,0,,175,0
Deshka,1998,0,,176,0
Deshka,1998,0,,177,0
Deshka,1998,0,,178,0
Deshka,1998,0,,179,0
Deshka,1998,0,,180,0
Deshka,1998,0,,181,0
Deshka,1998,0,,182,0
Deshka,1998,0,,183,0
Deshka,1998,0,,184,0
Deshka,1998,0,,185,0
Deshka,1998,0,,186,0
Deshka,1998,6,,187,6
Deshka,1998,0,,188,6
Deshka,1998,0,,189,6
Deshka,1998,0,,190,6
Deshka,1998,1,,191,7
Deshka,1998,1,,192,8
Deshka,1998,3,,193,11
Deshka,1998,8,,194,19
Deshka,1998,4,,195,23
Deshka,1998,173,,196,196
Deshka,1998,100,,197,296
Deshka,1998,273,,198,569
Deshka,1998,1347,,199,1916
Deshka,1998,7411,,200,9327
Deshka,1998,24744,,201,34071
Deshka,1998,38643,,202,72714
Deshka,1998,35117,,203,107831
Deshka,1998,19800,,204,127631
Deshka,1998,15436,,205,143067
Deshka,1998,46081,,206,189148
Deshka,1998,31400,,207,220548
Deshka,1998,18855,,208,239403
Deshka,1998,10704,,209,250107
Deshka,1998,15320,,210,265427
Deshka,1998,23254,,211,288681
Deshka,1998,47282,,212,335963
Deshka,1998,58767,,213,394730
Deshka,1998,52364,,214,447094
Deshka,1998,44910,,215,492004
Deshka,1998,26157,,216,518161
Deshka,1998,14431,,217,532592
Deshka,1998,8463,,218,541055
Deshka,1998,386,,219,541441
Deshka,1998,0,,220,541441
Deshka,1998,0,,221,541441
Deshka,1998,0,,222,541441
Deshka,1998,0,,223,541441
Deshka,1998,0,,224,541441
Deshka,1998,113,,225,541554
Deshka,1998,0,,226,541554
Deshka,1998,175,,227,541729
Deshka,1998,93,,228,541822
Deshka,1998,30,,229,541852
Deshka,1998,23,,230,541875
Deshka,1998,31,,231,541906
Deshka,1998,2,,232,541908
Deshka,1998,2,,233,541910
Deshka,1998,0,,234,541910
Deshka,1998,0,,235,541910
Deshka,1998,0,,236,541910
Deshka,1998,0,,237,541910
Deshka,1998,11,,238,541921
Deshka,1998,5,,239,541926
Deshka,1998,4,,240,541930
Deshka,1998,5,,241,541935
Deshka,1998,4,,242,541939
Deshka,1998,3,,243,541942
Deshka,1998,1,,244,541943
Deshka,1998,3,,245,541946
Deshka,1998,0,,246,541946
Deshka,1998,0,,247,541946
Deshka,1998,0,,248,541946
Deshka,1998,0,,249,541946
Deshka,1999,2,,191,2
Deshka,1999,0,,192,2
Deshka,1999,0,,193,2
Deshka,1999,0,,194,2
Deshka,1999,0,,195,2
Deshka,1999,0,,196,2
Deshka,1999,2,,197,4
Deshka,1999,0,,198,4
Deshka,1999,0,,199,4
Deshka,1999,0,,200,4
Deshka,1999,0,,201,4
Deshka,1999,0,,202,4
Deshka,1999,2,,203,6
Deshka,1999,0,,204,6
Deshka,1999,2,,205,8
Deshka,1999,2,,206,10
Deshka,1999,19,,207,29
Deshka,1999,6,,208,35
Deshka,1999,2,,209,37
Deshka,1999,13,,210,50
Deshka,1999,17,,211,67
Deshka,1999,0,,212,67
Deshka,1999,0,,213,67
Deshka,1999,0,,214,67
Deshka,1999,35,,215,102
Deshka,1999,96,,216,198
Deshka,1999,93,,217,291
Deshka,1999,20,,218,311
Deshka,1999,64,,219,375
Deshka,1999,66,,220,441
Deshka,1999,27,,221,468
Deshka,1999,28,,222,496
Deshka,1999,108,,223,604
Deshka,1999,157,,224,761
Deshka,1999,5,,225,766
Deshka,1999,0,,226,766
Deshka,1999,0,,227,766
Deshka,1999,0,,228,766
Deshka,1999,0,,229,766
Deshka,1999,0,,230,766
Deshka,2000,0,,186,0
Deshka,2000,0,,187,0
Deshka,2000,0,,188,0
Deshka,2000,29,,189,29
Deshka,2000,0,,190,29
Deshka,2000,0,,191,29
Deshka,2000,1,,192,30
Deshka,2000,1,,193,31
Deshka,2000,3,,194,34
Deshka,2000,4,,195,38
Deshka,2000,13,,196,51
Deshka,2000,98,,197,149
Deshka,2000,378,,198,527
Deshka,2000,330,,199,857
Deshka,2000,231,,200,1088
Deshka,2000,1037,,201,2125
Deshka,2000,236,,202,2361
Deshka,2000,3371,,203,5732
Deshka,2000,8507,,204,14239
Deshka,2000,14968,,205,29207
Deshka,2000,12703,,206,41910
Deshka,2000,26201,,207,68111
Deshka,2000,69319,,208,137430
Deshka,2000,85724,,209,223154
Deshka,2000,225180,,210,448334
Deshka,2000,160700,,211,609034
Deshka,2000,65900,,212,674934
Deshka,2000,142700,,213,817634
Deshka,2000,120500,,214,938134
Deshka,2000,83700,,215,1021834
Deshka,2000,31100,,216,1052934
Deshka,2000,39992,,217,1092926
Deshka,2000,39200,,219,1132126
Deshka,2000,30437,,220,1162563
Deshka,2000,30100,,221,1192663
Deshka,2000,10138,,222,1202801
Deshka,2000,16246,,223,1219047
Deshka,2000,6563,,224,1225610
Deshka,2000,7527,,225,1233137
Deshka,2000,5152,,226,1238289
Deshka,2000,5361,,227,1243650
Deshka,2000,12,,228,1243662
Deshka,2000,1166,,229,1244828
Deshka,2000,1104,,230,1245932
Deshka,2000,367,,231,1246299
Deshka,2000,561,,232,1246860
Deshka,2000,559,,233,1247419
Deshka,2000,300,,234,1247719
Deshka,2000,301,,235,1248020
Deshka,2000,80,,236,1248100
Deshka,2000,107,,237,1248207
Deshka,2000,84,,238,1248291
Deshka,2000,56,,239,1248347
Deshka,2000,51,,240,1248398
Deshka,2000,30,,241,1248428
Deshka,2000,30,,242,1248458
Deshka,2000,18,,243,1248476
Deshka,2000,8,,244,1248484
Deshka,2000,5,,245,1248489
Deshka,2000,1,,246,1248490
Deshka,2000,0,,247,1248490
Deshka,2000,0,,248,1248490
Deshka,2000,0,,249,1248490
Deshka,2000,0,,250,1248490
Deshka,2000,0,,251,1248490
Deshka,2000,3,,252,1248493
Deshka,2000,5,,253,1248498
Deshka,2000,0,,254,1248498
Deshka,2000,0,,255,1248498
Deshka,2000,0,,256,1248498
Deshka,2000,0,,257,1248498
Deshka,2000,0,,258,1248498
Deshka,2000,0,,259,1248498
Deshka,2000,0,,260,1248498
Deshka,2000,0,,261,1248498
Deshka,2000,0,,263,1248498
Deshka,2000,0,,264,1248498
Deshka,2000,0,,265,1248498
Deshka,2000,0,,266,1248498
Deshka,2000,0,,267,1248498
Deshka,2001,1,,197,1
Deshka,2001,0,,198,1
Deshka,2001,0,,199,1
Deshka,2001,3,,200,4
Deshka,2001,205,,201,209
Deshka,2001,584,,202,793
Deshka,2001,529,,203,1322
Deshka,2001,36,,204,1358
Deshka,2001,47,,205,1405
Deshka,2001,33,,206,1438
Deshka,2001,133,,207,1571
Deshka,2001,236,,208,1807
Deshka,2001,316,,209,2123
Deshka,2001,402,,210,2525
Deshka,2001,6,,211,2531
Deshka,2001,236,,212,2767
Deshka,2001,257,,213,3024
Deshka,2001,27,,214,3051
Deshka,2001,97,,215,3148
Deshka,2001,536,,216,3684
Deshka,2001,61,,217,3745
Deshka,2001,87,,218,3832
Deshka,2001,1,,219,3833
Deshka,2001,0,,220,3833
Deshka,2001,0,,221,3833
Deshka,2001,0,,222,3833
Deshka,2001,0,,223,3833
Deshka,2001,0,,224,3833
Deshka,2001,0,,225,3833
Deshka,2001,0,,226,3833
Deshka,2001,1,,227,3834
Deshka,2001,0,,228,3834
Deshka,2001,0,,229,3834
Deshka,2001,0,,230,3834
Deshka,2001,0,,231,3834
Deshka,2001,0,,232,3834
Deshka,2001,0,,233,3834
Deshka,2001,1,,234,3835
Deshka,2001,0,,235,3835
Deshka,2001,2,,236,3837
Deshka,2001,2,,237,3839
Deshka,2001,0,,238,3839
Deshka,2001,0,,239,3839
Deshka,2001,0,,240,3839
Deshka,2001,2,,241,3841
Deshka,2001,0,,242,3841
Deshka,2001,0,,243,3841
Deshka,2001,0,,244,3841
Deshka,2001,0,,245,3841
Deshka,2001,1,,246,3842
Deshka,2001,0,,247,3842
Deshka,2001,0,,248,3842
Deshka,2001,0,,249,3842
Deshka,2001,0,,250,3842
Deshka,2001,0,,251,3842
Deshka,2001,0,,252,3842
Deshka,2001,3,,253,3845
Deshka,2001,0,,255,3845
Deshka,2001,0,,256,3845
Deshka,2001,0,,257,3845
Deshka,2001,0,,258,3845
Deshka,2001,0,,259,3845
Deshka,2001,0,,260,3845
Deshka,2001,0,,261,3845
Deshka,2001,0,,262,3845
Deshka,2001,0,,263,3845
Deshka,2001,0,,264,3845
Deshka,2001,0,,265,3845
Deshka,2001,0,,266,3845
Deshka,2001,0,,267,3845
Deshka,2002,11,,187,11
Deshka,2002,2,,188,13
Deshka,2002,9,,189,22
Deshka,2002,15,,190,37
Deshka,2002,6,,191,43
Deshka,2002,22,,192,65
Deshka,2002,108,,193,173
Deshka,2002,1111,,194,1284
Deshka,2002,1130,,195,2414
Deshka,2002,771,,196,3185
Deshka,2002,1855,,197,5040
Deshka,2002,7645,,198,12685
Deshka,2002,16687,,199,29372
Deshka,2002,14670,,200,44042
Deshka,2002,12686,,201,56728
Deshka,2002,39872,,202,96600
Deshka,2002,55573,,203,152173
Deshka,2002,45162,,204,197335
Deshka,2002,30954,,205,228289
Deshka,2002,53040,,206,281329
Deshka,2002,76920,,207,358249
Deshka,2002,77700,,208,435949
Deshka,2002,89135,,209,525084
Deshka,2002,102560,,210,627644
Deshka,2002,80000,,211,707644
Deshka,2002,76500,,212,784144
Deshka,2002,39280,,213,823424
Deshka,2002,31280,,214,854704
Deshka,2002,15400,,215,870104
Deshka,2002,19480,,216,889584
Deshka,2002,20360,,217,909944
Deshka,2002,14100,,218,924044
Deshka,2002,14920,,219,938964
Deshka,2002,6120,,220,945084
Deshka,2002,82,,221,945166
Deshka,2002,62,,222,945228
Deshka,2002,46,,223,945274
Deshka,2002,36,,224,945310
Deshka,2002,91,,225,945401
Deshka,2002,45,,226,945446
Deshka,2002,197,,227,945643
Deshka,2002,140,,228,945783
Deshka,2002,90,,229,945873
Deshka,2002,45,,230,945918
Deshka,2002,80,,231,945998
Deshka,2002,109,,232,946107
Deshka,2002,98,,233,946205
Deshka,2002,27,,234,946232
Deshka,2002,4,,235,946236
Deshka,2002,2,,236,946238
Deshka,2002,2,,237,946240
Deshka,2002,7,,238,946247
Deshka,2002,3,,239,946250
Deshka,2002,2,,240,946252
Deshka,2002,3,,241,946255
Deshka,2002,0,,249,946255
Deshka,2002,0,,250,946255
Deshka,2002,0,,251,946255
Deshka,2002,0,,252,946255
Deshka,2003,1,,184,1
Deshka,2003,0,,185,1
Deshka,2003,0,,186,1
Deshka,2003,0,,187,1
Deshka,2003,0,,188,1
Deshka,2003,0,,189,1
Deshka,2003,0,,190,1
Deshka,2003,0,,191,1
Deshka,2003,0,,192,1
Deshka,2003,0,,193,1
Deshka,2003,0,,194,1
Deshka,2003,1,,195,2
Deshka,2003,0,,196,2
Deshka,2003,0,,197,2
Deshka,2003,0,,198,2
Deshka,2003,4,,202,6
Deshka,2003,5,,203,11
Deshka,2003,40,,204,51
Deshka,2003,35,,205,86
Deshka,2003,352,,206,438
Deshka,2003,1399,,207,1837
Deshka,2003,1483,,208,3320
Deshka,2003,926,,209,4246
Deshka,2003,428,,210,4674
Deshka,2003,167,,211,4841
Deshka,2003,44,,212,4885
Deshka,2003,67,,213,4952
Deshka,2003,326,,214,5278
Deshka,2003,511,,215,5789
Deshka,2003,82,,216,5871
Deshka,2003,183,,217,6054
Deshka,2003,297,,218,6351
Deshka,2003,390,,219,6741
Deshka,2003,418,,220,7159
Deshka,2003,514,,221,7673
Deshka,2003,247,,222,7920
Deshka,2003,110,,223,8030
Deshka,2003,236,,224,8266
Deshka,2003,714,,225,8980
Deshka,2003,108,,226,9088
Deshka,2003,12,,227,9100
Deshka,2003,8,,228,9108
Deshka,2003,6,,229,9114
Deshka,2003,1,,230,9115
Deshka,2003,0,,231,9115
Deshka,2003,6,,232,9121
Deshka,2003,13,,233,9134
Deshka,2003,13,,234,9147
Deshka,2003,13,,235,9160
Deshka,2003,25,,236,9185
Deshka,2003,4,,237,9189
Deshka,2003,16,,238,9205
Deshka,2003,1,,239,9206
Deshka,2003,0,,240,9206
Deshka,2003,0,,241,9206
Deshka,2003,0,,243,9206
Deshka,2003,1,,244,9207
Deshka,2003,1,,245,9208
Deshka,2003,0,,246,9208
Deshka,2003,5,,247,9213
Deshka,2003,0,,248,9213
Deshka,2003,1,,249,9214
Deshka,2003,0,,250,9214
Deshka,2003,0,,251,9214
Deshka,2004,1,,184,1
Deshka,2004,1,,185,2
Deshka,2004,0,,186,2
Deshka,2004,3,,187,5
Deshka,2004,1,,188,6
Deshka,2004,2,,189,8
Deshka,2004,0,,190,8
Deshka,2004,0,,191,8
Deshka,2004,0,,192,8
Deshka,2004,0,,193,8
Deshka,2004,0,,194,8
Deshka,2004,3,,195,11
Deshka,2004,2,,196,13
Deshka,2004,3,,197,16
Deshka,2004,34,,198,50
Deshka,2004,2512,,199,2562
Deshka,2004,10637,,200,13199
Deshka,2004,6744,,201,19943
Deshka,2004,7677,,202,27620
Deshka,2004,7867,,203,35487
Deshka,2004,8841,,204,44328
Deshka,2004,5463,,205,49791
Deshka,2004,18435,,206,68226
Deshka,2004,31118,,207,99344
Deshka,2004,32542,,208,131886
Deshka,2004,40291,,209,172177
Deshka,2004,38317,,210,210494
Deshka,2004,27841,,211,238335
Deshka,2004,21317,,212,259652
Deshka,2004,18419,,213,278071
Deshka,2004,31074,,214,309145
Deshka,2004,14124,,215,323269
Deshka,2004,16586,,216,339855
Deshka,2004,7661,,217,347516
Deshka,2004,4269,,218,351785
Deshka,2004,2258,,219,354043
Deshka,2004,2631,,220,356674
Deshka,2004,4721,,221,361395
Deshka,2004,5563,,222,366958
Deshka,2004,4158,,223,371116
Deshka,2004,3261,,224,374377
Deshka,2004,3172,,225,377549
Deshka,2004,2345,,226,379894
Deshka,2004,2424,,227,382318
Deshka,2004,2031,,228,384349
Deshka,2004,1383,,229,385732
Deshka,2004,1192,,230,386924
Deshka,2004,501,,231,387425
Deshka,2004,305,,232,387730
Deshka,2004,347,,233,388077
Deshka,2004,656,,234,388733
Deshka,2004,364,,235,389097
Deshka,2004,177,,236,389274
Deshka,2004,107,,237,389381
Deshka,2004,163,,238,389544
Deshka,2004,156,,239,389700
Deshka,2004,176,,240,389876
Deshka,2004,78,,241,389954
Deshka,2004,48,,242,390002
Deshka,2004,19,,243,390021
Deshka,2004,15,,244,390036
Deshka,2004,24,,245,390060
Deshka,2004,14,,246,390074
Deshka,2004,6,,247,390080
Deshka,2004,2,,248,390082
Deshka,2004,3,,249,390085
Deshka,2004,1,,250,390086
Deshka,2004,1,,251,390087
Deshka,2004,0,,252,390087
Deshka,2005,4,,189,4
Deshka,2005,3,,190,7
Deshka,2005,7,,191,14
Deshka,2005,0,,192,14
Deshka,2005,7,,193,21
Deshka,2005,10,,194,31
Deshka,2005,14,,195,45
Deshka,2005,5,,196,50
Deshka,2005,3,,197,53
Deshka,2005,51,,198,104
Deshka,2005,44,,199,148
Deshka,2005,39,,200,187
Deshka,2005,73,,201,260
Deshka,2005,854,,202,1114
Deshka,2005,281,,203,1395
Deshka,2005,560,,204,1955
Deshka,2005,266,,205,2221
Deshka,2005,137,,206,2358
Deshka,2005,16,,207,2374
Deshka,2005,217,,208,2591
Deshka,2005,28,,209,2619
Deshka,2005,349,,210,2968
Deshka,2005,193,,211,3161
Deshka,2005,441,,212,3602
Deshka,2005,234,,213,3836
Deshka,2005,243,,214,4079
Deshka,2005,371,,215,4450
Deshka,2005,540,,216,4990
Deshka,2005,387,,217,5377
Deshka,2005,401,,218,5778
Deshka,2005,79,,219,5857
Deshka,2005,139,,220,5996
Deshka,2005,72,,221,6068
Deshka,2005,83,,222,6151
Deshka,2005,119,,223,6270
Deshka,2005,115,,224,6385
Deshka,2005,184,,225,6569
Deshka,2005,23,,226,6592
Deshka,2005,16,,227,6608
Deshka,2005,23,,228,6631
Deshka,2005,148,,229,6779
Deshka,2005,46,,230,6825
Deshka,2005,17,,231,6842
Deshka,2005,31,,232,6873
Deshka,2005,95,,233,6968
Deshka,2005,37,,234,7005
Deshka,2005,26,,235,7031
Deshka,2005,19,,236,7050
Deshka,2005,11,,237,7061
Deshka,2005,6,,238,7067
Deshka,2005,3,,239,7070
Deshka,2005,2,,240,7072
Deshka,2005,4,,241,7076
Deshka,2005,9,,242,7085
Deshka,2005,2,,243,7087
Deshka,2005,1,,245,7088
Deshka,2005,0,,246,7088
Deshka,2005,0,,247,7088
Deshka,2005,0,,248,7088
Deshka,2005,0,,249,7088
Deshka,2006,1,,182,1
Deshka,2006,1,,184,2
Deshka,2006,2,,185,4
Deshka,2006,1,,187,5
Deshka,2006,0,,188,5
Deshka,2006,4,,189,9
Deshka,2006,3,,190,12
Deshka,2006,3,,191,15
Deshka,2006,4,,192,19
Deshka,2006,21,,193,40
Deshka,2006,21,,194,61
Deshka,2006,25,,195,86
Deshka,2006,84,,196,170
Deshka,2006,84,,197,254
Deshka,2006,64,,198,318
Deshka,2006,122,,199,440
Deshka,2006,468,,200,908
Deshka,2006,594,,201,1502
Deshka,2006,1826,,202,3328
Deshka,2006,1463,,203,4791
Deshka,2006,993,,204,5784
Deshka,2006,4315,,205,10099
Deshka,2006,6371,,206,16470
Deshka,2006,8168,,207,24638
Deshka,2006,5070,,208,29708
Deshka,2006,5598,,209,35306
Deshka,2006,8759,,210,44065
Deshka,2006,7914,,211,51979
Deshka,2006,4896,,212,56875
Deshka,2006,7082,,213,63957
Deshka,2006,4051,,214,68008
Deshka,2006,2577,,215,70585
Deshka,2006,3280,,216,73865
Deshka,2006,2729,,217,76594
Deshka,2006,1677,,218,78271
Deshka,2006,590,,219,78861
Deshka,2006,391,,220,79252
Deshka,2006,774,,221,80026
Deshka,2006,1031,,222,81057
Deshka,2006,644,,223,81701
Deshka,2006,750,,224,82451
Deshka,2006,881,,225,83332
Deshka,2006,115,,226,83447
Deshka,2006,7,,227,83454
Deshka,2006,0,,228,83454
Deshka,2006,0,"no count, wier partially submerged",229,83454
Deshka,2006,0,"wier flooded, done for season",233,83454
Deshka,2007,2,,193,2
Deshka,2007,0,,194,2
Deshka,2007,0,,195,2
Deshka,2007,1,,196,3
Deshka,2007,1,,197,4
Deshka,2007,4,,198,8
Deshka,2007,4,,199,12
Deshka,2007,9,,200,21
Deshka,2007,12,,201,33
Deshka,2007,18,,202,51
Deshka,2007,5,,203,56
Deshka,2007,0,,204,56
Deshka,2007,4,,205,60
Deshka,2007,38,,206,98
Deshka,2007,129,,207,227
Deshka,2007,257,,208,484
Deshka,2007,351,,209,835
Deshka,2007,459,,210,1294
Deshka,2007,89,,211,1383
Deshka,2007,122,,212,1505
Deshka,2007,196,,213,1701
Deshka,2007,286,,214,1987
Deshka,2007,127,,215,2114
Deshka,2007,369,,216,2483
Deshka,2007,453,,217,2936
Deshka,2007,250,,218,3186
Deshka,2007,62,,219,3248
Deshka,2007,13,,220,3261
Deshka,2007,36,,221,3297
Deshka,2007,42,,222,3339
Deshka,2007,66,,223,3405
Deshka,2007,80,,224,3485
Deshka,2007,77,,225,3562
Deshka,2007,22,,226,3584
Deshka,2007,85,,227,3669
Deshka,2007,54,,228,3723
Deshka,2007,63,,229,3786
Deshka,2007,26,,230,3812
Deshka,2007,11,,231,3823
Deshka,2007,15,,232,3838
Deshka,2007,41,,233,3879
Deshka,2007,21,,234,3900
Deshka,2007,21,,235,3921
Deshka,2007,15,,236,3936
Deshka,2007,9,,237,3945
Deshka,2007,3,,238,3948
Deshka,2007,1,,239,3949
Deshka,2007,1,,240,3950
Deshka,2007,1,,241,3951
Deshka,2007,2,,242,3953
Deshka,2007,0,,243,3953
Deshka,2007,1,,244,3954
Deshka,2007,0,,245,3954
Deshka,2007,0,,246,3954
Deshka,2007,0,,248,3954
Deshka,2008,1,,178,1
Deshka,2008,1,,179,2
Deshka,2008,1,,182,3
Deshka,2008,5,,183,8
Deshka,2008,1,,185,9
Deshka,2008,0,,186,9
Deshka,2008,5,,187,14
Deshka,2008,3,,188,17
Deshka,2008,2,,189,19
Deshka,2008,0,,190,19
Deshka,2008,3,,191,22
Deshka,2008,1,,192,23
Deshka,2008,0,,193,23
Deshka,2008,0,,194,23
Deshka,2008,0,,195,23
Deshka,2008,0,,196,23
Deshka,2008,1,,197,24
Deshka,2008,0,,198,24
Deshka,2008,14,,199,38
Deshka,2008,122,,200,160
Deshka,2008,221,,201,381
Deshka,2008,71,,202,452
Deshka,2008,72,,203,524
Deshka,2008,82,,204,606
Deshka,2008,394,,205,1000
Deshka,2008,716,,206,1716
Deshka,2008,837,,207,2553
Deshka,2008,904,,208,3457
Deshka,2008,1138,,209,4595
Deshka,2008,815,,210,5410
Deshka,2008,784,,211,6194
Deshka,2008,1240,,212,7434
Deshka,2008,647,,213,8081
Deshka,2008,1158,,214,9239
Deshka,2008,1064,,215,10303
Deshka,2008,408,,216,10711
Deshka,2008,447,,217,11158
Deshka,2008,243,,218,11401
Deshka,2008,405,,219,11806
Deshka,2008,369,,220,12175
Deshka,2008,212,,221,12387
Deshka,2008,103,,222,12490
Deshka,2008,76,,223,12566
Deshka,2008,66,,224,12632
Deshka,2008,62,,225,12694
Deshka,2008,48,,226,12742
Deshka,2008,55,,227,12797
Deshka,2008,35,,228,12832
Deshka,2008,16,,229,12848
Deshka,2008,25,,230,12873
Deshka,2008,23,,231,12896
Deshka,2008,14,,232,12910
Deshka,2008,4,,233,12914
Deshka,2008,5,,234,12919
Deshka,2008,4,,235,12923
Deshka,2008,20,,236,12943
Deshka,2008,3,,237,12946
Deshka,2008,1,,238,12947
Deshka,2008,0,,241,12947
Deshka,2008,0,,242,12947
Deshka,2008,0,,244,12947
Deshka,2008,0,,245,12947
Deshka,2008,0,,246,12947
Deshka,2008,0,,247,12947
Deshka,2008,0,,248,12947
Deshka,2008,0,,249,12947
Deshka,2008,0,,250,12947
Deshka,2008,0,,251,12947
Deshka,2008,0,last day,252,12947
Deshka,2009,1,,182,1
Deshka,2009,3,,183,4
Deshka,2009,0,,184,4
Deshka,2009,1,,185,5
Deshka,2009,1,,186,6
Deshka,2009,0,,187,6
Deshka,2009,0,,188,6
Deshka,2009,0,,189,6
Deshka,2009,0,,190,6
Deshka,2009,0,,191,6
Deshka,2009,0,,192,6
Deshka,2009,22,,198,28
Deshka,2009,0,,199,28
Deshka,2009,13,,200,41
Deshka,2009,17,,201,58
Deshka,2009,93,,202,151
Deshka,2009,38,,203,189
Deshka,2009,88,,204,277
Deshka,2009,2868,,205,3145
Deshka,2009,290,,206,3435
Deshka,2009,1051,,207,4486
Deshka,2009,256,,208,4742
Deshka,2009,539,,209,5281
Deshka,2009,1635,,210,6916
Deshka,2009,942,,211,7858
Deshka,2009,3164,,212,11022
Deshka,2009,1642,,213,12664
Deshka,2009,674,,214,13338
Deshka,2009,826,,215,14164
Deshka,2009,336,,216,14500
Deshka,2009,926,,217,15426
Deshka,2009,470,,218,15896
Deshka,2009,745,,219,16641
Deshka,2009,1302,,220,17943
Deshka,2009,1511,,221,19454
Deshka,2009,1157,,222,20611
Deshka,2009,916,,223,21527
Deshka,2009,772,,224,22299
Deshka,2009,440,,225,22739
Deshka,2009,1113,,226,23852
Deshka,2009,1953,,227,25805
Deshka,2009,175,,228,25980
Deshka,2009,13,,229,25993
Deshka,2009,9,,230,26002
Deshka,2009,12,,231,26014
Deshka,2009,23,,232,26037
Deshka,2009,20,,233,26057
Deshka,2009,13,,234,26070
Deshka,2009,3,,235,26073
Deshka,2009,4,,236,26077
Deshka,2010,23,,196,23
Deshka,2010,2,,197,25
Deshka,2010,26,,198,51
Deshka,2010,45,,199,96
Deshka,2010,139,,200,235
Deshka,2010,385,,201,620
Deshka,2010,1048,,202,1668
Deshka,2010,26,,203,1694
Deshka,2010,118,,204,1812
Deshka,2010,211,,205,2023
Deshka,2010,167,,206,2190
Deshka,2010,133,,207,2323
Deshka,2010,114,,208,2437
Deshka,2010,46,,209,2483
Deshka,2010,215,,210,2698
Deshka,2010,423,,211,3121
Deshka,2010,2026,,212,5147
Deshka,2010,1530,,213,6677
Deshka,2010,651,,214,7328
Deshka,2010,621,,215,7949
Deshka,2010,422,,216,8371
Deshka,2010,386,,217,8757
Deshka,2010,159,,218,8916
Deshka,2010,162,,219,9078
Deshka,2010,34,,220,9112
Deshka,2010,32,,221,9144
Deshka,2010,116,,222,9260
Deshka,2010,43,,223,9303
Deshka,2010,2,,224,9305
Deshka,2010,6,,225,9311
Deshka,2010,6,,226,9317
Deshka,2010,0,,227,9317
Deshka,2010,1,,228,9318
Deshka,2010,10,,229,9328
Deshka,2011,1,,188,1
Deshka,2011,2,,189,3
Deshka,2011,0,,190,3
Deshka,2011,0,,191,3
Deshka,2011,7,,192,10
Deshka,2011,3,,193,13
Deshka,2011,13,,194,26
Deshka,2011,8,,195,34
Deshka,2011,1,,198,35
Deshka,2011,3,,199,38
Deshka,2011,8,Water level 1.79,200,46
Deshka,2011,16,,201,62
Deshka,2011,28,,202,90
Deshka,2011,44,,203,134
Deshka,2011,7,,204,141
Deshka,2011,57,,205,198
Deshka,2011,161,,206,359
Deshka,2011,74,,207,433
Deshka,2011,270,,208,703
Deshka,2011,312,,209,1015
Deshka,2011,429,,210,1444
Deshka,2011,318,,211,1762
Deshka,2011,109,,212,1871
Deshka,2011,195,,213,2066
Deshka,2011,1531,,214,3597
Deshka,2011,497,,215,4094
Deshka,2011,32,,216,4126
Deshka,2011,81,,217,4207
Deshka,2011,54,,218,4261
Deshka,2011,33,,219,4294
Deshka,2011,0,"no count, water high and dirty",220,4294
Deshka,2011,0,"no count, flooding",221,4294
Deshka,2011,0,"no count, flooding",222,4294
Deshka,2011,0,"no count, flooding",223,4294
Deshka,2011,0,"no count, flooding",224,4294
Deshka,2011,0,"no count, flooding",225,4294
Deshka,2011,0,"no count, flooding",226,4294
Deshka,2011,9,,227,4303
Deshka,2011,49,,228,4352
Deshka,2011,17,,229,4369
Deshka,2011,28,,230,4397
Deshka,2011,46,,231,4443
Deshka,2011,5,,232,4448
Deshka,2011,15,,233,4463
Deshka,2011,9,,234,4472
Deshka,2011,2,,235,4474
Deshka,2011,7,,236,4481
Deshka,2011,3,,237,4484
Deshka,2011,2,,238,4486
Deshka,2011,3,,239,4489
Deshka,2011,0,,240,4489
Deshka,2011,0,,241,4489
Deshka,2011,0,,243,4489
Deshka,2012,2,,185,2
Deshka,2012,1,,186,3
Deshka,2012,6,,187,9
Deshka,2012,14,,188,23
Deshka,2012,19,,189,42
Deshka,2012,8,,190,50
Deshka,2012,2,,191,52
Deshka,2012,10,,192,62
Deshka,2012,2,,193,64
Deshka,2012,2,,194,66
Deshka,2012,8,,195,74
Deshka,2012,3,,196,77
Deshka,2012,0,,197,77
Deshka,2012,4,,198,81
Deshka,2012,7,,199,88
Deshka,2012,21,,200,109
Deshka,2012,8,,201,117
Deshka,2012,38,,202,155
Deshka,2012,103,,203,258
Deshka,2012,198,,204,456
Deshka,2012,749,,205,1205
Deshka,2012,74,,206,1279
Deshka,2012,562,,207,1841
Deshka,2012,2624,,208,4465
Deshka,2012,545,,209,5010
Deshka,2012,16563,,210,21573
Deshka,2012,11282,,211,32855
Deshka,2012,12500,,212,45355
Deshka,2012,7112,,213,52467
Deshka,2012,8233,,214,60700
Deshka,2012,4111,,215,64811
Deshka,2012,2681,,216,67492
Deshka,2012,5330,,217,72822
Deshka,2012,2119,,218,74941
Deshka,2012,928,,219,75869
Deshka,2012,617,,220,76486
Deshka,2012,524,,221,77010
Deshka,2012,651,,222,77661
Deshka,2012,280,,223,77941
Deshka,2012,255,,224,78196
Deshka,2012,147,,225,78343
Deshka,2012,98,,226,78441
Deshka,2012,71,,227,78512
Deshka,2012,58,,228,78570
Deshka,2012,61,,229,78631
Deshka,2012,90,,230,78721
Deshka,2012,21,,231,78742
Deshka,2012,13,,232,78755
Deshka,2012,47,,234,78802
Deshka,2012,16,,235,78818
Deshka,2012,7,,236,78825
Deshka,2012,4,,237,78829
Deshka,2012,4,,238,78833
Deshka,2012,4,,239,78837
Deshka,2012,1,,240,78838
Deshka,2012,0,,241,78838
Deshka,2012,1,,242,78839
Deshka,2012,0,,243,78839
Deshka,2012,1,,244,78840
Deshka,2012,13,,245,78853
Deshka,2012,0,,246,78853
Deshka,2012,0,,247,78853
Dog Salmon River,2006,5,,183,5
Dog Salmon River,2006,1,,184,6
Dog Salmon River,2006,5,,185,11
Dog Salmon River,2006,12,,186,23
Dog Salmon River,2006,7,,187,30
Dog Salmon River,2006,1,,188,31
Dog Salmon River,2006,1,,189,32
Dog Salmon River,2006,7,,190,39
Dog Salmon River,2006,0,,191,39
Dog Salmon River,2006,0,,192,39
Dog Salmon River,2006,62,,193,101
Dog Salmon River,2006,9,,194,110
Dog Salmon River,2006,0,,195,110
Dog Salmon River,2006,76,,196,186
Dog Salmon River,2006,53,,197,239
Dog Salmon River,2006,6,,198,245
Dog Salmon River,2006,3,,199,248
Dog Salmon River,2006,29,,200,277
Dog Salmon River,2006,32,,201,309
Dog Salmon River,2006,28,,202,337
Dog Salmon River,2006,18,,203,355
Dog Salmon River,2006,22,,204,377
Dog Salmon River,2006,273,,205,650
Dog Salmon River,2006,4,,206,654
Dog Salmon River,2006,6,,207,660
Dog Salmon River,2006,31,,208,691
Dog Salmon River,2006,128,,209,819
Dog Salmon River,2006,63,,210,882
Dog Salmon River,2006,1,,211,883
Dog Salmon River,2006,606,,212,1489
Dog Salmon River,2006,323,,213,1812
Dog Salmon River,2006,526,,214,2338
Dog Salmon River,2006,410,,215,2748
Dog Salmon River,2006,739,,216,3487
Dog Salmon River,2006,290,,217,3777
Dog Salmon River,2006,407,,218,4184
Dog Salmon River,2006,704,,219,4888
Dog Salmon River,2006,1554,,220,6442
Dog Salmon River,2006,1862,,221,8304
Dog Salmon River,2006,2899,,222,11203
Dog Salmon River,2006,5949,,223,17152
Dog Salmon River,2006,1504,,224,18656
Dog Salmon River,2006,4567,,225,23223
Dog Salmon River,2006,7968,,226,31191
Dog Salmon River,2006,19447,,227,50638
Dog Salmon River,2006,5598,,228,56236
Dog Salmon River,2006,6211,,229,62447
Dog Salmon River,2007,1,,177,1
Dog Salmon River,2007,12,,178,13
Dog Salmon River,2007,12,,179,25
Dog Salmon River,2007,8,,180,33
Dog Salmon River,2007,53,,181,86
Dog Salmon River,2007,21,,182,107
Dog Salmon River,2007,113,,183,220
Dog Salmon River,2007,84,,184,304
Dog Salmon River,2007,65,,185,369
Dog Salmon River,2007,39,,186,408
Dog Salmon River,2007,243,,187,651
Dog Salmon River,2007,86,,188,737
Dog Salmon River,2007,220,,189,957
Dog Salmon River,2007,180,,190,1137
Dog Salmon River,2007,492,,191,1629
Dog Salmon River,2007,229,,192,1858
Dog Salmon River,2007,208,,193,2066
Dog Salmon River,2007,36,,194,2102
Dog Salmon River,2007,46,,195,2148
Dog Salmon River,2007,74,,196,2222
Dog Salmon River,2007,68,,197,2290
Dog Salmon River,2007,232,,198,2522
Dog Salmon River,2007,149,,199,2671
Dog Salmon River,2007,931,,200,3602
Dog Salmon River,2007,400,,201,4002
Dog Salmon River,2007,130,,202,4132
Dog Salmon River,2007,1847,,203,5979
Dog Salmon River,2007,500,,204,6479
Dog Salmon River,2007,613,,206,7092
Dog Salmon River,2007,245,,207,7337
Dog Salmon River,2007,69,,208,7406
Dog Salmon River,2007,40,,209,7446
Dog Salmon River,2007,206,,210,7652
Dog Salmon River,2007,296,,211,7948
Dog Salmon River,2007,216,,212,8164
Dog Salmon River,2007,89,,213,8253
Dog Salmon River,2007,18496,,214,26749
Dog Salmon River,2007,1130,,215,27879
Dog Salmon River,2007,2842,,216,30721
Dog Salmon River,2007,2160,,217,32881
Dog Salmon River,2007,5782,,218,38663
Dog Salmon River,2007,612,,219,39275
Dog Salmon River,2007,4201,,220,43476
Dog Salmon River,2007,964,,221,44440
Dog Salmon River,2007,526,,222,44966
Dog Salmon River,2007,1235,,223,46201
Dog Salmon River,2007,552,,224,46753
Dog Salmon River,2007,791,,225,47544
Dog Salmon River,2007,1543,,226,49087
Dog Salmon River,2007,1443,,227,50530
Dog Salmon River,2007,12,,228,50542
Dog Salmon River,2007,2592,,229,53134
Dog Salmon River,2007,703,,230,53837
Dog Salmon River,2007,734,,231,54571
Dog Salmon River,2007,1114,,232,55685
Dog Salmon River,2007,1374,,233,57059
Dog Salmon River,2007,1963,,234,59022
Dog Salmon River,2007,1863,wier closed,235,60885
Dog Salmon River,2007,63,,257,60948
Dog Salmon River,2007,70,wier closed,258,61018
Dog Salmon River,2008,2,,174,2
Dog Salmon River,2008,2,,175,4
Dog Salmon River,2008,0,,176,4
Dog Salmon River,2008,96,,177,100
Dog Salmon River,2008,22,,178,122
Dog Salmon River,2008,7,,179,129
Dog Salmon River,2008,8,,180,137
Dog Salmon River,2008,19,,181,156
Dog Salmon River,2008,13,,182,169
Dog Salmon River,2008,1,,183,170
Dog Salmon River,2008,0,,184,170
Dog Salmon River,2008,23,,185,193
Dog Salmon River,2008,15,,186,208
Dog Salmon River,2008,11,,187,219
Dog Salmon River,2008,18,,188,237
Dog Salmon River,2008,22,,189,259
Dog Salmon River,2008,16,,190,275
Dog Salmon River,2008,45,,191,320
Dog Salmon River,2008,22,,192,342
Dog Salmon River,2008,2,,193,344
Dog Salmon River,2008,12,,194,356
Dog Salmon River,2008,18,,195,374
Dog Salmon River,2008,19,,196,393
Dog Salmon River,2008,25,,197,418
Dog Salmon River,2008,7,,198,425
Dog Salmon River,2008,2,,199,427
Dog Salmon River,2008,0,,200,427
Dog Salmon River,2008,11,,201,438
Dog Salmon River,2008,9,,202,447
Dog Salmon River,2008,0,,203,447
Dog Salmon River,2008,0,,204,447
Dog Salmon River,2008,23,,205,470
Dog Salmon River,2008,12,,206,482
Dog Salmon River,2008,9,,207,491
Dog Salmon River,2008,22,,208,513
Dog Salmon River,2008,1224,,209,1737
Dog Salmon River,2008,136,,210,1873
Dog Salmon River,2008,324,,211,2197
Dog Salmon River,2008,14,,212,2211
Dog Salmon River,2008,209,,213,2420
Dog Salmon River,2008,59,,214,2479
Dog Salmon River,2008,49,,215,2528
Dog Salmon River,2008,117,,216,2645
Dog Salmon River,2008,276,,217,2921
Dog Salmon River,2008,794,,218,3715
Dog Salmon River,2008,968,,219,4683
Dog Salmon River,2008,1122,,220,5805
Dog Salmon River,2008,553,,221,6358
Dog Salmon River,2008,347,,222,6705
Dog Salmon River,2008,2222,,223,8927
Dog Salmon River,2008,52,,224,8979
Dog Salmon River,2008,31,,225,9010
Dog Salmon River,2008,2026,,226,11036
Dog Salmon River,2008,4130,,227,15166
Dog Salmon River,2008,16550,,228,31716
Dog Salmon River,2008,14461,,229,46177
Dog Salmon River,2008,11365,,230,57542
Dog Salmon River,2008,304,,231,57846
Dog Salmon River,2008,3485,,232,61331
Dog Salmon River,2008,45000,"Wier closed, post wier estimate",233,106331
Dog Salmon River,2009,2,,175,2
Dog Salmon River,2009,0,,176,2
Dog Salmon River,2009,0,,177,2
Dog Salmon River,2009,0,,178,2
Dog Salmon River,2009,2,,179,4
Dog Salmon River,2009,0,,180,4
Dog Salmon River,2009,0,,181,4
Dog Salmon River,2009,4,,182,8
Dog Salmon River,2009,9,,183,17
Dog Salmon River,2009,82,,184,99
Dog Salmon River,2009,150,,185,249
Dog Salmon River,2009,36,,186,285
Dog Salmon River,2009,34,,187,319
Dog Salmon River,2009,62,,188,381
Dog Salmon River,2009,6,,189,387
Dog Salmon River,2009,6,,190,393
Dog Salmon River,2009,37,,191,430
Dog Salmon River,2009,24,,192,454
Dog Salmon River,2009,11,,193,465
Dog Salmon River,2009,379,,194,844
Dog Salmon River,2009,133,,195,977
Dog Salmon River,2009,148,,196,1125
Dog Salmon River,2009,84,,197,1209
Dog Salmon River,2009,69,,198,1278
Dog Salmon River,2009,44,,199,1322
Dog Salmon River,2009,52,,200,1374
Dog Salmon River,2009,1,,201,1375
Dog Salmon River,2009,278,,202,1653
Dog Salmon River,2009,76,,203,1729
Dog Salmon River,2009,1,,204,1730
Dog Salmon River,2009,78,,205,1808
Dog Salmon River,2009,429,,206,2237
Dog Salmon River,2009,514,,207,2751
Dog Salmon River,2009,1172,,208,3923
Dog Salmon River,2009,743,,209,4666
Dog Salmon River,2009,6910,,210,11576
Dog Salmon River,2009,1628,,211,13204
Dog Salmon River,2009,294,,212,13498
Dog Salmon River,2009,6,,213,13504
Dog Salmon River,2009,1300,,214,14804
Dog Salmon River,2009,62,,215,14866
Dog Salmon River,2009,3225,,216,18091
Dog Salmon River,2009,1596,,217,19687
Dog Salmon River,2009,24,,218,19711
Dog Salmon River,2009,726,,219,20437
Dog Salmon River,2009,428,,220,20865
Dog Salmon River,2009,1082,,221,21947
Dog Salmon River,2009,8,,222,21955
Dog Salmon River,2009,267,,223,22222
Dog Salmon River,2009,246,,224,22468
Dog Salmon River,2009,578,,225,23046
Dog Salmon River,2009,959,,226,24005
Dog Salmon River,2009,2700,,227,26705
Dog Salmon River,2010,1,,187,1
Dog Salmon River,2010,7,,188,8
Dog Salmon River,2010,19,,189,27
Dog Salmon River,2010,0,,190,27
Dog Salmon River,2010,21,,191,48
Dog Salmon River,2010,3,,192,51
Dog Salmon River,2010,12,,193,63
Dog Salmon River,2010,14,,194,77
Dog Salmon River,2010,0,,195,77
Dog Salmon River,2010,5,,196,82
Dog Salmon River,2010,10,,197,92
Dog Salmon River,2010,0,,198,92
Dog Salmon River,2010,1,,199,93
Dog Salmon River,2010,38,,200,131
Dog Salmon River,2010,2,,201,133
Dog Salmon River,2010,22,,202,155
Dog Salmon River,2010,4,,203,159
Dog Salmon River,2010,0,,204,159
Dog Salmon River,2010,99,,205,258
Dog Salmon River,2010,71,,206,329
Dog Salmon River,2010,56,,207,385
Dog Salmon River,2010,128,,208,513
Dog Salmon River,2010,380,,209,893
Dog Salmon River,2010,295,,210,1188
Dog Salmon River,2010,1455,,211,2643
Dog Salmon River,2010,2474,,212,5117
Dog Salmon River,2010,574,,213,5691
Dog Salmon River,2010,6271,,214,11962
Dog Salmon River,2010,6372,,215,18334
Dog Salmon River,2010,10672,,216,29006
Dog Salmon River,2010,4910,,217,33916
Dog Salmon River,2010,8143,,218,42059
Dog Salmon River,2010,7010,,219,49069
Dog Salmon River,2010,17141,,220,66210
Dog Salmon River,2010,12967,,221,79177
Dog Salmon River,2010,6125,,222,85302
Dog Salmon River,2010,6366,,223,91668
Dog Salmon River,2010,78977,"Wier closed, post wier estimate",224,170645
Dog Salmon River,2011,1,,179,1
Dog Salmon River,2011,3,,180,4
Dog Salmon River,2011,0,,181,4
Dog Salmon River,2011,11,,182,15
Dog Salmon River,2011,28,,183,43
Dog Salmon River,2011,6,,184,49
Dog Salmon River,2011,12,,185,61
Dog Salmon River,2011,63,,186,124
Dog Salmon River,2011,42,,187,166
Dog Salmon River,2011,3,,188,169
Dog Salmon River,2011,21,,189,190
Dog Salmon River,2011,63,,190,253
Dog Salmon River,2011,8,,191,261
Dog Salmon River,2011,56,,192,317
Dog Salmon River,2011,193,,193,510
Dog Salmon River,2011,128,,194,638
Dog Salmon River,2011,116,,195,754
Dog Salmon River,2011,60,,196,814
Dog Salmon River,2011,115,,197,929
Dog Salmon River,2011,84,,198,1013
Dog Salmon River,2011,453,,199,1466
Dog Salmon River,2011,75,,200,1541
Dog Salmon River,2011,152,,201,1693
Dog Salmon River,2011,841,,202,2534
Dog Salmon River,2011,235,,203,2769
Dog Salmon River,2011,354,,204,3123
Dog Salmon River,2011,499,,205,3622
Dog Salmon River,2011,434,,206,4056
Dog Salmon River,2011,203,,207,4259
Dog Salmon River,2011,836,,208,5095
Dog Salmon River,2011,347,,209,5442
Dog Salmon River,2011,1146,,210,6588
Dog Salmon River,2011,125,,211,6713
Dog Salmon River,2011,336,,212,7049
Dog Salmon River,2011,120,,213,7169
Dog Salmon River,2011,119,,214,7288
Dog Salmon River,2011,246,,215,7534
Dog Salmon River,2011,127,,216,7661
Dog Salmon River,2011,446,,217,8107
Dog Salmon River,2011,3915,,218,12022
Dog Salmon River,2011,1663,,219,13685
Dog Salmon River,2011,73,,220,13758
Dog Salmon River,2011,315,,221,14073
Dog Salmon River,2011,510,,222,14583
Dog Salmon River,2011,274,,223,14857
Dog Salmon River,2011,643,,224,15500
Dog Salmon River,2011,130,,225,15630
Dog Salmon River,2011,248,,226,15878
Dog Salmon River,2011,285,,227,16163
Dog Salmon River,2011,239,,228,16402
Dog Salmon River,2011,384,,229,16786
Dog Salmon River,2011,518,,230,17304
Dog Salmon River,2011,897,,231,18201
Dog Salmon River,2011,286,,232,18487
Dog Salmon River,2011,2706,Wier pulled for season,233,21193
Dog Salmon River,2011,150,post wier estimate,234,21343
Dog Salmon River,2012,1,,172,1
Dog Salmon River,2012,0,,173,1
Dog Salmon River,2012,0,,174,1
Dog Salmon River,2012,3,,175,4
Dog Salmon River,2012,0,,176,4
Dog Salmon River,2012,7,,177,11
Dog Salmon River,2012,5,,178,16
Dog Salmon River,2012,4,,179,20
Dog Salmon River,2012,0,,180,20
Dog Salmon River,2012,2,,181,22
Dog Salmon River,2012,4,,182,26
Dog Salmon River,2012,7,,183,33
Dog Salmon River,2012,5,,184,38
Dog Salmon River,2012,1,,185,39
Dog Salmon River,2012,1,,186,40
Dog Salmon River,2012,0,,187,40
Dog Salmon River,2012,8,,188,48
Dog Salmon River,2012,11,,189,59
Dog Salmon River,2012,6,,190,65
Dog Salmon River,2012,2,,191,67
Dog Salmon River,2012,0,,192,67
Dog Salmon River,2012,0,,193,67
Dog Salmon River,2012,7,,194,74
Dog Salmon River,2012,0,,195,74
Dog Salmon River,2012,0,,196,74
Dog Salmon River,2012,11,,197,85
Dog Salmon River,2012,1,,198,86
Dog Salmon River,2012,20,,199,106
Dog Salmon River,2012,41,,200,147
Dog Salmon River,2012,11,,201,158
Dog Salmon River,2012,3,,202,161
Dog Salmon River,2012,42,,203,203
Dog Salmon River,2012,2,,204,205
Dog Salmon River,2012,0,,205,205
Dog Salmon River,2012,41,,206,246
Dog Salmon River,2012,22,,207,268
Dog Salmon River,2012,2,,208,270
Dog Salmon River,2012,92,,209,362
Dog Salmon River,2012,5,,210,367
Dog Salmon River,2012,76,,211,443
Dog Salmon River,2012,1137,,212,1580
Dog Salmon River,2012,722,,213,2302
Dog Salmon River,2012,1167,,214,3469
Dog Salmon River,2012,2153,,216,5622
Dog Salmon River,2012,870,,217,6492
Dog Salmon River,2012,3676,,218,10168
Dog Salmon River,2012,4286,,219,14454
Dog Salmon River,2012,23319,,220,37773
Dog Salmon River,2012,19931,,221,57704
Dog Salmon River,2012,15452,,222,73156
Dog Salmon River,2012,11549,,223,84705
Dog Salmon River,2012,11657,,224,96362
Dog Salmon River,2012,7205,,225,103567
Dog Salmon River,2012,11748,,226,115315
Dog Salmon River,2012,21924,,227,137239
Dog Salmon River,2012,17681,,228,154920
Dog Salmon River,2012,10455,,229,165375
Dog Salmon River,2012,10730,,230,176105
Dog Salmon River,2012,20675,,231,196780
Dog Salmon River,2012,200000,post wier estimate,232,396780
Fish Creek ,1997,0,VERY few fish (KO),188,0
Fish Creek ,1997,0,,189,0
Fish Creek ,1997,0,,190,0
Fish Creek ,1997,0,,191,0
Fish Creek ,1997,0,,192,0
Fish Creek ,1997,0,,193,0
Fish Creek ,1997,0,,194,0
Fish Creek ,1997,0,,195,0
Fish Creek ,1997,0,,196,0
Fish Creek ,1997,0,,197,0
Fish Creek ,1997,0,,198,0
Fish Creek ,1997,0,,199,0
Fish Creek ,1997,0,,200,0
Fish Creek ,1997,0,,201,0
Fish Creek ,1997,0,,202,0
Fish Creek ,1997,0,,203,0
Fish Creek ,1997,0,,204,0
Fish Creek ,1997,0,,205,0
Fish Creek ,1997,0,,206,0
Fish Creek ,1997,1,,207,1
Fish Creek ,1997,0,,208,1
Fish Creek ,1997,0,,209,1
Fish Creek ,1997,0,,210,1
Fish Creek ,1997,3,,211,4
Fish Creek ,1997,7,,212,11
Fish Creek ,1997,8,,213,19
Fish Creek ,1997,4,,214,23
Fish Creek ,1997,1,,215,24
Fish Creek ,1997,0,,216,24
Fish Creek ,1997,0,,217,24
Fish Creek ,1997,3,,218,27
Fish Creek ,1997,2,,219,29
Fish Creek ,1997,0,,220,29
Fish Creek ,1997,1,,221,30
Fish Creek ,1997,0,,222,30
Fish Creek ,1997,2,,223,32
Fish Creek ,1997,0,,224,32
Fish Creek ,1997,0,,225,32
Fish Creek ,1997,0,,226,32
Fish Creek ,1997,0,,227,32
Fish Creek ,1997,0,,228,32
Fish Creek ,1997,0,,229,32
Fish Creek ,1997,0,,230,32
Fish Creek ,1997,0,,231,32
Fish Creek ,1997,0,,232,32
Fish Creek ,1997,0,,233,32
Fish Creek ,1997,0,,234,32
Fish Creek ,1997,0,,235,32
Fish Creek ,1997,0,,236,32
Fish Creek ,1997,0,,237,32
Fish Creek ,1997,0,,238,32
Fish Creek ,1997,0,,239,32
Fish Creek ,1997,0,,240,32
Fish Creek ,1997,0,,241,32
Fish Creek ,1997,0,,242,32
Fish Creek ,1997,0,,243,32
Fish Creek ,1997,0,,244,32
Fish Creek ,1998,0,,188,0
Fish Creek ,1998,0,,189,0
Fish Creek ,1998,0,,190,0
Fish Creek ,1998,0,,191,0
Fish Creek ,1998,0,,192,0
Fish Creek ,1998,0,,193,0
Fish Creek ,1998,0,,194,0
Fish Creek ,1998,0,,195,0
Fish Creek ,1998,0,,196,0
Fish Creek ,1998,0,,197,0
Fish Creek ,1998,0,,198,0
Fish Creek ,1998,0,,199,0
Fish Creek ,1998,0,,200,0
Fish Creek ,1998,0,,201,0
Fish Creek ,1998,0,,202,0
Fish Creek ,1998,0,,203,0
Fish Creek ,1998,0,,204,0
Fish Creek ,1998,0,,205,0
Fish Creek ,1998,0,,206,0
Fish Creek ,1998,6,,207,6
Fish Creek ,1998,5,,208,11
Fish Creek ,1998,0,,209,11
Fish Creek ,1998,0,,210,11
Fish Creek ,1998,8,,211,19
Fish Creek ,1998,0,,212,19
Fish Creek ,1998,8,,213,27
Fish Creek ,1998,0,,214,27
Fish Creek ,1998,3,,215,30
Fish Creek ,1998,3,,216,33
Fish Creek ,1998,7,,217,40
Fish Creek ,1998,13,,218,53
Fish Creek ,1998,31,,219,84
Fish Creek ,1998,21,,220,105
Fish Creek ,1998,4,,221,109
Fish Creek ,1998,2,,222,111
Fish Creek ,1998,0,,223,111
Fish Creek ,1998,12,,224,123
Fish Creek ,1998,5,,225,128
Fish Creek ,1998,2,,226,130
Fish Creek ,1998,7,,227,137
Fish Creek ,1998,23,,228,160
Fish Creek ,1998,0,,229,160
Fish Creek ,1998,0,,230,160
Fish Creek ,1998,2,,231,162
Fish Creek ,1998,0,,232,162
Fish Creek ,1998,2,,233,164
Fish Creek ,1998,1,,234,165
Fish Creek ,1998,0,,235,165
Fish Creek ,1998,0,,236,165
Fish Creek ,1998,0,,237,165
Fish Creek ,1998,0,,238,165
Fish Creek ,1998,0,,239,165
Fish Creek ,1998,0,,240,165
Fish Creek ,1998,0,,241,165
Fish Creek ,1998,0,,242,165
Fish Creek ,1998,0,,243,165
Fish Creek ,1998,0,,244,165
Fish Creek ,1998,0,,245,165
Fish Creek ,1998,0,,246,165
Fish Creek ,1998,0,,247,165
Fish Creek ,1998,0,,248,165
Fish Creek ,1998,0,,249,165
Fish Creek ,1998,0,,250,165
Fish Creek ,1998,0,,251,165
Fish Creek ,1998,0,,252,165
Fish Creek ,1998,0,,253,165
Fish Creek ,1998,0,,254,165
Fish Creek ,1998,0,,255,165
Fish Creek ,1998,0,,256,165
Fish Creek ,1998,0,,257,165
Fish Creek ,1998,0,,258,165
Fish Creek ,1998,0,,259,165
Fish Creek ,1998,0,,260,165
Fish Creek ,1998,0,,261,165
Fish Creek ,1998,0,,262,165
Fish Creek ,1998,0,,263,165
Fish Creek ,1998,0,,264,165
Fish Creek ,1998,0,,265,165
Fish Creek ,1998,0,,266,165
Fish Creek ,1998,0,,267,165
Fish Creek ,1998,0,,268,165
Fish Creek ,1998,0,,269,165
Fish Creek ,1998,0,,270,165
Fish Creek ,2000,2,,203,2
Fish Creek ,2000,2,,210,4
Fish Creek ,2000,4,,212,8
Fish Creek ,2000,4,,213,12
Fish Creek ,2000,4,,214,16
Fish Creek ,2000,43,,215,59
Fish Creek ,2000,23,,216,82
Fish Creek ,2000,49,,217,131
Fish Creek ,2000,41,,218,172
Fish Creek ,2000,27,,219,199
Fish Creek ,2000,34,,220,233
Fish Creek ,2000,215,,221,448
Fish Creek ,2000,47,,222,495
Fish Creek ,2000,158,,223,653
Fish Creek ,2000,0,,224,653
Fish Creek ,2000,0,,225,653
Fish Creek ,2000,0,,226,653
Fish Creek ,2000,33,,227,686
Fish Creek ,2000,0,,228,686
Fish Creek ,2000,3,,229,689
Fish Creek ,2000,14,,230,703
Fish Creek ,2000,47,,231,750
Fish Creek ,2000,21,,232,771
Fish Creek ,2000,14,,233,785
Fish Creek ,2000,0,,234,785
Fish Creek ,2000,0,,235,785
Fish Creek ,2000,0,,236,785
Fish Creek ,2000,0,,237,785
Fish Creek ,2000,3,,238,788
Fish Creek ,2000,1,,239,789
Fish Creek ,2000,0,,240,789
Fish Creek ,2000,0,,241,789
Fish Creek ,2000,0,,242,789
Fish Creek ,2000,0,,243,789
Fish Creek ,2000,0,,244,789
Fish Creek ,2000,0,,245,789
Fish Creek ,2000,0,,246,789
Fish Creek ,2000,0,,247,789
Fish Creek ,2000,0,,248,789
Fish Creek ,2000,0,,249,789
Fish Creek ,2000,0,,250,789
Fish Creek ,2000,0,,251,789
Fish Creek ,2000,0,,252,789
Fish Creek ,2000,0,,253,789
Fish Creek ,2000,0,,254,789
Fish Creek ,2000,0,,255,789
Fish Creek ,2000,0,,256,789
Fish Creek ,2000,0,,257,789
Fish Creek ,2000,0,,258,789
Fish Creek ,2000,0,,259,789
Fish Creek ,2000,0,,260,789
Fish Creek ,2000,0,,261,789
Fish Creek ,2000,0,,263,789
Fish Creek ,2000,0,,264,789
Fish Creek ,2000,0,,265,789
Fish Creek ,2000,0,,266,789
Fish Creek ,2000,0,,267,789
Fish Creek ,2001,1,,202,1
Fish Creek ,2001,0,,203,1
Fish Creek ,2001,1,,204,2
Fish Creek ,2001,1,,205,3
Fish Creek ,2001,0,,206,3
Fish Creek ,2001,1,,207,4
Fish Creek ,2001,0,,208,4
Fish Creek ,2001,0,,209,4
Fish Creek ,2001,1,,210,5
Fish Creek ,2001,1,,212,6
Fish Creek ,2001,0,,213,6
Fish Creek ,2001,0,,214,6
Fish Creek ,2001,1,,215,7
Fish Creek ,2001,3,,216,10
Fish Creek ,2001,0,,217,10
Fish Creek ,2001,4,,218,14
Fish Creek ,2001,6,,219,20
Fish Creek ,2001,11,,220,31
Fish Creek ,2001,2,,221,33
Fish Creek ,2001,3,,222,36
Fish Creek ,2001,4,,223,40
Fish Creek ,2001,15,,224,55
Fish Creek ,2001,10,,225,65
Fish Creek ,2001,14,,226,79
Fish Creek ,2001,11,,227,90
Fish Creek ,2001,2,,228,92
Fish Creek ,2001,5,,229,97
Fish Creek ,2001,6,,230,103
Fish Creek ,2001,1,,231,104
Fish Creek ,2001,0,,232,104
Fish Creek ,2001,3,,233,107
Fish Creek ,2001,0,,234,107
Fish Creek ,2001,6,,235,113
Fish Creek ,2001,1,,236,114
Fish Creek ,2001,0,,237,114
Fish Creek ,2001,0,,238,114
Fish Creek ,2001,0,,239,114
Fish Creek ,2001,0,,240,114
Fish Creek ,2001,1,,241,115
Fish Creek ,2001,3,,242,118
Fish Creek ,2001,0,,243,118
Fish Creek ,2001,0,,244,118
Fish Creek ,2001,0,,245,118
Fish Creek ,2001,0,,246,118
Fish Creek ,2001,0,,247,118
Fish Creek ,2001,0,,248,118
Fish Creek ,2001,0,,249,118
Fish Creek ,2001,0,,250,118
Fish Creek ,2001,0,,251,118
Fish Creek ,2001,0,,252,118
Fish Creek ,2001,0,,253,118
Fish Creek ,2001,0,,255,118
Fish Creek ,2001,0,,256,118
Fish Creek ,2001,0,,257,118
Fish Creek ,2001,0,,258,118
Fish Creek ,2001,0,,259,118
Fish Creek ,2001,0,,260,118
Fish Creek ,2001,0,,261,118
Fish Creek ,2001,0,,262,118
Fish Creek ,2001,0,,263,118
Fish Creek ,2001,0,,264,118
Fish Creek ,2001,0,,265,118
Fish Creek ,2001,0,,266,118
Fish Creek ,2001,0,,267,118
George River,1996,1,I am not including years with less than 5 fish (KO),185,1
George River,1996,2,,187,3
George River,1996,1,,188,4
George River,1996,12,,191,16
George River,1996,4,,194,20
George River,1996,9,,195,29
George River,1996,11,,196,40
George River,1996,34,,197,74
George River,1996,18,,198,92
George River,1996,34,,199,126
George River,1996,44,,200,170
George River,1996,90,,201,260
George River,1996,68,,202,328
George River,1996,61,,203,389
George River,1996,45,,204,434
George River,1996,39,,205,473
George River,1996,68,,206,541
George River,1996,74,,207,615
George River,1996,28,,208,643
George River,1997,0,,160,0
George River,1997,0,,161,0
George River,1997,0,,162,0
George River,1997,0,,163,0
George River,1997,0,,164,0
George River,1997,0,,165,0
George River,1997,0,,166,0
George River,1997,0,,168,0
George River,1997,0,,169,0
George River,1997,0,,170,0
George River,1997,0,,171,0
George River,1997,0,,172,0
George River,1997,0,,173,0
George River,1997,0,,174,0
George River,1997,0,,175,0
George River,1997,0,,176,0
George River,1997,0,,177,0
George River,1997,0,,178,0
George River,1997,0,,179,0
George River,1997,0,,180,0
George River,1997,0,,181,0
George River,1997,0,,182,0
George River,1997,0,,183,0
George River,1997,0,,184,0
George River,1997,0,,185,0
George River,1997,0,,186,0
George River,1997,0,,187,0
George River,1997,0,,188,0
George River,1997,0,,189,0
George River,1997,0,,190,0
George River,1997,0,,191,0
George River,1997,0,,192,0
George River,1997,1,,193,1
George River,1997,0,,194,1
George River,1997,0,,195,1
George River,1997,1,,196,2
George River,1997,0,,197,2
George River,1997,0,,198,2
George River,1997,2,,199,4
George River,1997,1,,200,5
George River,1997,0,,201,5
George River,1997,0,,202,5
George River,1997,1,,203,6
George River,1997,2,,204,8
George River,1997,0,,205,8
George River,1997,1,,206,9
George River,1997,0,,207,9
George River,1997,0,,208,9
George River,1997,1,,209,10
George River,1997,0,,210,10
George River,1997,0,,211,10
George River,1997,1,,212,11
George River,1997,1,,213,12
George River,1997,0,,214,12
George River,1997,0,,215,12
George River,1997,0,,216,12
George River,1997,0,,217,12
George River,1997,0,,218,12
George River,1997,0,,219,12
George River,1997,1,,220,13
George River,1997,1,,221,14
George River,1997,1,,222,15
George River,1997,0,,223,15
George River,1997,0,,224,15
George River,1997,0,,225,15
George River,1997,0,,226,15
George River,1997,0,,227,15
George River,1997,0,,228,15
George River,1997,0,,229,15
George River,1997,0,,230,15
George River,1997,0,,231,15
George River,1997,0,,232,15
George River,1997,0,,233,15
George River,1997,0,,234,15
George River,1997,0,,235,15
George River,1997,0,,236,15
George River,1997,0,,237,15
George River,1997,0,,238,15
George River,1997,0,,239,15
George River,1997,0,,240,15
George River,1997,0,,241,15
George River,1997,2,,242,17
George River,1997,0,,243,17
George River,1997,0,,244,17
George River,1997,0,,245,17
George River,1997,0,,246,17
George River,1997,0,,247,17
George River,1997,0,,248,17
George River,1997,0,,249,17
George River,1997,0,,250,17
George River,1997,0,,251,17
George River,1997,0,,252,17
George River,1997,0,,253,17
George River,1997,0,,254,17
George River,1997,0,,255,17
George River,1997,0,,256,17
George River,1997,0,,257,17
George River,1997,0,,258,17
George River,1999,0,,195,0
George River,1999,0,,196,0
George River,1999,0,,197,0
George River,1999,0,,198,0
George River,1999,0,,199,0
George River,1999,0,,200,0
George River,1999,0,,201,0
George River,1999,0,,202,0
George River,1999,0,,203,0
George River,1999,3,,204,3
George River,1999,3,,205,6
George River,1999,0,,206,6
George River,1999,1,,207,7
George River,1999,2,,208,9
George River,1999,0,,209,9
George River,1999,1,,210,10
George River,1999,1,,211,11
George River,1999,7,,212,18
George River,1999,2,,213,20
George River,1999,0,,214,20
George River,1999,1,,215,21
George River,1999,5,,216,26
George River,1999,4,,217,30
George River,1999,1,,218,31
George River,1999,3,,219,34
George River,1999,4,,220,38
George River,1999,2,,221,40
George River,1999,1,,222,41
George River,1999,7,,223,48
George River,1999,1,,224,49
George River,1999,9,,225,58
George River,1999,9,,226,67
George River,1999,3,,227,70
George River,1999,3,,228,73
George River,1999,4,,229,77
George River,1999,6,,230,83
George River,1999,2,,231,85
George River,1999,0,,232,85
George River,1999,0,,233,85
George River,1999,6,,234,91
George River,1999,2,,235,93
George River,1999,1,,236,94
George River,1999,0,,237,94
George River,1999,0,,238,94
George River,1999,0,,239,94
George River,1999,0,,240,94
George River,1999,0,,241,94
George River,1999,1,,242,95
George River,1999,0,,243,95
George River,1999,1,,244,96
George River,1999,0,,245,96
George River,1999,0,,246,96
George River,1999,0,,247,96
George River,1999,0,,248,96
George River,1999,0,,249,96
George River,1999,0,,250,96
George River,1999,0,,251,96
George River,1999,1,,252,97
George River,1999,0,,253,97
George River,1999,0,,254,97
George River,1999,0,,255,97
George River,1999,0,,256,97
George River,1999,0,,257,97
George River,1999,0,,258,97
George River,1999,0,,259,97
George River,1999,0,,260,97
George River,1999,0,,261,97
George River,1999,0,,262,97
George River,1999,0,,263,97
George River,1999,0,,264,97
George River,1999,0,,265,97
George River,1999,0,,266,97
George River,1999,0,,267,97
George River,1999,0,,268,97
George River,2000,0,,170,0
George River,2000,0,,171,0
George River,2000,0,,172,0
George River,2000,0,,173,0
George River,2000,0,,174,0
George River,2000,0,,175,0
George River,2000,0,,176,0
George River,2000,0,,177,0
George River,2000,0,,178,0
George River,2000,0,,179,0
George River,2000,0,,180,0
George River,2000,0,,181,0
George River,2000,0,,182,0
George River,2000,2,,183,2
George River,2000,0,,185,2
George River,2000,3,,186,5
George River,2000,0,,188,5
George River,2000,0,,189,5
George River,2000,0,,190,5
George River,2000,2,,191,7
George River,2000,2,,192,9
George River,2000,2,,193,11
George River,2000,0,,194,11
George River,2000,0,,195,11
George River,2000,5,,196,16
George River,2000,1,,197,17
George River,2000,1,,198,18
George River,2000,0,,199,18
George River,2000,5,,200,23
George River,2000,3,,201,26
George River,2000,2,,202,28
George River,2000,1,,203,29
George River,2000,1,,204,30
George River,2000,2,,205,32
George River,2000,4,,206,36
George River,2000,11,,207,47
George River,2000,5,,208,52
George River,2000,0,,209,52
George River,2000,4,,210,56
George River,2000,5,,211,61
George River,2000,0,,212,61
George River,2000,0,,213,61
George River,2000,0,,216,61
George River,2000,0,,217,61
George River,2000,0,,218,61
George River,2000,0,,219,61
George River,2000,0,,220,61
George River,2000,0,,221,61
George River,2000,0,,222,61
George River,2000,0,,223,61
George River,2000,0,,224,61
George River,2000,0,,225,61
George River,2000,0,,226,61
George River,2000,0,,227,61
George River,2000,0,,228,61
George River,2000,0,,229,61
George River,2000,0,,230,61
George River,2000,0,,231,61
George River,2000,0,,232,61
George River,2000,0,,233,61
George River,2000,0,,234,61
George River,2000,0,,235,61
George River,2000,0,,236,61
George River,2000,0,,237,61
George River,2000,0,,238,61
George River,2000,0,,239,61
George River,2000,0,,240,61
George River,2000,0,,241,61
George River,2000,0,,242,61
George River,2000,0,,243,61
George River,2000,0,,244,61
George River,2000,0,,245,61
George River,2000,0,,246,61
George River,2000,0,,247,61
George River,2000,0,,248,61
George River,2000,0,,249,61
George River,2000,0,,250,61
George River,2000,0,,251,61
George River,2000,0,,252,61
George River,2000,0,,253,61
George River,2000,0,,254,61
George River,2000,0,,255,61
George River,2000,0,,256,61
George River,2000,0,,257,61
George River,2000,0,,258,61
George River,2000,0,,259,61
George River,2000,0,,260,61
George River,2001,0,,177,0
George River,2001,0,,178,0
George River,2001,0,,179,0
George River,2001,0,,180,0
George River,2001,0,,181,0
George River,2001,0,,182,0
George River,2001,0,,183,0
George River,2001,0,,184,0
George River,2001,0,,185,0
George River,2001,0,,186,0
George River,2001,0,,187,0
George River,2001,0,,188,0
George River,2001,0,,189,0
George River,2001,0,,190,0
George River,2001,0,,191,0
George River,2001,0,,192,0
George River,2001,0,,193,0
George River,2001,0,,194,0
George River,2001,2,,195,2
George River,2001,1,,196,3
George River,2001,4,,197,7
George River,2001,0,,198,7
George River,2001,2,,199,9
George River,2001,4,,200,13
George River,2001,3,,201,16
George River,2001,9,,202,25
George River,2001,10,,203,35
George River,2001,8,,204,43
George River,2001,1,,205,44
George River,2001,2,,206,46
George River,2001,0,,207,46
George River,2001,1,,208,47
George River,2001,3,,209,50
George River,2001,6,,210,56
George River,2001,0,,211,56
George River,2001,1,,212,57
George River,2001,1,,213,58
George River,2001,1,,214,59
George River,2001,5,,215,64
George River,2001,2,,216,66
George River,2001,7,,217,73
George River,2001,1,,218,74
George River,2001,6,,219,80
George River,2001,0,,220,80
George River,2001,2,,221,82
George River,2001,0,,222,82
George River,2001,0,,223,82
George River,2001,0,,224,82
George River,2001,0,,225,82
George River,2001,1,,226,83
George River,2001,0,,227,83
George River,2001,0,,228,83
George River,2001,0,,229,83
George River,2001,0,,230,83
George River,2001,0,,239,83
George River,2001,0,,240,83
George River,2001,0,,241,83
George River,2001,0,,242,83
George River,2001,0,,243,83
George River,2001,0,,244,83
George River,2001,0,,245,83
George River,2001,0,,246,83
George River,2001,0,,247,83
George River,2001,0,,248,83
George River,2001,0,,249,83
George River,2001,0,,250,83
George River,2001,0,,251,83
George River,2001,0,,252,83
George River,2001,0,,253,83
George River,2001,0,,254,83
George River,2001,0,,255,83
George River,2001,0,,256,83
George River,2001,0,,257,83
George River,2001,0,,258,83
George River,2001,0,,259,83
George River,2001,0,,260,83
George River,2001,0,,261,83
George River,2001,0,,262,83
George River,2001,0,,263,83
George River,2001,0,,264,83
George River,2001,0,,265,83
George River,2002,0,,173,0
George River,2002,0,,174,0
George River,2002,0,,175,0
George River,2002,1,,176,1
George River,2002,0,,177,1
George River,2002,0,,178,1
George River,2002,0,,179,1
George River,2002,0,,180,1
George River,2002,2,,181,3
George River,2002,1,,182,4
George River,2002,0,,183,4
George River,2002,0,,184,4
George River,2002,2,,185,6
George River,2002,5,,186,11
George River,2002,4,,187,15
George River,2002,31,,188,46
George River,2002,35,,189,81
George River,2002,38,,190,119
George River,2002,58,,191,177
George River,2002,160,,192,337
George River,2002,40,,193,377
George River,2002,40,,194,417
George River,2002,57,,195,474
George River,2002,37,,196,511
George River,2002,19,,197,530
George River,2002,30,,198,560
George River,2002,14,,199,574
George River,2002,16,,200,590
George River,2002,3,,201,593
George River,2002,8,,202,601
George River,2002,4,,203,605
George River,2002,2,,204,607
George River,2002,0,,205,607
George River,2002,2,,206,609
George River,2002,2,,207,611
George River,2002,0,,208,611
George River,2002,2,,209,613
George River,2002,6,,210,619
George River,2002,2,,211,621
George River,2002,0,,212,621
George River,2002,1,,213,622
George River,2002,0,,214,622
George River,2002,0,,215,622
George River,2002,1,,216,623
George River,2002,0,,217,623
George River,2002,0,,218,623
George River,2002,0,,219,623
George River,2002,0,,220,623
George River,2002,0,,221,623
George River,2002,0,,222,623
George River,2002,0,,223,623
George River,2002,1,,224,624
George River,2002,0,,225,624
George River,2002,0,,226,624
George River,2002,0,,227,624
George River,2002,0,,228,624
George River,2002,0,,229,624
George River,2002,0,,230,624
George River,2002,0,,231,624
George River,2002,0,,232,624
George River,2002,0,,233,624
George River,2002,3,,234,627
George River,2002,0,,235,627
George River,2002,0,,236,627
George River,2002,0,,237,627
George River,2002,0,,238,627
George River,2002,0,,239,627
George River,2002,0,,240,627
George River,2002,1,,241,628
George River,2002,0,,242,628
George River,2002,0,,243,628
George River,2002,0,,244,628
George River,2002,0,,245,628
George River,2002,1,,246,629
George River,2002,0,,247,629
George River,2002,1,,248,630
George River,2002,0,,249,630
George River,2002,0,,250,630
George River,2002,0,,251,630
George River,2002,0,,252,630
George River,2002,0,,253,630
George River,2002,0,,254,630
George River,2002,0,,255,630
George River,2002,0,,256,630
George River,2002,0,,257,630
George River,2002,0,,258,630
George River,2002,0,,259,630
George River,2002,0,,260,630
George River,2002,0,,261,630
George River,2002,0,,262,630
George River,2002,0,,263,630
George River,2003,18,,189,18
George River,2003,19,,190,37
George River,2003,10,,191,47
George River,2003,1,,192,48
George River,2003,9,,193,57
George River,2003,1,,194,58
George River,2003,10,,195,68
George River,2003,6,,196,74
George River,2003,3,,198,77
George River,2003,5,,199,82
George River,2003,6,,200,88
George River,2003,8,,201,96
George River,2003,11,,202,107
George River,2003,3,,204,110
George River,2003,1,,205,111
George River,2003,2,,207,113
George River,2003,1,,208,114
George River,2003,2,,216,116
George River,2003,2,,217,118
George River,2003,3,,218,121
George River,2003,3,,219,124
George River,2003,2,,221,126
George River,2003,1,,222,127
George River,2003,2,,231,129
George River,2003,1,,232,130
George River,2003,1,,233,131
George River,2003,4,,234,135
George River,2003,2,,235,137
George River,2003,2,,236,139
George River,2003,1,,243,140
George River,2003,1,,248,141
George River,2004,0,,179,0
George River,2004,0,,180,0
George River,2004,0,,181,0
George River,2004,0,,182,0
George River,2004,0,,183,0
George River,2004,1,,184,1
George River,2004,0,,185,1
George River,2004,0,,186,1
George River,2004,0,,187,1
George River,2004,0,,188,1
George River,2004,1,,189,2
George River,2004,2,,190,4
George River,2004,0,,191,4
George River,2004,0,,192,4
George River,2004,3,,193,7
George River,2004,2,,194,9
George River,2004,1,,195,10
George River,2004,0,,196,10
George River,2004,0,,197,10
George River,2004,0,,198,10
George River,2004,0,,199,10
George River,2004,0,,200,10
George River,2004,0,,201,10
George River,2004,1,,202,11
George River,2004,1,,203,12
George River,2004,0,,204,12
George River,2004,0,,205,12
George River,2004,1,,206,13
George River,2004,1,,207,14
George River,2004,2,,208,16
George River,2004,1,,209,17
George River,2004,1,,210,18
George River,2004,0,,211,18
George River,2004,0,,212,18
George River,2004,3,,213,21
George River,2004,1,,214,22
George River,2004,0,,215,22
George River,2004,1,,216,23
George River,2004,0,,217,23
George River,2004,2,,218,25
George River,2004,0,,219,25
George River,2004,0,,220,25
George River,2004,0,,221,25
George River,2004,1,,222,26
George River,2004,0,,223,26
George River,2004,0,,224,26
George River,2004,0,,225,26
George River,2004,0,,226,26
George River,2004,0,,227,26
George River,2004,0,,228,26
George River,2004,0,,229,26
George River,2004,0,,230,26
George River,2004,0,,231,26
George River,2004,0,,232,26
George River,2004,0,,233,26
George River,2004,0,,234,26
George River,2004,0,,235,26
George River,2004,0,,236,26
George River,2004,0,,237,26
George River,2004,0,,238,26
George River,2004,0,,239,26
George River,2004,0,,240,26
George River,2004,0,,241,26
George River,2004,0,,242,26
George River,2004,1,,243,27
George River,2004,2,,244,29
George River,2004,2,,245,31
George River,2004,2,,246,33
George River,2004,0,,247,33
George River,2004,0,,248,33
George River,2004,0,,249,33
George River,2004,0,,250,33
George River,2004,3,,251,36
George River,2004,0,,252,36
George River,2004,0,,253,36
George River,2004,0,,254,36
George River,2004,0,,255,36
George River,2004,0,,256,36
George River,2004,0,,257,36
George River,2004,0,,258,36
George River,2004,0,,259,36
George River,2004,0,,260,36
George River,2004,0,,261,36
George River,2004,0,,262,36
George River,2004,0,,263,36
George River,2004,0,,264,36
George River,2004,0,,265,36
George River,2004,1,,266,37
George River,2004,0,,267,37
George River,2004,0,,268,37
George River,2005,2,,188,2
George River,2005,1,,189,3
George River,2005,3,,190,6
George River,2005,1,,191,7
George River,2005,4,,193,11
George River,2005,8,,195,19
George River,2005,6,,196,25
George River,2005,3,,197,28
George River,2005,8,,198,36
George River,2005,1,,199,37
George River,2005,11,,201,48
George River,2005,7,,202,55
George River,2005,1,,203,56
George River,2005,2,,204,58
George River,2005,2,,206,60
George River,2005,1,,207,61
George River,2005,1,,210,62
George River,2005,1,,211,63
George River,2005,1,,212,64
George River,2005,2,,213,66
George River,2005,1,,216,67
George River,2005,1,,221,68
George River,2005,1,,222,69
George River,2005,1,,224,70
George River,2005,2,,229,72
George River,2005,1,,230,73
George River,2005,2,,232,75
George River,2005,1,,242,76
George River,2005,1,,252,77
George River,2006,0,,166,0
George River,2006,0,,167,0
George River,2006,0,,168,0
George River,2006,0,,169,0
George River,2006,0,,170,0
George River,2006,0,,171,0
George River,2006,0,,172,0
George River,2006,0,,173,0
George River,2006,0,,174,0
George River,2006,0,,175,0
George River,2006,0,,176,0
George River,2006,0,,177,0
George River,2006,1,,178,1
George River,2006,0,,179,1
George River,2006,0,,180,1
George River,2006,0,,181,1
George River,2006,1,,182,2
George River,2006,1,,183,3
George River,2006,2,,184,5
George River,2006,24,,185,29
George River,2006,8,,186,37
George River,2006,37,,187,74
George River,2006,14,,188,88
George River,2006,14,,189,102
George River,2006,13,,190,115
George River,2006,26,,191,141
George River,2006,21,,192,162
George River,2006,34,,193,196
George River,2006,17,,194,213
George River,2006,6,,195,219
George River,2006,2,,196,221
George River,2006,30,,197,251
George River,2006,80,,198,331
George River,2006,92,,199,423
George River,2006,138,,200,561
George River,2006,155,,201,716
George River,2006,152,,202,868
George River,2006,77,,203,945
George River,2006,60,,204,1005
George River,2006,44,,205,1049
George River,2006,19,,206,1068
George River,2006,19,,207,1087
George River,2006,23,,208,1110
George River,2006,13,,209,1123
George River,2006,9,,210,1132
George River,2006,10,,211,1142
George River,2006,10,,212,1152
George River,2006,9,,213,1161
George River,2006,8,,214,1169
George River,2006,9,,215,1178
George River,2006,17,,216,1195
George River,2006,9,,217,1204
George River,2006,4,,218,1208
George River,2006,6,,219,1214
George River,2006,1,,220,1215
George River,2006,1,,221,1216
George River,2006,2,,222,1218
George River,2006,1,,223,1219
George River,2006,2,,224,1221
George River,2006,0,,225,1221
George River,2006,1,,226,1222
George River,2006,0,,227,1222
George River,2006,0,,228,1222
George River,2006,0,,229,1222
George River,2006,0,,230,1222
George River,2006,0,,238,1222
George River,2006,0,,239,1222
George River,2006,1,,240,1223
George River,2006,1,,241,1224
George River,2006,0,,242,1224
George River,2006,2,,243,1226
George River,2006,1,,244,1227
George River,2006,0,,245,1227
George River,2006,0,,246,1227
George River,2006,1,,247,1228
George River,2006,0,,248,1228
George River,2006,0,,249,1228
George River,2006,0,,250,1228
George River,2006,1,,251,1229
George River,2006,0,,252,1229
George River,2006,2,,253,1231
George River,2006,0,,254,1231
George River,2006,0,,255,1231
George River,2006,0,,256,1231
George River,2006,1,,257,1232
George River,2006,0,,258,1232
George River,2006,0,,259,1232
George River,2006,0,,260,1232
George River,2006,0,,261,1232
George River,2006,0,,262,1232
George River,2006,0,,263,1232
George River,2007,2,,186,2
George River,2007,1,,188,3
George River,2007,1,,189,4
George River,2007,1,,190,5
George River,2007,11,,191,16
George River,2007,1,,192,17
George River,2007,7,,193,24
George River,2007,4,,194,28
George River,2007,2,,195,30
George River,2007,3,,203,33
George River,2007,6,,204,39
George River,2007,13,,205,52
George River,2007,36,,206,88
George River,2007,106,,207,194
George River,2007,21,,208,215
George River,2007,15,,209,230
George River,2007,10,,210,240
George River,2007,2,,211,242
George River,2007,10,,212,252
George River,2007,2,,213,254
George River,2007,4,,214,258
George River,2007,8,,215,266
George River,2007,2,,216,268
George River,2007,1,,217,269
George River,2007,2,,222,271
George River,2007,1,,225,272
George River,2007,4,,226,276
George River,2007,1,,227,277
George River,2007,2,,228,279
George River,2007,2,,229,281
George River,2007,1,,230,282
George River,2007,1,,236,283
George River,2007,1,,256,284
George River,2008,9,,189,9
George River,2008,21,,190,30
George River,2008,11,,191,41
George River,2008,5,,192,46
George River,2008,12,,193,58
George River,2008,29,,194,87
George River,2008,43,,195,130
George River,2008,47,,196,177
George River,2008,53,,197,230
George River,2008,42,,198,272
George River,2008,59,,199,331
George River,2008,35,,200,366
George River,2008,88,,201,454
George River,2008,52,,202,506
George River,2008,77,,203,583
George River,2008,153,,204,736
George River,2008,105,,205,841
George River,2008,110,,206,951
George River,2008,174,,207,1125
George River,2008,370,,208,1495
George River,2008,168,,209,1663
George River,2008,113,,210,1776
George River,2008,99,,211,1875
George River,2008,134,,212,2009
George River,2008,61,,213,2070
George River,2008,107,,214,2177
George River,2008,59,,215,2236
George River,2008,33,,216,2269
George River,2008,60,,217,2329
George River,2008,23,,218,2352
George River,2008,21,,219,2373
George River,2008,12,,220,2385
George River,2008,15,,221,2400
George River,2008,5,,222,2405
George River,2008,2,,223,2407
George River,2008,9,,224,2416
George River,2008,3,,225,2419
George River,2008,1,,226,2420
George River,2008,1,,227,2421
George River,2008,1,,228,2422
George River,2008,6,,229,2428
George River,2008,2,,230,2430
George River,2008,3,,231,2433
George River,2008,5,,232,2438
George River,2008,0,,233,2438
George River,2008,1,,234,2439
George River,2008,2,,235,2441
George River,2008,0,,236,2441
George River,2008,0,,237,2441
George River,2008,0,,238,2441
George River,2008,0,,239,2441
George River,2008,1,,240,2442
George River,2008,0,,241,2442
George River,2008,2,,242,2444
George River,2008,0,,243,2444
George River,2008,0,,244,2444
George River,2008,0,,245,2444
George River,2008,0,,246,2444
George River,2008,0,,247,2444
George River,2008,0,,248,2444
George River,2008,0,,249,2444
George River,2008,0,,250,2444
George River,2008,0,,251,2444
George River,2008,0,,252,2444
George River,2008,0,,253,2444
George River,2008,0,,254,2444
George River,2008,0,,255,2444
George River,2008,0,,256,2444
George River,2008,0,,257,2444
George River,2008,0,,258,2444
George River,2008,0,,259,2444
George River,2008,0,,260,2444
George River,2008,0,,261,2444
George River,2008,0,,262,2444
George River,2008,0,,263,2444
George River,2008,0,,264,2444
George River,2008,0,,265,2444
George River,2008,0,,266,2444
George River,2009,0,,168,0
George River,2009,0,,169,0
George River,2009,0,,170,0
George River,2009,0,,171,0
George River,2009,0,,172,0
George River,2009,0,,173,0
George River,2009,0,,174,0
George River,2009,0,,175,0
George River,2009,0,,176,0
George River,2009,0,,177,0
George River,2009,0,,178,0
George River,2009,0,,179,0
George River,2009,0,,180,0
George River,2009,0,,181,0
George River,2009,0,,182,0
George River,2009,0,,183,0
George River,2009,0,,184,0
George River,2009,0,,185,0
George River,2009,0,,186,0
George River,2009,4,,187,4
George River,2009,6,,188,10
George River,2009,1,,189,11
George River,2009,0,,190,11
George River,2009,5,,191,16
George River,2009,21,,192,37
George River,2009,18,,193,55
George River,2009,6,,194,61
George River,2009,18,,195,79
George River,2009,1,,196,80
George River,2009,5,,197,85
George River,2009,8,,198,93
George River,2009,6,,199,99
George River,2009,8,,200,107
George River,2009,13,,201,120
George River,2009,8,,202,128
George River,2009,13,,203,141
George River,2009,15,,204,156
George River,2009,8,,205,164
George River,2009,13,,206,177
George River,2009,17,,207,194
George River,2009,13,,208,207
George River,2009,17,,209,224
George River,2009,21,,210,245
George River,2009,11,,211,256
George River,2009,16,,212,272
George River,2009,4,,213,276
George River,2009,20,,214,296
George River,2009,7,,215,303
George River,2009,1,,216,304
George River,2009,1,,217,305
George River,2009,6,,218,311
George River,2009,1,,219,312
George River,2009,0,,220,312
George River,2009,0,,221,312
George River,2009,0,,222,312
George River,2009,1,,223,313
George River,2009,0,,224,313
George River,2009,2,,225,315
George River,2009,0,,226,315
George River,2009,2,,227,317
George River,2009,0,,228,317
George River,2009,0,,229,317
George River,2009,0,,230,317
George River,2009,0,,231,317
George River,2009,0,,232,317
George River,2009,0,,233,317
George River,2009,0,,234,317
George River,2009,0,,235,317
George River,2009,0,,236,317
George River,2009,0,,237,317
George River,2009,0,,238,317
George River,2009,0,,239,317
George River,2009,1,,240,318
George River,2009,0,,241,318
George River,2009,0,,242,318
George River,2009,0,,243,318
George River,2009,0,,244,318
George River,2009,0,,245,318
George River,2009,0,,246,318
George River,2009,0,,247,318
George River,2009,0,,248,318
George River,2009,0,,249,318
George River,2009,0,,250,318
George River,2009,0,,251,318
George River,2009,0,,252,318
George River,2009,0,,253,318
George River,2009,0,,254,318
George River,2009,0,,255,318
George River,2009,0,,256,318
George River,2009,0,,257,318
George River,2009,0,,258,318
George River,2009,0,,259,318
George River,2009,0,,260,318
George River,2009,0,,261,318
George River,2009,0,,262,318
George River,2009,0,,263,318
George River,2009,0,,264,318
George River,2009,0,,265,318
George River,2009,0,,266,318
George River,2009,0,,267,318
George River,2009,0,,268,318
George River,2010,0,,166,0
George River,2010,0,,167,0
George River,2010,0,,168,0
George River,2010,0,,169,0
George River,2010,0,,170,0
George River,2010,0,,171,0
George River,2010,0,,172,0
George River,2010,0,,173,0
George River,2010,0,,174,0
George River,2010,0,,175,0
George River,2010,0,,176,0
George River,2010,0,,177,0
George River,2010,0,,178,0
George River,2010,0,,179,0
George River,2010,0,,180,0
George River,2010,0,,181,0
George River,2010,0,,182,0
George River,2010,0,,183,0
George River,2010,1,,184,1
George River,2010,0,,185,1
George River,2010,10,,186,11
George River,2010,3,,187,14
George River,2010,12,,188,26
George River,2010,25,,189,51
George River,2010,20,,190,71
George River,2010,21,,191,92
George River,2010,23,,192,115
George River,2010,20,,193,135
George River,2010,40,,194,175
George River,2010,42,,195,217
George River,2010,21,,196,238
George River,2010,34,,197,272
George River,2010,32,,198,304
George River,2010,50,,199,354
George River,2010,30,,200,384
George River,2010,25,,201,409
George River,2010,20,,202,429
George River,2010,21,,203,450
George River,2010,20,,204,470
George River,2010,37,,205,507
George River,2010,55,,206,562
George River,2010,65,,207,627
George River,2010,47,,208,674
George River,2010,57,,209,731
George River,2010,26,,210,757
George River,2010,21,,211,778
George River,2010,22,,212,800
George River,2010,13,,213,813
George River,2010,7,,214,820
George River,2010,12,,215,832
George River,2010,12,,216,844
George River,2010,4,,217,848
George River,2010,1,,218,849
George River,2010,2,,219,851
George River,2010,4,,220,855
George River,2010,2,,221,857
George River,2010,1,,222,858
George River,2010,0,,223,858
George River,2010,0,,224,858
George River,2010,0,,225,858
George River,2010,2,,226,860
George River,2010,0,,227,860
George River,2010,2,,228,862
George River,2010,0,,229,862
George River,2010,0,,230,862
George River,2010,0,,231,862
George River,2010,0,,232,862
George River,2010,0,,233,862
George River,2010,1,,234,863
George River,2010,0,,235,863
George River,2010,0,,236,863
George River,2010,0,,237,863
George River,2010,0,,238,863
George River,2010,2,,239,865
George River,2010,0,,240,865
George River,2010,0,,241,865
George River,2010,0,,242,865
George River,2010,0,,243,865
George River,2010,0,,244,865
George River,2010,0,,245,865
George River,2010,0,,246,865
George River,2010,0,,247,865
George River,2010,0,,248,865
George River,2010,0,,249,865
George River,2010,1,,250,866
George River,2010,0,,251,866
George River,2010,1,,252,867
George River,2010,0,,253,867
George River,2010,1,,254,868
George River,2010,0,,255,868
George River,2010,0,,256,868
George River,2010,0,,257,868
George River,2010,1,,258,869
George River,2010,0,,259,869
George River,2010,0,,260,869
George River,2010,0,,261,869
George River,2010,0,,262,869
George River,2010,0,,263,869
George River,2011,0,,167,0
George River,2011,0,,168,0
George River,2011,0,,169,0
George River,2011,0,,170,0
George River,2011,0,,171,0
George River,2011,0,,172,0
George River,2011,0,,173,0
George River,2011,0,,174,0
George River,2011,0,,175,0
George River,2011,0,,176,0
George River,2011,0,,177,0
George River,2011,0,,178,0
George River,2011,0,,179,0
George River,2011,0,,180,0
George River,2011,0,,181,0
George River,2011,0,,182,0
George River,2011,0,,183,0
George River,2011,0,,184,0
George River,2011,0,,185,0
George River,2011,0,,186,0
George River,2011,1,,187,1
George River,2011,2,,188,3
George River,2011,3,,189,6
George River,2011,0,,190,6
George River,2011,2,,191,8
George River,2011,1,,192,9
George River,2011,17,,193,26
George River,2011,26,,194,52
George River,2011,22,,195,74
George River,2011,11,,196,85
George River,2011,8,,197,93
George River,2011,12,,198,105
George River,2011,16,,199,121
George River,2011,26,,200,147
George River,2011,44,,201,191
George River,2011,74,,202,265
George River,2011,53,,203,318
George River,2011,46,,204,364
George River,2011,34,,205,398
George River,2011,37,,206,435
George River,2011,37,,207,472
George River,2011,36,,208,508
George River,2011,37,,209,545
George River,2011,17,,210,562
George River,2011,14,,211,576
George River,2011,8,,212,584
George River,2011,38,,213,622
George River,2011,37,,214,659
George River,2011,43,,215,702
George River,2011,39,,216,741
George River,2011,13,,217,754
George River,2011,19,,218,773
George River,2011,3,,219,776
George River,2011,2,,237,778
George River,2011,1,,238,779
George River,2011,0,,239,779
George River,2011,0,,240,779
George River,2011,1,,241,780
George River,2011,0,,242,780
George River,2011,1,,243,781
George River,2011,1,,244,782
George River,2011,0,,245,782
George River,2011,0,,246,782
George River,2011,0,,247,782
George River,2011,0,,248,782
George River,2011,1,,249,783
George River,2011,0,,250,783
George River,2011,0,,251,783
George River,2011,0,,252,783
George River,2011,0,,253,783
George River,2011,0,,254,783
George River,2011,0,,255,783
George River,2011,0,,256,783
George River,2011,0,,257,783
George River,2011,0,,258,783
George River,2011,0,,259,783
George River,2011,0,,260,783
George River,2011,0,,261,783
George River,2011,0,,262,783
George River,2011,0,,263,783
George River,2012,3,Note: note above report says estimates are incomplete because pinks can slip through wier,182,3
George River,2012,19,,183,22
George River,2012,17,,184,39
George River,2012,17,,185,56
George River,2012,11,,186,67
George River,2012,29,,187,96
George River,2012,12,,188,108
George River,2012,54,,189,162
George River,2012,48,,190,210
George River,2012,17,,191,227
George River,2012,45,,192,272
George River,2012,66,,193,338
George River,2012,78,,194,416
George River,2012,142,,195,558
George River,2012,87,,196,645
George River,2012,132,,197,777
George River,2012,227,,198,1004
George River,2012,306,,199,1310
George River,2012,282,,200,1592
George River,2012,383,,201,1975
George River,2012,305,,202,2280
George River,2012,333,,203,2613
George River,2012,442,,204,3055
George River,2012,587,,205,3642
George River,2012,397,,206,4039
George River,2012,475,,207,4514
George River,2012,423,,208,4937
George River,2012,316,,209,5253
George River,2012,391,,210,5644
George River,2012,144,,211,5788
George River,2012,93,,212,5881
George River,2012,74,,213,5955
George River,2012,50,,214,6005
George River,2012,37,,215,6042
George River,2012,55,,216,6097
George River,2012,36,,217,6133
George River,2012,28,,218,6161
George River,2012,29,,219,6190
George River,2012,18,,220,6208
George River,2012,10,,221,6218
George River,2012,12,,222,6230
George River,2012,6,,223,6236
George River,2012,6,,224,6242
George River,2012,4,,225,6246
George River,2012,5,,226,6251
George River,2012,5,,227,6256
George River,2012,5,,228,6261
George River,2012,1,,229,6262
George River,2012,1,,230,6263
George River,2012,1,,231,6264
George River,2012,1,,236,6265
George River,2012,4,,241,6269
George River,2012,1,,243,6270
George River,2012,1,,249,6271
Goodnews River,1981,0,,182,0
Goodnews River,1981,0,,183,0
Goodnews River,1981,0,,184,0
Goodnews River,1981,0,,185,0
Goodnews River,1981,0,,186,0
Goodnews River,1981,2,,187,2
Goodnews River,1981,2,,188,4
Goodnews River,1981,9,,189,13
Goodnews River,1981,9,,190,22
Goodnews River,1981,17,,191,39
Goodnews River,1981,10,,192,49
Goodnews River,1981,13,,193,62
Goodnews River,1981,16,,194,78
Goodnews River,1981,15,,195,93
Goodnews River,1981,26,,196,119
Goodnews River,1981,47,,197,166
Goodnews River,1981,64,,198,230
Goodnews River,1981,48,,199,278
Goodnews River,1981,81,,200,359
Goodnews River,1981,101,,201,460
Goodnews River,1981,58,,202,518
Goodnews River,1981,123,,203,641
Goodnews River,1981,161,,204,802
Goodnews River,1981,76,,205,878
Goodnews River,1981,41,,206,919
Goodnews River,1981,48,,207,967
Goodnews River,1981,55,,208,1022
Goodnews River,1981,63,,209,1085
Goodnews River,1981,12,,210,1097
Goodnews River,1981,18,,211,1115
Goodnews River,1981,26,,212,1141
Goodnews River,1981,25,,213,1166
Goodnews River,1981,37,,214,1203
Goodnews River,1981,17,,215,1220
Goodnews River,1981,22,,216,1242
Goodnews River,1981,18,,217,1260
Goodnews River,1981,7,,218,1267
Goodnews River,1981,16,,219,1283
Goodnews River,1981,19,,220,1302
Goodnews River,1981,4,,221,1306
Goodnews River,1981,6,,222,1312
Goodnews River,1981,11,,223,1323
Goodnews River,1981,2,,224,1325
Goodnews River,1981,1,,225,1326
Goodnews River,1981,1,,226,1327
Goodnews River,1981,0,,227,1327
Goodnews River,1982,0,,174,0
Goodnews River,1982,0,,175,0
Goodnews River,1982,0,,176,0
Goodnews River,1982,0,,177,0
Goodnews River,1982,0,,178,0
Goodnews River,1982,0,,179,0
Goodnews River,1982,0,,180,0
Goodnews River,1982,0,,181,0
Goodnews River,1982,0,,182,0
Goodnews River,1982,0,,183,0
Goodnews River,1982,0,,184,0
Goodnews River,1982,0,,185,0
Goodnews River,1982,3,,186,3
Goodnews River,1982,1,,187,4
Goodnews River,1982,4,,188,8
Goodnews River,1982,10,,189,18
Goodnews River,1982,42,,190,60
Goodnews River,1982,17,,191,77
Goodnews River,1982,61,,192,138
Goodnews River,1982,105,,193,243
Goodnews River,1982,225,,194,468
Goodnews River,1982,227,,195,695
Goodnews River,1982,183,,196,878
Goodnews River,1982,413,,197,1291
Goodnews River,1982,255,,198,1546
Goodnews River,1982,183,,199,1729
Goodnews River,1982,110,,200,1839
Goodnews River,1982,223,,201,2062
Goodnews River,1982,484,,202,2546
Goodnews River,1982,858,,203,3404
Goodnews River,1982,848,,204,4252
Goodnews River,1982,837,,205,5089
Goodnews River,1982,827,,206,5916
Goodnews River,1982,817,,207,6733
Goodnews River,1982,994,,208,7727
Goodnews River,1982,680,,209,8407
Goodnews River,1982,520,,210,8927
Goodnews River,1982,525,,211,9452
Goodnews River,1982,1144,,212,10596
Goodnews River,1982,1083,,213,11679
Goodnews River,1982,1022,,214,12701
Goodnews River,1982,1154,,215,13855
Goodnews River,1984,0,,167,0
Goodnews River,1984,0,,168,0
Goodnews River,1984,0,,169,0
Goodnews River,1984,0,,170,0
Goodnews River,1984,0,,171,0
Goodnews River,1984,0,,172,0
Goodnews River,1984,0,,173,0
Goodnews River,1984,0,,174,0
Goodnews River,1984,0,,175,0
Goodnews River,1984,0,,176,0
Goodnews River,1984,0,,177,0
Goodnews River,1984,0,,178,0
Goodnews River,1984,0,,179,0
Goodnews River,1984,0,,180,0
Goodnews River,1984,0,,181,0
Goodnews River,1984,0,,182,0
Goodnews River,1984,0,,183,0
Goodnews River,1984,0,,184,0
Goodnews River,1984,11,,185,11
Goodnews River,1984,10,,186,21
Goodnews River,1984,8,,187,29
Goodnews River,1984,18,,188,47
Goodnews River,1984,18,,189,65
Goodnews River,1984,42,,190,107
Goodnews River,1984,84,,191,191
Goodnews River,1984,61,,192,252
Goodnews River,1984,431,,193,683
Goodnews River,1984,266,,194,949
Goodnews River,1984,176,,195,1125
Goodnews River,1984,276,,196,1401
Goodnews River,1984,459,,197,1860
Goodnews River,1984,642,,198,2502
Goodnews River,1984,1457,,199,3959
Goodnews River,1984,973,,200,4932
Goodnews River,1984,510,,201,5442
Goodnews River,1984,363,,202,5805
Goodnews River,1984,676,,203,6481
Goodnews River,1984,702,,204,7183
Goodnews River,1984,727,,205,7910
Goodnews River,1984,597,,206,8507
Goodnews River,1984,491,,207,8998
Goodnews River,1984,753,,208,9751
Goodnews River,1984,789,,209,10540
Goodnews River,1984,1071,,210,11611
Goodnews River,1984,871,,211,12482
Goodnews River,1984,671,,212,13153
Goodnews River,1984,591,,213,13744
Goodnews River,1985,0,,178,0
Goodnews River,1985,0,,179,0
Goodnews River,1985,0,,180,0
Goodnews River,1985,0,,181,0
Goodnews River,1985,0,,182,0
Goodnews River,1985,0,,183,0
Goodnews River,1985,0,,184,0
Goodnews River,1985,0,,185,0
Goodnews River,1985,0,,186,0
Goodnews River,1985,0,,187,0
Goodnews River,1985,0,,188,0
Goodnews River,1985,0,,189,0
Goodnews River,1985,0,,190,0
Goodnews River,1985,0,,191,0
Goodnews River,1985,0,,192,0
Goodnews River,1985,0,,193,0
Goodnews River,1985,0,,194,0
Goodnews River,1985,0,,195,0
Goodnews River,1985,0,,196,0
Goodnews River,1985,0,,197,0
Goodnews River,1985,0,,198,0
Goodnews River,1985,0,,199,0
Goodnews River,1985,0,,200,0
Goodnews River,1985,9,,201,9
Goodnews River,1985,5,,202,14
Goodnews River,1985,0,,203,14
Goodnews River,1985,0,,204,14
Goodnews River,1985,3,,205,17
Goodnews River,1985,27,,206,44
Goodnews River,1985,58,,207,102
Goodnews River,1985,7,,208,109
Goodnews River,1985,6,,209,115
Goodnews River,1985,4,,210,119
Goodnews River,1985,18,,211,137
Goodnews River,1985,7,,212,144
Goodnews River,1986,0,,167,0
Goodnews River,1986,0,,168,0
Goodnews River,1986,0,,169,0
Goodnews River,1986,0,,170,0
Goodnews River,1986,0,,171,0
Goodnews River,1986,0,,172,0
Goodnews River,1986,0,,173,0
Goodnews River,1986,0,,174,0
Goodnews River,1986,0,,175,0
Goodnews River,1986,0,,176,0
Goodnews River,1986,0,,177,0
Goodnews River,1986,0,,178,0
Goodnews River,1986,0,,179,0
Goodnews River,1986,0,,180,0
Goodnews River,1986,0,,181,0
Goodnews River,1986,0,,182,0
Goodnews River,1986,0,,183,0
Goodnews River,1986,0,,184,0
Goodnews River,1986,4,,185,4
Goodnews River,1986,7,,186,11
Goodnews River,1986,16,,187,27
Goodnews River,1986,25,,188,52
Goodnews River,1986,60,,189,112
Goodnews River,1986,20,,190,132
Goodnews River,1986,93,,191,225
Goodnews River,1986,63,,192,288
Goodnews River,1986,117,,193,405
Goodnews River,1986,175,,194,580
Goodnews River,1986,232,,195,812
Goodnews River,1986,644,,196,1456
Goodnews River,1986,346,,197,1802
Goodnews River,1986,329,,198,2131
Goodnews River,1986,532,,199,2663
Goodnews River,1986,481,,200,3144
Goodnews River,1986,924,,201,4068
Goodnews River,1986,1366,,202,5434
Goodnews River,1986,1376,,203,6810
Goodnews River,1986,987,,204,7797
Goodnews River,1986,337,,205,8134
Goodnews River,1987,0,,173,0
Goodnews River,1987,0,,174,0
Goodnews River,1987,0,,175,0
Goodnews River,1987,0,,176,0
Goodnews River,1987,0,,177,0
Goodnews River,1987,0,,178,0
Goodnews River,1987,0,,179,0
Goodnews River,1987,0,,180,0
Goodnews River,1987,0,,181,0
Goodnews River,1987,0,,182,0
Goodnews River,1987,0,,183,0
Goodnews River,1987,0,,184,0
Goodnews River,1987,0,,185,0
Goodnews River,1987,0,,186,0
Goodnews River,1987,0,,187,0
Goodnews River,1987,0,,188,0
Goodnews River,1987,0,,189,0
Goodnews River,1987,0,,190,0
Goodnews River,1987,0,,191,0
Goodnews River,1987,0,,192,0
Goodnews River,1987,0,,193,0
Goodnews River,1987,0,,194,0
Goodnews River,1987,0,,195,0
Goodnews River,1987,4,,196,4
Goodnews River,1987,0,,197,4
Goodnews River,1987,6,,198,10
Goodnews River,1987,3,,199,13
Goodnews River,1987,5,,200,18
Goodnews River,1987,8,,201,26
Goodnews River,1987,17,,202,43
Goodnews River,1987,3,,203,46
Goodnews River,1987,3,,204,49
Goodnews River,1987,7,,205,56
Goodnews River,1987,4,,206,60
Goodnews River,1987,0,,207,60
Goodnews River,1987,-4,,208,56
Goodnews River,1987,0,,209,56
Goodnews River,1987,0,,210,56
Goodnews River,1987,7,,211,63
Goodnews River,1988,0,,175,0
Goodnews River,1988,0,,176,0
Goodnews River,1988,0,,177,0
Goodnews River,1988,0,,178,0
Goodnews River,1988,0,,179,0
Goodnews River,1988,0,,180,0
Goodnews River,1988,0,,181,0
Goodnews River,1988,0,,182,0
Goodnews River,1988,13,,183,13
Goodnews River,1988,23,,184,36
Goodnews River,1988,23,,185,59
Goodnews River,1988,23,,186,82
Goodnews River,1988,23,,187,105
Goodnews River,1988,13,,188,118
Goodnews River,1988,32,,189,150
Goodnews River,1988,23,,190,173
Goodnews River,1988,96,,191,269
Goodnews River,1988,102,,192,371
Goodnews River,1988,108,,193,479
Goodnews River,1988,234,,194,713
Goodnews River,1988,321,,195,1034
Goodnews River,1988,450,,196,1484
Goodnews River,1988,330,,197,1814
Goodnews River,1988,399,,198,2213
Goodnews River,1988,425,,199,2638
Goodnews River,1988,451,,200,3089
Goodnews River,1988,163,,201,3252
Goodnews River,1988,279,,202,3531
Goodnews River,1988,304,,203,3835
Goodnews River,1988,688,,204,4523
Goodnews River,1988,438,,205,4961
Goodnews River,1988,283,,206,5244
Goodnews River,1988,127,,207,5371
Goodnews River,1988,186,,208,5557
Goodnews River,1988,302,,209,5859
Goodnews River,1988,390,,210,6249
Goodnews River,1988,348,,211,6597
Goodnews River,1988,184,,212,6781
Goodnews River,1989,0,,179,0
Goodnews River,1989,0,,180,0
Goodnews River,1989,0,,181,0
Goodnews River,1989,0,,182,0
Goodnews River,1989,0,,183,0
Goodnews River,1989,0,,184,0
Goodnews River,1989,0,,185,0
Goodnews River,1989,0,,186,0
Goodnews River,1989,4,,187,4
Goodnews River,1989,0,,188,4
Goodnews River,1989,0,,189,4
Goodnews River,1989,0,,190,4
Goodnews River,1989,0,,191,4
Goodnews River,1989,0,,192,4
Goodnews River,1989,0,,193,4
Goodnews River,1989,7,,194,11
Goodnews River,1989,14,,195,25
Goodnews River,1989,7,,196,32
Goodnews River,1989,10,,197,42
Goodnews River,1989,12,,198,54
Goodnews River,1989,18,,199,72
Goodnews River,1989,17,,200,89
Goodnews River,1989,24,,201,113
Goodnews River,1989,10,,202,123
Goodnews River,1989,27,,203,150
Goodnews River,1989,23,,204,173
Goodnews River,1989,18,,205,191
Goodnews River,1989,21,,206,212
Goodnews River,1989,9,,207,221
Goodnews River,1989,10,,208,231
Goodnews River,1989,0,,209,231
Goodnews River,1989,7,,210,238
Goodnews River,1989,5,,211,243
Goodnews River,1989,3,,212,246
Goodnews River,1990,0,,171,0
Goodnews River,1990,0,,172,0
Goodnews River,1990,0,,173,0
Goodnews River,1990,0,,174,0
Goodnews River,1990,0,,175,0
Goodnews River,1990,0,,176,0
Goodnews River,1990,0,,177,0
Goodnews River,1990,0,,178,0
Goodnews River,1990,0,,179,0
Goodnews River,1990,0,,180,0
Goodnews River,1990,0,,181,0
Goodnews River,1990,2,,182,2
Goodnews River,1990,4,,183,6
Goodnews River,1990,6,,184,12
Goodnews River,1990,12,,185,24
Goodnews River,1990,18,,186,42
Goodnews River,1990,31,,187,73
Goodnews River,1990,66,,188,139
Goodnews River,1990,89,,189,228
Goodnews River,1990,111,,190,339
Goodnews River,1990,142,,191,481
Goodnews River,1990,183,,192,664
Goodnews River,1990,115,,193,779
Goodnews River,1990,236,,194,1015
Goodnews River,1990,139,,195,1154
Goodnews River,1990,221,,196,1375
Goodnews River,1990,302,,197,1677
Goodnews River,1990,274,,198,1951
Goodnews River,1990,354,,199,2305
Goodnews River,1990,122,,200,2427
Goodnews River,1990,222,,201,2649
Goodnews River,1990,177,,202,2826
Goodnews River,1990,214,,203,3040
Goodnews River,1990,251,,204,3291
Goodnews River,1990,87,,205,3378
Goodnews River,1991,0,,179,0
Goodnews River,1991,0,,180,0
Goodnews River,1991,0,,181,0
Goodnews River,1991,0,,182,0
Goodnews River,1991,0,,183,0
Goodnews River,1991,8,,184,8
Goodnews River,1991,27,,185,35
Goodnews River,1991,29,,186,64
Goodnews River,1991,48,,187,112
Goodnews River,1991,65,,188,177
Goodnews River,1991,107,,189,284
Goodnews River,1991,202,,190,486
Goodnews River,1991,339,,191,825
Goodnews River,1991,133,,192,958
Goodnews River,1991,69,,193,1027
Goodnews River,1991,12,,194,1039
Goodnews River,1991,35,,195,1074
Goodnews River,1991,51,,196,1125
Goodnews River,1991,27,,197,1152
Goodnews River,1991,15,,198,1167
Goodnews River,1991,12,,199,1179
Goodnews River,1991,58,,200,1237
Goodnews River,1991,19,,201,1256
Goodnews River,1991,28,,202,1284
Goodnews River,1991,43,,203,1327
Goodnews River,1991,57,,204,1384
Goodnews River,1991,39,,205,1423
Goodnews River,1991,33,,206,1456
Goodnews River,1991,21,,207,1477
Goodnews River,1991,19,,208,1496
Goodnews River,1991,25,,209,1521
Goodnews River,1991,19,,210,1540
Goodnews River,1991,31,,211,1571
Goodnews River,1991,12,,212,1583
Goodnews River,1991,35,,213,1618
Goodnews River,1991,11,,214,1629
Goodnews River,1991,6,,215,1635
Goodnews River,1991,5,,216,1640
Goodnews River,1991,3,,217,1643
Goodnews River,1991,13,,218,1656
Goodnews River,1991,1,,219,1657
Goodnews River,1991,3,,220,1660
Goodnews River,1991,2,,221,1662
Goodnews River,1991,10,,222,1672
Goodnews River,1991,2,,223,1674
Goodnews River,1991,2,,224,1676
Goodnews River,1991,0,,225,1676
Goodnews River,1991,0,,226,1676
Goodnews River,1991,1,,227,1677
Goodnews River,1991,1,,228,1678
Goodnews River,1991,1,,229,1679
Goodnews River,1991,1,,230,1680
Goodnews River,1991,1,,231,1681
Goodnews River,1991,1,,232,1682
Goodnews River,1991,0,,233,1682
Goodnews River,1991,3,,234,1685
Goodnews River,1991,4,,235,1689
Goodnews River,1991,2,,236,1691
Goodnews River,1991,3,,237,1694
Goodnews River,1992,0,,173,0
Goodnews River,1992,0,,174,0
Goodnews River,1992,0,,175,0
Goodnews River,1992,0,,176,0
Goodnews River,1992,0,,177,0
Goodnews River,1992,0,,178,0
Goodnews River,1992,4,,179,4
Goodnews River,1992,0,,180,4
Goodnews River,1992,,,181,4
Goodnews River,1992,,,182,4
Goodnews River,1992,6,,183,10
Goodnews River,1992,10,,184,20
Goodnews River,1992,13,,185,33
Goodnews River,1992,14,,186,47
Goodnews River,1992,15,,187,62
Goodnews River,1992,18,,188,80
Goodnews River,1992,32,,189,112
Goodnews River,1992,322,,190,434
Goodnews River,1992,41,,191,475
Goodnews River,1992,157,,192,632
Goodnews River,1992,175,,193,807
Goodnews River,1992,170,,194,977
Goodnews River,1992,68,,195,1045
Goodnews River,1992,369,,196,1414
Goodnews River,1992,578,,197,1992
Goodnews River,1992,323,,198,2315
Goodnews River,1992,1110,,199,3425
Goodnews River,1992,986,,200,4411
Goodnews River,1992,1407,,201,5818
Goodnews River,1992,1199,,202,7017
Goodnews River,1992,566,,203,7583
Goodnews River,1992,798,,204,8381
Goodnews River,1992,602,,205,8983
Goodnews River,1992,1639,,206,10622
Goodnews River,1992,877,,207,11499
Goodnews River,1992,1080,,208,12579
Goodnews River,1992,1253,,209,13832
Goodnews River,1992,894,,210,14726
Goodnews River,1992,1098,,211,15824
Goodnews River,1992,2009,,212,17833
Goodnews River,1992,1328,,213,19161
Goodnews River,1992,1884,,214,21045
Goodnews River,1992,875,,215,21920
Goodnews River,1992,478,,216,22398
Goodnews River,1992,430,,217,22828
Goodnews River,1992,57,,218,22885
Goodnews River,1992,15,,219,22900
Goodnews River,1992,35,,220,22935
Goodnews River,1992,41,,221,22976
Goodnews River,1992,9,,222,22985
Goodnews River,1992,13,,223,22998
Goodnews River,1992,24,,224,23022
Goodnews River,1992,4,,225,23026
Goodnews River,1992,2,,226,23028
Goodnews River,1992,2,,227,23030
Goodnews River,1993,0,,173,0
Goodnews River,1993,0,,174,0
Goodnews River,1993,0,,175,0
Goodnews River,1993,0,,176,0
Goodnews River,1993,0,,177,0
Goodnews River,1993,0,,178,0
Goodnews River,1993,0,,179,0
Goodnews River,1993,0,,180,0
Goodnews River,1993,0,,181,0
Goodnews River,1993,0,,182,0
Goodnews River,1993,0,,183,0
Goodnews River,1993,0,,184,0
Goodnews River,1993,0,,185,0
Goodnews River,1993,0,,186,0
Goodnews River,1993,,,187,0
Goodnews River,1993,,,188,0
Goodnews River,1993,,,189,0
Goodnews River,1993,,,190,0
Goodnews River,1993,0,,191,0
Goodnews River,1993,9,,192,9
Goodnews River,1993,0,,193,9
Goodnews River,1993,0,,194,9
Goodnews River,1993,0,,195,9
Goodnews River,1993,0,,196,9
Goodnews River,1993,22,,197,31
Goodnews River,1993,44,,198,75
Goodnews River,1993,27,,199,102
Goodnews River,1993,16,,200,118
Goodnews River,1993,28,,201,146
Goodnews River,1993,11,,202,157
Goodnews River,1993,17,,203,174
Goodnews River,1993,4,,204,178
Goodnews River,1993,8,,205,186
Goodnews River,1993,1,,206,187
Goodnews River,1993,10,,207,197
Goodnews River,1993,0,,208,197
Goodnews River,1993,0,,209,197
Goodnews River,1993,3,,210,200
Goodnews River,1993,8,,211,208
Goodnews River,1993,4,,212,212
Goodnews River,1993,2,,213,214
Goodnews River,1993,0,,214,214
Goodnews River,1993,3,,215,217
Goodnews River,1993,13,,216,230
Goodnews River,1993,4,,217,234
Goodnews River,1993,4,,218,238
Goodnews River,1993,9,,219,247
Goodnews River,1993,5,,220,252
Goodnews River,1993,3,,221,255
Goodnews River,1993,7,,222,262
Goodnews River,1993,5,,223,267
Goodnews River,1993,8,,224,275
Goodnews River,1993,3,,225,278
Goodnews River,1993,12,,226,290
Goodnews River,1993,11,,227,301
Goodnews River,1993,3,,228,304
Goodnews River,1993,5,,229,309
Goodnews River,1993,9,,230,318
Goodnews River,1994,0,,173,0
Goodnews River,1994,0,,174,0
Goodnews River,1994,0,,175,0
Goodnews River,1994,0,,176,0
Goodnews River,1994,0,,177,0
Goodnews River,1994,0,,178,0
Goodnews River,1994,2,,179,2
Goodnews River,1994,8,,180,10
Goodnews River,1994,5,,181,15
Goodnews River,1994,20,,182,35
Goodnews River,1994,21,,183,56
Goodnews River,1994,2,,184,58
Goodnews River,1994,0,,185,58
Goodnews River,1994,35,,186,93
Goodnews River,1994,29,,187,122
Goodnews River,1994,113,,188,235
Goodnews River,1994,401,,189,636
Goodnews River,1994,19,,190,655
Goodnews River,1994,220,,191,875
Goodnews River,1994,186,,192,1061
Goodnews River,1994,896,,193,1957
Goodnews River,1994,,,194,1957
Goodnews River,1994,,,195,1957
Goodnews River,1994,,,196,1957
Goodnews River,1994,,,197,1957
Goodnews River,1994,,,198,1957
Goodnews River,1994,1873,,199,3830
Goodnews River,1994,2703,,200,6533
Goodnews River,1994,1843,,201,8376
Goodnews River,1994,1066,,202,9442
Goodnews River,1994,852,,203,10294
Goodnews River,1994,1108,,204,11402
Goodnews River,1994,1308,,205,12710
Goodnews River,1994,1628,,206,14338
Goodnews River,1994,3277,,207,17615
Goodnews River,1994,1033,,208,18648
Goodnews River,1994,6201,,209,24849
Goodnews River,1994,2934,,210,27783
Goodnews River,1994,1235,,211,29018
Goodnews River,1994,2096,,212,31114
Goodnews River,1994,697,,213,31811
Goodnews River,1994,1973,,214,33784
Goodnews River,1994,2114,,215,35898
Goodnews River,1994,1012,,216,36910
Goodnews River,1994,384,,217,37294
Goodnews River,1994,211,,218,37505
Goodnews River,1994,460,,219,37965
Goodnews River,1994,740,,220,38705
Goodnews River,1995,0,,170,0
Goodnews River,1995,0,,171,0
Goodnews River,1995,0,,172,0
Goodnews River,1995,0,,173,0
Goodnews River,1995,0,,174,0
Goodnews River,1995,0,,175,0
Goodnews River,1995,0,,176,0
Goodnews River,1995,0,,177,0
Goodnews River,1995,0,,178,0
Goodnews River,1995,0,,179,0
Goodnews River,1995,0,,180,0
Goodnews River,1995,0,,181,0
Goodnews River,1995,0,,182,0
Goodnews River,1995,0,,183,0
Goodnews River,1995,0,,184,0
Goodnews River,1995,0,,185,0
Goodnews River,1995,0,,186,0
Goodnews River,1995,0,,187,0
Goodnews River,1995,0,,188,0
Goodnews River,1995,0,,189,0
Goodnews River,1995,0,,190,0
Goodnews River,1995,0,,191,0
Goodnews River,1995,2,,192,2
Goodnews River,1995,7,,193,9
Goodnews River,1995,12,,194,21
Goodnews River,1995,14,,195,35
Goodnews River,1995,10,,196,45
Goodnews River,1995,2,,197,47
Goodnews River,1995,10,,198,57
Goodnews River,1995,11,,199,68
Goodnews River,1995,3,,200,71
Goodnews River,1995,46,,201,117
Goodnews River,1995,15,,202,132
Goodnews River,1995,6,,203,138
Goodnews River,1995,10,,204,148
Goodnews River,1995,20,,205,168
Goodnews River,1995,7,,206,175
Goodnews River,1995,11,,207,186
Goodnews River,1995,10,,208,196
Goodnews River,1995,9,,209,205
Goodnews River,1995,5,,210,210
Goodnews River,1995,8,,211,218
Goodnews River,1995,18,,212,236
Goodnews River,1995,5,,213,241
Goodnews River,1995,8,,214,249
Goodnews River,1995,9,,215,258
Goodnews River,1995,3,,216,261
Goodnews River,1995,3,,217,264
Goodnews River,1995,2,,218,266
Goodnews River,1995,2,,219,268
Goodnews River,1995,1,,220,269
Goodnews River,1995,10,,221,279
Goodnews River,1995,3,,222,282
Goodnews River,1995,3,,223,285
Goodnews River,1995,2,,224,287
Goodnews River,1995,4,,225,291
Goodnews River,1995,4,,226,295
Goodnews River,1995,1,,227,296
Goodnews River,1995,7,,228,303
Goodnews River,1995,1,,229,304
Goodnews River,1995,2,,230,306
Goodnews River,1995,3,,231,309
Goodnews River,1995,5,,232,314
Goodnews River,1995,1,,233,315
Goodnews River,1995,5,,234,320
Goodnews River,1995,0,,235,320
Goodnews River,1995,2,,236,322
Goodnews River,1995,5,,237,327
Goodnews River,1995,2,,238,329
Goodnews River,1995,1,,239,330
Goodnews River,1995,0,,240,330
Goodnews River,1996,0,,170,0
Goodnews River,1996,0,,171,0
Goodnews River,1996,0,,172,0
Goodnews River,1996,0,,173,0
Goodnews River,1996,0,,174,0
Goodnews River,1996,0,,175,0
Goodnews River,1996,0,,176,0
Goodnews River,1996,0,,177,0
Goodnews River,1996,0,,178,0
Goodnews River,1996,,,179,0
Goodnews River,1996,,,180,0
Goodnews River,1996,,,181,0
Goodnews River,1996,,,182,0
Goodnews River,1996,0,,183,0
Goodnews River,1996,0,,184,0
Goodnews River,1996,18,,185,18
Goodnews River,1996,176,,186,194
Goodnews River,1996,96,,187,290
Goodnews River,1996,160,,188,450
Goodnews River,1996,152,,189,602
Goodnews River,1996,103,,190,705
Goodnews River,1996,186,,191,891
Goodnews River,1996,421,,192,1312
Goodnews River,1996,103,,193,1415
Goodnews River,1996,86,,194,1501
Goodnews River,1996,140,,195,1641
Goodnews River,1996,140,,196,1781
Goodnews River,1996,140,,197,1921
Goodnews River,1996,140,,198,2061
Goodnews River,1996,140,,199,2201
Goodnews River,1996,140,,200,2341
Goodnews River,1996,140,,201,2481
Goodnews River,1996,195,,202,2676
Goodnews River,1996,312,,203,2988
Goodnews River,1996,514,,204,3502
Goodnews River,1996,1088,,205,4590
Goodnews River,1996,2411,,206,7001
Goodnews River,1996,1468,,207,8469
Goodnews River,1996,1558,,208,10027
Goodnews River,1996,1000,,209,11027
Goodnews River,1996,551,,210,11578
Goodnews River,1996,462,,211,12040
Goodnews River,1996,462,,212,12502
Goodnews River,1996,462,,213,12964
Goodnews River,1996,462,,214,13426
Goodnews River,1996,462,,215,13888
Goodnews River,1996,462,,216,14350
Goodnews River,1996,462,,217,14812
Goodnews River,1996,462,,218,15274
Goodnews River,1996,462,,219,15736
Goodnews River,1996,462,,220,16198
Goodnews River,1996,372,,221,16570
Goodnews River,1996,331,,222,16901
Goodnews River,1996,506,,223,17407
Goodnews River,1996,601,,224,18008
Goodnews River,1996,244,,225,18252
Goodnews River,1996,423,,226,18675
Goodnews River,1996,255,,227,18930
Goodnews River,1996,264,,228,19194
Goodnews River,1996,234,,229,19428
Goodnews River,1996,107,,230,19535
Goodnews River,1996,105,,231,19640
Goodnews River,1996,121,,232,19761
Goodnews River,1996,58,,233,19819
Goodnews River,1996,109,,234,19928
Goodnews River,1996,118,,235,20046
Goodnews River,1996,63,,236,20109
Goodnews River,1997,0,,163,0
Goodnews River,1997,0,,164,0
Goodnews River,1997,0,,165,0
Goodnews River,1997,0,,166,0
Goodnews River,1997,0,,167,0
Goodnews River,1997,0,,168,0
Goodnews River,1997,0,,169,0
Goodnews River,1997,0,,170,0
Goodnews River,1997,0,,171,0
Goodnews River,1997,0,,172,0
Goodnews River,1997,0,,173,0
Goodnews River,1997,0,,174,0
Goodnews River,1997,0,,175,0
Goodnews River,1997,0,,176,0
Goodnews River,1997,0,,177,0
Goodnews River,1997,0,,178,0
Goodnews River,1997,4,,179,4
Goodnews River,1997,0,,180,4
Goodnews River,1997,0,,181,4
Goodnews River,1997,0,,182,4
Goodnews River,1997,0,,183,4
Goodnews River,1997,0,,184,4
Goodnews River,1997,0,,185,4
Goodnews River,1997,3,,186,7
Goodnews River,1997,16,,187,23
Goodnews River,1997,3,,188,26
Goodnews River,1997,4,,189,30
Goodnews River,1997,6,,190,36
Goodnews River,1997,4,,191,40
Goodnews River,1997,10,,192,50
Goodnews River,1997,27,,193,77
Goodnews River,1997,20,,194,97
Goodnews River,1997,11,,195,108
Goodnews River,1997,17,,196,125
Goodnews River,1997,7,,197,132
Goodnews River,1997,12,,198,144
Goodnews River,1997,20,,199,164
Goodnews River,1997,59,,200,223
Goodnews River,1997,20,,201,243
Goodnews River,1997,8,,202,251
Goodnews River,1997,14,,203,265
Goodnews River,1997,20,,204,285
Goodnews River,1997,6,,205,291
Goodnews River,1997,5,,206,296
Goodnews River,1997,3,,207,299
Goodnews River,1997,7,,208,306
Goodnews River,1997,2,,209,308
Goodnews River,1997,6,,210,314
Goodnews River,1997,6,,211,320
Goodnews River,1997,16,,212,336
Goodnews River,1997,0,,213,336
Goodnews River,1997,7,,214,343
Goodnews River,1997,5,,215,348
Goodnews River,1997,7,,216,355
Goodnews River,1997,8,,217,363
Goodnews River,1997,8,,218,371
Goodnews River,1997,2,,219,373
Goodnews River,1997,0,,220,373
Goodnews River,1997,1,,221,374
Goodnews River,1997,13,,222,387
Goodnews River,1997,7,,223,394
Goodnews River,1997,6,,224,400
Goodnews River,1997,7,,225,407
Goodnews River,1997,7,,226,414
Goodnews River,1997,2,,227,416
Goodnews River,1997,6,,228,422
Goodnews River,1997,8,,229,430
Goodnews River,1997,5,,230,435
Goodnews River,1997,4,,231,439
Goodnews River,1997,23,,232,462
Goodnews River,1997,11,,233,473
Goodnews River,1997,9,,234,482
Goodnews River,1997,9,,235,491
Goodnews River,1997,10,,236,501
Goodnews River,1997,10,,237,511
Goodnews River,1997,13,,238,524
Goodnews River,1997,19,,239,543
Goodnews River,1997,12,,240,555
Goodnews River,1997,12,,241,567
Goodnews River,1997,21,,242,588
Goodnews River,1997,44,,243,632
Goodnews River,1997,42,,244,674
Goodnews River,1997,28,,245,702
Goodnews River,1997,58,,246,760
Goodnews River,1997,3,,247,763
Goodnews River,1997,48,,248,811
Goodnews River,1997,38,,249,849
Goodnews River,1997,16,,250,865
Goodnews River,1997,12,,251,877
Goodnews River,1997,12,,252,889
Goodnews River,1997,8,,253,897
Goodnews River,1997,10,,254,907
Goodnews River,1997,12,,255,919
Goodnews River,1997,11,,256,930
Goodnews River,1997,3,,257,933
Goodnews River,1997,1,,258,934
Goodnews River,1997,3,,259,937
Goodnews River,1997,3,,260,940
Goodnews River,1998,0,,185,0
Goodnews River,1998,0,,186,0
Goodnews River,1998,23,,187,23
Goodnews River,1998,48,,188,71
Goodnews River,1998,46,,189,117
Goodnews River,1998,77,,190,194
Goodnews River,1998,80,,191,274
Goodnews River,1998,53,,192,327
Goodnews River,1998,249,,193,576
Goodnews River,1998,192,,194,768
Goodnews River,1998,172,,195,940
Goodnews River,1998,220,,196,1160
Goodnews River,1998,217,,197,1377
Goodnews River,1998,186,,198,1563
Goodnews River,1998,136,,199,1699
Goodnews River,1998,120,,200,1819
Goodnews River,1998,158,,201,1977
Goodnews River,1998,393,,202,2370
Goodnews River,1998,281,,203,2651
Goodnews River,1998,356,,204,3007
Goodnews River,1998,295,,205,3302
Goodnews River,1998,270,,206,3572
Goodnews River,1998,253,,207,3825
Goodnews River,1998,218,,208,4043
Goodnews River,1998,59,,209,4102
Goodnews River,1998,30,,210,4132
Goodnews River,1998,203,,211,4335
Goodnews River,1998,144,,212,4479
Goodnews River,1998,249,,213,4728
Goodnews River,1998,407,,214,5135
Goodnews River,1998,386,,215,5521
Goodnews River,1998,98,,216,5619
Goodnews River,1998,105,,217,5724
Goodnews River,1998,119,,218,5843
Goodnews River,1998,154,,219,5997
Goodnews River,1998,108,,220,6105
Goodnews River,1998,206,,221,6311
Goodnews River,1998,254,,222,6565
Goodnews River,1998,171,,223,6736
Goodnews River,1998,228,,224,6964
Goodnews River,1998,105,,225,7069
Goodnews River,1998,249,,226,7318
Goodnews River,1998,412,,227,7730
Goodnews River,1998,973,,228,8703
Goodnews River,1998,36,,229,8739
Goodnews River,1998,178,,230,8917
Goodnews River,1998,248,,231,9165
Goodnews River,1998,324,,232,9489
Goodnews River,1998,104,,233,9593
Goodnews River,1998,58,,234,9651
Goodnews River,1998,180,,235,9831
Goodnews River,1998,72,,236,9903
Goodnews River,1998,52,,237,9955
Goodnews River,1998,77,,238,10032
Goodnews River,1998,53,,239,10085
Goodnews River,1998,38,,240,10123
Goodnews River,1998,25,,241,10148
Goodnews River,1998,50,,242,10198
Goodnews River,1998,15,,243,10213
Goodnews River,1998,19,,244,10232
Goodnews River,1998,28,,245,10260
Goodnews River,1998,12,,246,10272
Goodnews River,1998,9,,247,10281
Goodnews River,1998,14,,248,10295
Goodnews River,1998,8,,249,10303
Goodnews River,1998,16,,250,10319
Goodnews River,1998,12,,251,10331
Goodnews River,1998,5,,252,10336
Goodnews River,1998,10,,253,10346
Goodnews River,1998,5,,254,10351
Goodnews River,1998,11,,255,10362
Goodnews River,1998,0,,256,10362
Goodnews River,1998,6,,257,10368
Goodnews River,1998,4,,258,10372
Goodnews River,1998,3,,259,10375
Goodnews River,1998,1,,260,10376
Goodnews River,2007,0,,176,0
Goodnews River,2007,0,,177,0
Goodnews River,2007,0,,178,0
Goodnews River,2007,0,,179,0
Goodnews River,2007,0,,180,0
Goodnews River,2007,0,,181,0
Goodnews River,2007,0,,182,0
Goodnews River,2007,8,,183,8
Goodnews River,2007,70,,184,78
Goodnews River,2007,208,,185,286
Goodnews River,2007,28,,186,314
Goodnews River,2007,15,,187,329
Goodnews River,2007,19,,188,348
Goodnews River,2007,102,,189,450
Goodnews River,2007,64,,190,514
Goodnews River,2007,47,,191,561
Goodnews River,2007,52,,192,613
Goodnews River,2007,98,,193,711
Goodnews River,2007,34,,194,745
Goodnews River,2007,46,,195,791
Goodnews River,2007,32,,196,823
Goodnews River,2007,46,,197,869
Goodnews River,2007,98,,198,967
Goodnews River,2007,180,,199,1147
Goodnews River,2007,195,,200,1342
Goodnews River,2007,123,,201,1465
Goodnews River,2007,128,,202,1593
Goodnews River,2007,205,,203,1798
Goodnews River,2007,186,,204,1984
Goodnews River,2007,233,,205,2217
Goodnews River,2007,20,,206,2237
Goodnews River,2007,118,,207,2355
Goodnews River,2007,145,,208,2500
Goodnews River,2007,195,,209,2695
Goodnews River,2007,82,,210,2777
Goodnews River,2007,188,,211,2965
Goodnews River,2007,96,,212,3061
Goodnews River,2007,111,,213,3172
Goodnews River,2007,169,,214,3341
Goodnews River,2007,152,,215,3493
Goodnews River,2007,76,,216,3569
Goodnews River,2007,116,,217,3685
Goodnews River,2007,15,,218,3700
Goodnews River,2007,34,,219,3734
Goodnews River,2007,66,,220,3800
Goodnews River,2007,66,,221,3866
Goodnews River,2007,58,,222,3924
Goodnews River,2007,38,,223,3962
Goodnews River,2007,79,,224,4041
Goodnews River,2007,66,,225,4107
Goodnews River,2007,25,,226,4132
Goodnews River,2007,40,,227,4172
Goodnews River,2007,93,,228,4265
Goodnews River,2007,59,,229,4324
Goodnews River,2007,45,,230,4369
Goodnews River,2007,55,,231,4424
Goodnews River,2007,55,,232,4479
Goodnews River,2007,40,,233,4519
Goodnews River,2007,63,,234,4582
Goodnews River,2007,28,,235,4610
Goodnews River,2007,42,,236,4652
Goodnews River,2007,32,,237,4684
Goodnews River,2007,13,,238,4697
Goodnews River,2007,30,,239,4727
Goodnews River,2007,28,,240,4755
Goodnews River,2007,23,,241,4778
Goodnews River,2007,4,,242,4782
Goodnews River,2007,8,,243,4790
Goodnews River,2007,24,,244,4814
Goodnews River,2007,27,,245,4841
Goodnews River,2007,26,,246,4867
Goodnews River,2007,20,,247,4887
Goodnews River,2007,10,,248,4897
Goodnews River,2007,5,,249,4902
Goodnews River,2007,1,,250,4903
Goodnews River,2007,6,,251,4909
Goodnews River,2007,2,,252,4911
Goodnews River,2007,8,,253,4919
Goodnews River,2008,16,Fish tight at 15:30,184,16
Goodnews River,2008,11,,185,27
Goodnews River,2008,16,,186,43
Goodnews River,2008,8,,187,51
Goodnews River,2008,31,,188,82
Goodnews River,2008,154,,189,236
Goodnews River,2008,114,,190,350
Goodnews River,2008,83,,191,433
Goodnews River,2008,41,,192,474
Goodnews River,2008,71,,193,545
Goodnews River,2008,93,,194,638
Goodnews River,2008,88,,195,726
Goodnews River,2008,91,,196,817
Goodnews River,2008,122,,197,939
Goodnews River,2008,34,Partial count holes observed no estimates made,198,973
Goodnews River,2008,56,Partial count holes observed no estimates made,199,1029
Goodnews River,2008,77,Partial count holes observed no estimates made,200,1106
Goodnews River,2008,135,,201,1241
Goodnews River,2008,100,,202,1341
Goodnews River,2008,59,,203,1400
Goodnews River,2008,48,Partial count holes observed no estimates made,204,1448
Goodnews River,2008,175,,205,1623
Goodnews River,2008,234,,206,1857
Goodnews River,2008,204,,207,2061
Goodnews River,2008,245,,208,2306
Goodnews River,2008,87,,209,2393
Goodnews River,2008,210,,210,2603
Goodnews River,2008,200,,211,2803
Goodnews River,2008,264,,212,3067
Goodnews River,2008,372,,213,3439
Goodnews River,2008,317,,214,3756
Goodnews River,2008,537,,215,4293
Goodnews River,2008,132,Partial count holes observed no estimates made,216,4425
Goodnews River,2008,439,,217,4864
Goodnews River,2008,315,,218,5179
Goodnews River,2008,364,,219,5543
Goodnews River,2008,563,,220,6106
Goodnews River,2008,387,,221,6493
Goodnews River,2008,223,,222,6716
Goodnews River,2008,394,,223,7110
Goodnews River,2008,287,,224,7397
Goodnews River,2008,165,,225,7562
Goodnews River,2008,249,,226,7811
Goodnews River,2008,343,,227,8154
Goodnews River,2008,241,,228,8395
Goodnews River,2008,230,,229,8625
Goodnews River,2008,158,,230,8783
Goodnews River,2008,101,,231,8884
Goodnews River,2008,218,,232,9102
Goodnews River,2008,130,,233,9232
Goodnews River,2008,74,,234,9306
Goodnews River,2008,58,,235,9364
Goodnews River,2008,33,,236,9397
Goodnews River,2008,48,,237,9445
Goodnews River,2008,32,,238,9477
Goodnews River,2008,52,,239,9529
Goodnews River,2008,20,,240,9549
Goodnews River,2008,21,,241,9570
Goodnews River,2008,7,,242,9577
Goodnews River,2008,44,,243,9621
Goodnews River,2008,23,,244,9644
Goodnews River,2008,17,,245,9661
Goodnews River,2008,30,,246,9691
Goodnews River,2008,38,,247,9729
Goodnews River,2008,20,,248,9749
Goodnews River,2008,12,,249,9761
Goodnews River,2008,5,,250,9766
Goodnews River,2008,4,,251,9770
Goodnews River,2008,8,,252,9778
Goodnews River,2008,9,,253,9787
Goodnews River,2008,8,,254,9795
Goodnews River,2008,2,,255,9797
Goodnews River,2008,1,,256,9798
Goodnews River,2008,1,,257,9799
Goodnews River,2008,3,,258,9802
Goodnews River,2008,5,,259,9807
Goodnews River,2009,0,,179,0
Goodnews River,2009,0,,180,0
Goodnews River,2009,1,,181,1
Goodnews River,2009,0,,182,1
Goodnews River,2009,2,,183,3
Goodnews River,2009,0,,184,3
Goodnews River,2009,0,,185,3
Goodnews River,2009,0,,186,3
Goodnews River,2009,0,,187,3
Goodnews River,2009,0,,188,3
Goodnews River,2009,0,,189,3
Goodnews River,2009,1,,190,4
Goodnews River,2009,9,,191,13
Goodnews River,2009,0,,192,13
Goodnews River,2009,0,,193,13
Goodnews River,2009,12,,194,25
Goodnews River,2009,6,,195,31
Goodnews River,2009,11,,196,42
Goodnews River,2009,4,,197,46
Goodnews River,2009,35,,198,81
Goodnews River,2009,18,,199,99
Goodnews River,2009,8,,200,107
Goodnews River,2009,11,,201,118
Goodnews River,2009,10,,202,128
Goodnews River,2009,61,,203,189
Goodnews River,2009,26,,204,215
Goodnews River,2009,6,,205,221
Goodnews River,2009,52,,206,273
Goodnews River,2009,38,,207,311
Goodnews River,2009,38,,208,349
Goodnews River,2009,27,,209,376
Goodnews River,2009,10,,210,386
Goodnews River,2009,2,,211,388
Goodnews River,2009,0,,212,388
Goodnews River,2009,3,,213,391
Goodnews River,2009,3,,214,394
Goodnews River,2009,3,,215,397
Goodnews River,2009,1,,216,398
Goodnews River,2009,8,,217,406
Goodnews River,2009,27,,218,433
Goodnews River,2009,23,,219,456
Goodnews River,2009,8,,220,464
Goodnews River,2009,17,,221,481
Goodnews River,2009,8,,222,489
Goodnews River,2009,16,,223,505
Goodnews River,2009,6,,224,511
Goodnews River,2009,8,,225,519
Goodnews River,2009,8,,226,527
Goodnews River,2009,4,,227,531
Goodnews River,2009,19,,228,550
Goodnews River,2009,7,,229,557
Goodnews River,2009,4,,230,561
Goodnews River,2009,4,,231,565
Goodnews River,2009,11,,232,576
Goodnews River,2009,17,,233,593
Goodnews River,2009,14,,234,607
Goodnews River,2009,5,,235,612
Goodnews River,2009,5,,236,617
Goodnews River,2009,9,,237,626
Goodnews River,2009,3,,238,629
Goodnews River,2009,7,,239,636
Goodnews River,2009,5,,240,641
Goodnews River,2009,10,,241,651
Goodnews River,2009,15,,242,666
Goodnews River,2009,12,,243,678
Goodnews River,2009,2,,244,680
Goodnews River,2009,1,,245,681
Goodnews River,2009,0,,246,681
Goodnews River,2009,11,,247,692
Goodnews River,2009,4,,248,696
Goodnews River,2009,4,,249,700
Goodnews River,2009,2,,250,702
Goodnews River,2009,1,,251,703
Goodnews River,2009,1,,252,704
Goodnews River,2009,1,,253,705
Goodnews River,2009,0,,254,705
Goodnews River,2009,2,,255,707
Goodnews River,2009,4,,256,711
Goodnews River,2009,2,,257,713
Goodnews River,2009,1,,258,714
Goodnews River,2009,0,,259,714
Goodnews River,2009,0,,260,714
Goodnews River,2009,0,,261,714
Goodnews River,2009,0,,262,714
Goodnews River,2009,0,,263,714
Goodnews River,2009,0,,264,714
Goodnews River,2010,0,,176,0
Goodnews River,2010,0,,177,0
Goodnews River,2010,0,,178,0
Goodnews River,2010,0,,179,0
Goodnews River,2010,0,,180,0
Goodnews River,2010,0,,181,0
Goodnews River,2010,4,,182,4
Goodnews River,2010,3,,183,7
Goodnews River,2010,8,,184,15
Goodnews River,2010,21,,185,36
Goodnews River,2010,22,,186,58
Goodnews River,2010,20,,187,78
Goodnews River,2010,2,,188,80
Goodnews River,2010,12,,189,92
Goodnews River,2010,43,,190,135
Goodnews River,2010,50,,191,185
Goodnews River,2010,49,,192,234
Goodnews River,2010,80,,193,314
Goodnews River,2010,253,,194,567
Goodnews River,2010,140,,195,707
Goodnews River,2010,78,,196,785
Goodnews River,2010,73,,197,858
Goodnews River,2010,211,,198,1069
Goodnews River,2010,59,,199,1128
Goodnews River,2010,136,,200,1264
Goodnews River,2010,81,,201,1345
Goodnews River,2010,49,,202,1394
Goodnews River,2010,48,,203,1442
Goodnews River,2010,26,,204,1468
Goodnews River,2010,50,,205,1518
Goodnews River,2010,60,,206,1578
Goodnews River,2010,20,,207,1598
Goodnews River,2010,111,,208,1709
Goodnews River,2010,57,,209,1766
Goodnews River,2010,117,,210,1883
Goodnews River,2010,0,,211,1883
Goodnews River,2010,0,,212,1883
Goodnews River,2010,0,,213,1883
Goodnews River,2010,0,,214,1883
Goodnews River,2010,0,,215,1883
Goodnews River,2010,41,,216,1924
Goodnews River,2010,131,,217,2055
Goodnews River,2010,188,,218,2243
Goodnews River,2010,206,,219,2449
Goodnews River,2010,78,,220,2527
Goodnews River,2010,109,,221,2636
Goodnews River,2010,178,,222,2814
Goodnews River,2010,75,,223,2889
Goodnews River,2010,86,,224,2975
Goodnews River,2010,71,,225,3046
Goodnews River,2010,0,,226,3046
Goodnews River,2010,0,,227,3046
Goodnews River,2010,0,,228,3046
Goodnews River,2010,0,,229,3046
Goodnews River,2010,0,,230,3046
Goodnews River,2010,0,,231,3046
Goodnews River,2010,0,,232,3046
Goodnews River,2010,0,,233,3046
Goodnews River,2010,0,,234,3046
Goodnews River,2010,0,,235,3046
Goodnews River,2010,0,,236,3046
Goodnews River,2010,0,,237,3046
Goodnews River,2010,65,,238,3111
Goodnews River,2010,79,,239,3190
Goodnews River,2010,56,,240,3246
Goodnews River,2010,60,,241,3306
Goodnews River,2010,17,,242,3323
Goodnews River,2010,19,,243,3342
Goodnews River,2010,24,,244,3366
Goodnews River,2010,11,,245,3377
Goodnews River,2010,12,,246,3389
Goodnews River,2010,7,,247,3396
Goodnews River,2010,27,,248,3423
Goodnews River,2010,8,,249,3431
Goodnews River,2010,3,,250,3434
Goodnews River,2010,0,,251,3434
Goodnews River,2010,2,,252,3436
Goodnews River,2010,3,,253,3439
Goodnews River,2010,0,,254,3439
Goodnews River,2010,1,,255,3440
Goodnews River,2010,0,,256,3440
Goodnews River,2010,2,,257,3442
Goodnews River,2010,1,,258,3443
Goodnews River,2010,1,,259,3444
Goodnews River,2010,0,,260,3444
Goodnews River,2010,0,,261,3444
Goodnews River,2011,0,,175,0
Goodnews River,2011,0,,176,0
Goodnews River,2011,0,,177,0
Goodnews River,2011,0,,178,0
Goodnews River,2011,0,,179,0
Goodnews River,2011,0,,180,0
Goodnews River,2011,0,,181,0
Goodnews River,2011,0,,182,0
Goodnews River,2011,0,,183,0
Goodnews River,2011,0,,184,0
Goodnews River,2011,0,,185,0
Goodnews River,2011,1,,186,1
Goodnews River,2011,6,,187,7
Goodnews River,2011,4,,188,11
Goodnews River,2011,4,,189,15
Goodnews River,2011,13,,190,28
Goodnews River,2011,11,,191,39
Goodnews River,2011,7,,192,46
Goodnews River,2011,0,,193,46
Goodnews River,2011,7,,194,53
Goodnews River,2011,21,,195,74
Goodnews River,2011,29,,196,103
Goodnews River,2011,28,,197,131
Goodnews River,2011,37,,198,168
Goodnews River,2011,19,,199,187
Goodnews River,2011,53,,200,240
Goodnews River,2011,76,,201,316
Goodnews River,2011,48,,202,364
Goodnews River,2011,105,,203,469
Goodnews River,2011,74,,204,543
Goodnews River,2011,55,,205,598
Goodnews River,2011,42,,206,640
Goodnews River,2011,30,,207,670
Goodnews River,2011,49,,208,719
Goodnews River,2011,27,,209,746
Goodnews River,2011,25,,210,771
Goodnews River,2011,5,,211,776
Goodnews River,2011,12,,212,788
Goodnews River,2011,21,,213,809
Goodnews River,2011,24,,214,833
Goodnews River,2011,18,,215,851
Goodnews River,2011,18,,216,869
Goodnews River,2011,30,,217,899
Goodnews River,2011,13,,218,912
Goodnews River,2011,24,,219,936
Goodnews River,2011,24,,220,960
Goodnews River,2011,54,,221,1014
Goodnews River,2011,33,,222,1047
Goodnews River,2011,39,,223,1086
Goodnews River,2011,37,,224,1123
Goodnews River,2011,9,,225,1132
Goodnews River,2011,29,,226,1161
Goodnews River,2011,17,,227,1178
Goodnews River,2011,18,,228,1196
Goodnews River,2011,16,,229,1212
Goodnews River,2011,10,,230,1222
Goodnews River,2011,9,,231,1231
Goodnews River,2011,9,,232,1240
Goodnews River,2011,8,,233,1248
Goodnews River,2011,2,,234,1250
Goodnews River,2011,3,,235,1253
Goodnews River,2011,15,,236,1268
Goodnews River,2011,12,,237,1280
Goodnews River,2011,12,,238,1292
Goodnews River,2011,18,,239,1310
Goodnews River,2011,7,,240,1317
Goodnews River,2011,7,,241,1324
Goodnews River,2011,6,,242,1330
Goodnews River,2011,5,,243,1335
Goodnews River,2011,2,,244,1337
Goodnews River,2011,4,,245,1341
Goodnews River,2011,5,,246,1346
Goodnews River,2011,5,,247,1351
Goodnews River,2011,3,,248,1354
Goodnews River,2011,15,,249,1369
Goodnews River,2011,2,,250,1371
Goodnews River,2011,4,,251,1375
Goodnews River,2011,0,,252,1375
Goodnews River,2011,2,,253,1377
Goodnews River,2011,3,,254,1380
Goodnews River,2011,3,,255,1383
Goodnews River,2011,2,,256,1385
Goodnews River,2011,3,,257,1388
Goodnews River,2011,2,,258,1390
Goodnews River,2011,0,,259,1390
Goodnews River,2011,1,,260,1391
Goodnews River,2011,3,,261,1394
Ilnik River,2006,4,,174,4
Ilnik River,2006,0,,175,4
Ilnik River,2006,0,,176,4
Ilnik River,2006,0,,177,4
Ilnik River,2006,3,,178,7
Ilnik River,2006,1,,179,8
Ilnik River,2006,2,,180,10
Ilnik River,2006,2,,181,12
Ilnik River,2006,26,,182,38
Ilnik River,2006,7,,183,45
Ilnik River,2006,19,,184,64
Ilnik River,2006,32,,185,96
Ilnik River,2006,20,,186,116
Ilnik River,2006,18,,187,134
Ilnik River,2006,23,,188,157
Ilnik River,2006,8,,189,165
Ilnik River,2006,2,,190,167
Ilnik River,2006,15,,191,182
Ilnik River,2006,18,,192,200
Ilnik River,2006,2,,193,202
Ilnik River,2006,1,,194,203
Ilnik River,2006,0,,195,203
Ilnik River,2006,0,,196,203
Ilnik River,2006,0,,197,203
Ilnik River,2006,0,,198,203
Ilnik River,2006,0,,199,203
Ilnik River,2006,7,,200,210
Ilnik River,2007,5,,179,5
Ilnik River,2007,2,,180,7
Ilnik River,2007,1,,181,8
Ilnik River,2007,2,,182,10
Ilnik River,2007,5,,183,15
Ilnik River,2007,12,,184,27
Ilnik River,2007,8,,185,35
Ilnik River,2007,13,,186,48
Ilnik River,2007,23,,187,71
Ilnik River,2007,11,,188,82
Ilnik River,2007,41,,189,123
Ilnik River,2007,15,,190,138
Ilnik River,2007,39,,191,177
Ilnik River,2007,14,,192,191
Ilnik River,2007,6,,193,197
Ilnik River,2007,22,,194,219
Ilnik River,2007,31,,195,250
Ilnik River,2007,101,,196,351
Ilnik River,2007,78,,197,429
Ilnik River,2007,81,,198,510
Ilnik River,2007,46,,199,556
Ilnik River,2007,43,,200,599
Ilnik River,2007,43,,201,642
Ilnik River,2007,0,Wier closed,202,642
Ilnik River,2008,1,,182,1
Ilnik River,2008,8,,183,9
Ilnik River,2008,0,,184,9
Ilnik River,2008,0,,185,9
Ilnik River,2008,9,,186,18
Ilnik River,2008,3,,187,21
Ilnik River,2008,6,,188,27
Ilnik River,2008,9,,189,36
Ilnik River,2008,5,,190,41
Ilnik River,2008,6,,191,47
Ilnik River,2008,5,,192,52
Ilnik River,2008,4,,193,56
Ilnik River,2008,9,,194,65
Ilnik River,2008,4,,195,69
Ilnik River,2008,0,,196,69
Ilnik River,2008,25,,197,94
Ilnik River,2008,9,,198,103
Ilnik River,2008,5,,199,108
Ilnik River,2008,5,,200,113
Ilnik River,2008,2,"Wier pulled, post wier estimate",201,115
Ilnik River,2009,8,,172,8
Ilnik River,2009,1,,173,9
Ilnik River,2009,7,,174,16
Ilnik River,2009,1,,175,17
Ilnik River,2009,0,,176,17
Ilnik River,2009,2,,177,19
Ilnik River,2009,0,,178,19
Ilnik River,2009,0,,179,19
Ilnik River,2009,0,,180,19
Ilnik River,2009,2,,181,21
Ilnik River,2009,0,,182,21
Ilnik River,2009,0,,183,21
Ilnik River,2009,1,,184,22
Ilnik River,2009,0,,185,22
Ilnik River,2009,0,,186,22
Ilnik River,2009,0,,187,22
Ilnik River,2009,2,,188,24
Ilnik River,2009,0,,189,24
Ilnik River,2009,1,,190,25
Ilnik River,2009,3,,191,28
Ilnik River,2009,1,,192,29
Ilnik River,2009,5,,193,34
Ilnik River,2009,6,,194,40
Ilnik River,2009,2,,195,42
Ilnik River,2009,6,,196,48
Ilnik River,2009,2,,197,50
Ilnik River,2009,0,,198,50
Ilnik River,2009,0,,199,50
Ilnik River,2009,4,,200,54
Ilnik River,2009,2,,201,56
Ilnik River,2009,0,Wier closed for season,202,56
Ilnik River,2010,1,,180,1
Ilnik River,2010,2,,181,3
Ilnik River,2010,4,,182,7
Ilnik River,2010,2,,183,9
Ilnik River,2010,1,,184,10
Ilnik River,2010,0,,185,10
Ilnik River,2010,2,,186,12
Ilnik River,2010,2,,187,14
Ilnik River,2010,2,,188,16
Ilnik River,2010,7,,189,23
Ilnik River,2010,4,,190,27
Ilnik River,2010,2,,191,29
Ilnik River,2010,7,,192,36
Ilnik River,2010,2,,193,38
Ilnik River,2010,2,,194,40
Ilnik River,2010,2,,195,42
Ilnik River,2010,3,,196,45
Ilnik River,2010,5,,197,50
Ilnik River,2010,0,Wier closed,198,50
Ilnik River,2011,12,,181,12
Ilnik River,2011,17,,182,29
Ilnik River,2011,15,,183,44
Ilnik River,2011,10,,184,54
Ilnik River,2011,15,,185,69
Ilnik River,2011,9,,186,78
Ilnik River,2011,7,,187,85
Ilnik River,2011,11,,188,96
Ilnik River,2011,8,,189,104
Ilnik River,2011,13,,190,117
Ilnik River,2011,6,,191,123
Ilnik River,2011,3,,192,126
Ilnik River,2011,4,,193,130
Ilnik River,2011,3,,194,133
Ilnik River,2011,2,,195,135
Ilnik River,2011,0,Wier puller for season,196,135
Ilnik River,2012,9,,189,9
Ilnik River,2012,3,,190,12
Ilnik River,2012,0,,191,12
Ilnik River,2012,24,,192,36
Ilnik River,2012,12,,193,48
Ilnik River,2012,4,,194,52
Ilnik River,2012,1,,195,53
Ilnik River,2012,0,,196,53
Ilnik River,2012,30,,197,83
Ilnik River,2012,0,,198,83
Ilnik River,2012,0,Wier pulled for season,199,83
Kanektok River,1984,0,,167,0
Kanektok River,1984,0,,168,0
Kanektok River,1984,0,,169,0
Kanektok River,1984,0,,170,0
Kanektok River,1984,0,,171,0
Kanektok River,1984,0,,172,0
Kanektok River,1984,0,,173,0
Kanektok River,1984,0,,174,0
Kanektok River,1984,0,,175,0
Kanektok River,1984,0,,176,0
Kanektok River,1984,0,,177,0
Kanektok River,1984,0,,178,0
Kanektok River,1984,0,,179,0
Kanektok River,1984,0,,180,0
Kanektok River,1984,0,,181,0
Kanektok River,1984,0,,182,0
Kanektok River,1984,0,,183,0
Kanektok River,1984,0,,184,0
Kanektok River,1984,0,,185,0
Kanektok River,1984,0,,186,0
Kanektok River,1984,0,,187,0
Kanektok River,1984,0,,188,0
Kanektok River,1984,0,,189,0
Kanektok River,1984,471,,190,471
Kanektok River,1984,350,,191,821
Kanektok River,1984,225,,192,1046
Kanektok River,1984,0,,193,1046
Kanektok River,1984,286,,194,1332
Kanektok River,1984,172,,195,1504
Kanektok River,1984,1006,,196,2510
Kanektok River,1984,0,,197,2510
Kanektok River,1984,676,,198,3186
Kanektok River,1984,300,,199,3486
Kanektok River,1984,1814,,200,5300
Kanektok River,1984,590,,201,5890
Kanektok River,1984,367,,202,6257
Kanektok River,1984,0,,203,6257
Kanektok River,1984,6451,,204,12708
Kanektok River,1984,10622,,205,23330
Kanektok River,1984,6038,,206,29368
Kanektok River,1984,1644,,207,31012
Kanektok River,1984,1981,,208,32993
Kanektok River,1984,1990,,209,34983
Kanektok River,1984,4431,,210,39414
Kanektok River,1984,1182,,211,40596
Kanektok River,1984,0,,212,40596
Kanektok River,1984,0,,213,40596
Kanektok River,1984,0,,214,40596
Kanektok River,1986,0,,167,0
Kanektok River,1986,0,,168,0
Kanektok River,1986,0,,169,0
Kanektok River,1986,0,,170,0
Kanektok River,1986,0,,171,0
Kanektok River,1986,0,,172,0
Kanektok River,1986,0,,173,0
Kanektok River,1986,0,,174,0
Kanektok River,1986,0,,175,0
Kanektok River,1986,0,,176,0
Kanektok River,1986,0,,177,0
Kanektok River,1986,0,,178,0
Kanektok River,1986,265,,179,265
Kanektok River,1986,199,,180,464
Kanektok River,1986,204,,181,668
Kanektok River,1986,0,,182,668
Kanektok River,1986,0,,183,668
Kanektok River,1986,0,,184,668
Kanektok River,1986,0,,185,668
Kanektok River,1986,0,,186,668
Kanektok River,1986,49,,187,717
Kanektok River,1986,138,,188,855
Kanektok River,1986,603,,189,1458
Kanektok River,1986,0,,190,1458
Kanektok River,1986,4312,,191,5770
Kanektok River,1986,1769,,192,7539
Kanektok River,1986,0,,193,7539
Kanektok River,1986,156,,194,7695
Kanektok River,1986,223,,195,7918
Kanektok River,1986,0,,196,7918
Kanektok River,1986,0,,197,7918
Kanektok River,1986,126,,198,8044
Kanektok River,1986,324,,199,8368
Kanektok River,1997,0,,162,0
Kanektok River,1997,0,,163,0
Kanektok River,1997,,,164,0
Kanektok River,1997,0,,165,0
Kanektok River,1997,0,,166,0
Kanektok River,1997,0,,167,0
Kanektok River,1997,0,,168,0
Kanektok River,1997,0,,169,0
Kanektok River,1997,0,,170,0
Kanektok River,1997,0,,171,0
Kanektok River,1997,0,,172,0
Kanektok River,1997,0,,173,0
Kanektok River,1997,0,,174,0
Kanektok River,1997,0,,175,0
Kanektok River,1997,0,,176,0
Kanektok River,1997,0,,177,0
Kanektok River,1997,0,,178,0
Kanektok River,1997,0,,179,0
Kanektok River,1997,0,,180,0
Kanektok River,1997,0,,181,0
Kanektok River,1997,0,,182,0
Kanektok River,1997,0,,183,0
Kanektok River,1997,0,,184,0
Kanektok River,1997,0,,185,0
Kanektok River,1997,0,,186,0
Kanektok River,1997,6,,187,6
Kanektok River,1997,744,,188,750
Kanektok River,1997,756,,189,1506
Kanektok River,1997,408,,190,1914
Kanektok River,1997,138,,191,2052
Kanektok River,1997,426,,192,2478
Kanektok River,1997,150,,193,2628
Kanektok River,1997,324,,194,2952
Kanektok River,1997,672,,195,3624
Kanektok River,1997,162,,196,3786
Kanektok River,1997,252,,197,4038
Kanektok River,1997,312,,198,4350
Kanektok River,1997,84,,199,4434
Kanektok River,1997,102,,200,4536
Kanektok River,1997,108,,201,4644
Kanektok River,1997,160,,202,4804
Kanektok River,1997,210,,203,5014
Kanektok River,1997,144,,204,5158
Kanektok River,1997,132,,205,5290
Kanektok River,1997,42,,206,5332
Kanektok River,1997,24,,207,5356
Kanektok River,1997,90,,208,5446
Kanektok River,1997,144,,209,5590
Kanektok River,1997,102,,210,5692
Kanektok River,1997,102,,211,5794
Kanektok River,1997,156,,212,5950
Kanektok River,1997,72,,213,6022
Kanektok River,1997,96,,214,6118
Kanektok River,1997,60,,215,6178
Kanektok River,1997,240,,216,6418
Kanektok River,1997,186,,217,6604
Kanektok River,1997,132,,218,6736
Kanektok River,1997,120,,219,6856
Kanektok River,1997,114,,220,6970
Kanektok River,1997,60,,221,7030
Kanektok River,1997,66,,222,7096
Kanektok River,1997,78,,223,7174
Kanektok River,1997,60,,224,7234
Kanektok River,1997,36,,225,7270
Kanektok River,1997,90,,226,7360
Kanektok River,1997,42,,227,7402
Kanektok River,1997,108,,228,7510
Kanektok River,1997,138,,229,7648
Kanektok River,1997,90,,230,7738
Kanektok River,1997,78,,231,7816
Kanektok River,1997,72,,232,7888
Kanektok River,1997,6,,233,7894
Kanektok River,2001,0,,222,0
Kanektok River,2001,9,,223,9
Kanektok River,2001,2,,224,11
Kanektok River,2001,1,,225,12
Kanektok River,2001,0,,226,12
Kanektok River,2001,2,,227,14
Kanektok River,2001,0,,228,14
Kanektok River,2001,1,,229,15
Kanektok River,2001,0,,230,15
Kanektok River,2001,0,,231,15
Kanektok River,2001,0,,232,15
Kanektok River,2001,2,,233,17
Kanektok River,2001,0,,234,17
Kanektok River,2001,0,,235,17
Kanektok River,2001,0,,236,17
Kanektok River,2001,0,,237,17
Kanektok River,2001,0,,238,17
Kanektok River,2001,0,,239,17
Kanektok River,2001,0,,240,17
Kanektok River,2001,1,,241,18
Kanektok River,2001,0,,242,18
Kanektok River,2001,0,,243,18
Kanektok River,2001,0,,244,18
Kanektok River,2001,0,,245,18
Kanektok River,2001,0,,246,18
Kanektok River,2001,0,,247,18
Kanektok River,2001,0,,248,18
Kanektok River,2001,0,,249,18
Kanektok River,2001,0,,250,18
Kanektok River,2001,0,,251,18
Kanektok River,2001,0,,252,18
Kanektok River,2001,0,,253,18
Kanektok River,2001,0,,254,18
Kanektok River,2001,0,,255,18
Kanektok River,2001,0,,256,18
Kanektok River,2001,0,,257,18
Kanektok River,2001,1,,258,19
Kanektok River,2001,0,,259,19
Kanektok River,2001,0,,260,19
Kanektok River,2001,0,,261,19
Kanektok River,2001,0,,262,19
Kanektok River,2001,0,,263,19
Kanektok River,2001,0,,264,19
Kanektok River,2001,0,,265,19
Kanektok River,2001,0,,266,19
Kanektok River,2001,0,,267,19
Kanektok River,2001,0,,268,19
Kanektok River,2001,0,,269,19
Kanektok River,2001,0,,270,19
Kanektok River,2001,0,,271,19
Kanektok River,2001,0,,272,19
Kanektok River,2001,0,,273,19
Kanektok River,2001,0,,274,19
Kanektok River,2001,0,,275,19
Kanektok River,2001,0,,276,19
Kanektok River,2002,1,,182,1
Kanektok River,2002,2,,183,3
Kanektok River,2002,7,,184,10
Kanektok River,2002,20,,185,30
Kanektok River,2002,96,,186,126
Kanektok River,2002,67,,187,193
Kanektok River,2002,96,,188,289
Kanektok River,2002,139,,189,428
Kanektok River,2002,135,,190,563
Kanektok River,2002,109,,191,672
Kanektok River,2002,218,,192,890
Kanektok River,2002,244,,193,1134
Kanektok River,2002,376,,194,1510
Kanektok River,2002,691,,195,2201
Kanektok River,2002,916,,196,3117
Kanektok River,2002,713,,197,3830
Kanektok River,2002,1413,,198,5243
Kanektok River,2002,2822,,199,8065
Kanektok River,2002,3059,,200,11124
Kanektok River,2002,2489,,201,13613
Kanektok River,2002,1776,,202,15389
Kanektok River,2002,2615,,203,18004
Kanektok River,2002,4291,,204,22295
Kanektok River,2002,8111,,205,30406
Kanektok River,2002,3368,,206,33774
Kanektok River,2002,1893,,207,35667
Kanektok River,2002,2793,,208,38460
Kanektok River,2002,3431,,209,41891
Kanektok River,2002,2703,,210,44594
Kanektok River,2002,4760,,211,49354
Kanektok River,2002,5781,,212,55135
Kanektok River,2002,6811,,213,61946
Kanektok River,2002,3074,,214,65020
Kanektok River,2002,4490,,215,69510
Kanektok River,2002,3952,,216,73462
Kanektok River,2002,3298,,217,76760
Kanektok River,2002,1785,,218,78545
Kanektok River,2002,1186,,219,79731
Kanektok River,2002,994,,220,80725
Kanektok River,2002,851,,221,81576
Kanektok River,2002,843,,222,82419
Kanektok River,2002,490,,223,82909
Kanektok River,2002,283,,224,83192
Kanektok River,2002,954,,225,84146
Kanektok River,2002,345,,226,84491
Kanektok River,2002,571,,227,85062
Kanektok River,2002,343,,228,85405
Kanektok River,2002,394,,229,85799
Kanektok River,2002,219,,230,86018
Kanektok River,2002,236,,231,86254
Kanektok River,2002,154,,232,86408
Kanektok River,2002,144,,233,86552
Kanektok River,2002,130,,234,86682
Kanektok River,2002,90,,235,86772
Kanektok River,2002,79,,236,86851
Kanektok River,2002,42,,237,86893
Kanektok River,2002,19,,238,86912
Kanektok River,2002,16,,239,86928
Kanektok River,2002,27,,240,86955
Kanektok River,2002,13,,241,86968
Kanektok River,2002,12,,242,86980
Kanektok River,2002,10,,243,86990
Kanektok River,2002,7,,244,86997
Kanektok River,2002,13,,245,87010
Kanektok River,2002,5,,246,87015
Kanektok River,2002,3,,247,87018
Kanektok River,2002,4,,248,87022
Kanektok River,2002,6,,249,87028
Kanektok River,2002,0,,250,87028
Kanektok River,2002,0,,251,87028
Kanektok River,2002,0,,252,87028
Kanektok River,2002,0,,253,87028
Kanektok River,2002,1,,254,87029
Kanektok River,2002,0,,255,87029
Kanektok River,2002,1,,256,87030
Kanektok River,2002,0,,257,87030
Kanektok River,2002,1,,258,87031
Kanektok River,2002,4,,259,87035
Kanektok River,2002,1,,260,87036
Kanektok River,2002,0,,261,87036
Kanektok River,2002,0,,262,87036
Kanektok River,2002,0,,263,87036
Kanektok River,2003,0,,175,0
Kanektok River,2003,0,,176,0
Kanektok River,2003,0,,177,0
Kanektok River,2003,0,,178,0
Kanektok River,2003,12,,179,12
Kanektok River,2003,9,,180,21
Kanektok River,2003,27,,181,48
Kanektok River,2003,14,,182,62
Kanektok River,2003,10,,183,72
Kanektok River,2003,13,,184,85
Kanektok River,2003,58,,185,143
Kanektok River,2003,73,,186,216
Kanektok River,2003,77,,187,293
Kanektok River,2003,36,,188,329
Kanektok River,2003,91,,189,420
Kanektok River,2003,126,,190,546
Kanektok River,2003,153,,191,699
Kanektok River,2003,84,,192,783
Kanektok River,2003,109,,193,892
Kanektok River,2003,144,,194,1036
Kanektok River,2003,145,,195,1181
Kanektok River,2003,168,,196,1349
Kanektok River,2003,135,,197,1484
Kanektok River,2003,90,,198,1574
Kanektok River,2003,86,,199,1660
Kanektok River,2003,92,,200,1752
Kanektok River,2003,89,,201,1841
Kanektok River,2003,47,,202,1888
Kanektok River,2003,60,,203,1948
Kanektok River,2003,83,,204,2031
Kanektok River,2003,15,,205,2046
Kanektok River,2003,26,,206,2072
Kanektok River,2003,23,,207,2095
Kanektok River,2003,25,,208,2120
Kanektok River,2003,26,,209,2146
Kanektok River,2003,15,,210,2161
Kanektok River,2003,20,,211,2181
Kanektok River,2003,4,,212,2185
Kanektok River,2003,1,,213,2186
Kanektok River,2003,14,,214,2200
Kanektok River,2003,4,,215,2204
Kanektok River,2003,12,,216,2216
Kanektok River,2003,12,,217,2228
Kanektok River,2003,15,,218,2243
Kanektok River,2003,7,,219,2250
Kanektok River,2003,14,,220,2264
Kanektok River,2003,5,,221,2269
Kanektok River,2003,5,,222,2274
Kanektok River,2003,5,,223,2279
Kanektok River,2003,10,,224,2289
Kanektok River,2003,8,,225,2297
Kanektok River,2003,3,,226,2300
Kanektok River,2003,1,,227,2301
Kanektok River,2003,0,,228,2301
Kanektok River,2003,0,,229,2301
Kanektok River,2003,0,,230,2301
Kanektok River,2003,1,,231,2302
Kanektok River,2003,2,,232,2304
Kanektok River,2003,0,,233,2304
Kanektok River,2003,7,,234,2311
Kanektok River,2003,13,,235,2324
Kanektok River,2003,12,,236,2336
Kanektok River,2003,7,,237,2343
Kanektok River,2003,11,,238,2354
Kanektok River,2003,7,,239,2361
Kanektok River,2003,10,,240,2371
Kanektok River,2003,13,,241,2384
Kanektok River,2003,9,,242,2393
Kanektok River,2003,4,,243,2397
Kanektok River,2003,13,,244,2410
Kanektok River,2003,4,,245,2414
Kanektok River,2003,5,,246,2419
Kanektok River,2003,0,,247,2419
Kanektok River,2003,3,,248,2422
Kanektok River,2003,0,,249,2422
Kanektok River,2003,6,,250,2428
Kanektok River,2003,5,,251,2433
Kanektok River,2003,2,,252,2435
Kanektok River,2003,0,,253,2435
Kanektok River,2003,1,,254,2436
Kanektok River,2003,3,,255,2439
Kanektok River,2003,2,,256,2441
Kanektok River,2003,0,,257,2441
Kanektok River,2003,0,,258,2441
Kanektok River,2003,0,,259,2441
Kanektok River,2003,2,,260,2443
Kanektok River,2003,0,,261,2443
Kanektok River,2004,5,,181,5
Kanektok River,2004,68,,182,73
Kanektok River,2004,73,,183,146
Kanektok River,2004,37,,184,183
Kanektok River,2004,38,,185,221
Kanektok River,2004,68,,186,289
Kanektok River,2004,84,,187,373
Kanektok River,2004,75,,188,448
Kanektok River,2004,157,,189,605
Kanektok River,2004,169,,190,774
Kanektok River,2004,296,,191,1070
Kanektok River,2004,372,,192,1442
Kanektok River,2004,461,,193,1903
Kanektok River,2004,546,,194,2449
Kanektok River,2004,351,,195,2800
Kanektok River,2004,325,,196,3125
Kanektok River,2004,333,,197,3458
Kanektok River,2004,385,,198,3843
Kanektok River,2004,319,,199,4162
Kanektok River,2004,601,,200,4763
Kanektok River,2004,703,,201,5466
Kanektok River,2004,949,,202,6415
Kanektok River,2004,1237,,203,7652
Kanektok River,2004,1167,,204,8819
Kanektok River,2004,1261,,205,10080
Kanektok River,2004,2384,,206,12464
Kanektok River,2004,2922,,207,15386
Kanektok River,2004,2864,,208,18250
Kanektok River,2004,5416,,209,23666
Kanektok River,2004,2864,,210,26530
Kanektok River,2004,3371,,211,29901
Kanektok River,2004,3924,,212,33825
Kanektok River,2004,4050,,213,37875
Kanektok River,2004,7135,,214,45010
Kanektok River,2004,6124,,215,51134
Kanektok River,2004,9367,,216,60501
Kanektok River,2004,4493,,217,64994
Kanektok River,2004,2959,,218,67953
Kanektok River,2004,1496,,219,69449
Kanektok River,2004,4731,,220,74180
Kanektok River,2004,2086,,221,76266
Kanektok River,2004,2504,,222,78770
Kanektok River,2004,1788,,223,80558
Kanektok River,2004,2089,,224,82647
Kanektok River,2004,2334,,225,84981
Kanektok River,2004,2003,,226,86984
Kanektok River,2004,1292,,227,88276
Kanektok River,2004,862,,228,89138
Kanektok River,2004,1679,,229,90817
Kanektok River,2004,1459,,230,92276
Kanektok River,2004,954,,231,93230
Kanektok River,2004,399,,232,93629
Kanektok River,2004,715,,233,94344
Kanektok River,2004,520,,234,94864
Kanektok River,2004,384,,235,95248
Kanektok River,2004,277,,236,95525
Kanektok River,2004,480,,237,96005
Kanektok River,2004,509,,238,96514
Kanektok River,2004,277,,239,96791
Kanektok River,2004,109,,240,96900
Kanektok River,2004,122,,241,97022
Kanektok River,2004,170,,242,97192
Kanektok River,2004,109,,243,97301
Kanektok River,2004,155,,244,97456
Kanektok River,2004,162,,245,97618
Kanektok River,2004,164,,246,97782
Kanektok River,2004,75,,247,97857
Kanektok River,2004,28,,248,97885
Kanektok River,2004,25,,249,97910
Kanektok River,2004,38,,250,97948
Kanektok River,2004,30,,251,97978
Kanektok River,2004,24,,252,98002
Kanektok River,2004,17,,253,98019
Kanektok River,2004,12,,254,98031
Kanektok River,2004,8,,255,98039
Kanektok River,2004,8,,256,98047
Kanektok River,2004,3,,257,98050
Kanektok River,2004,3,,258,98053
Kanektok River,2004,2,,259,98055
Kanektok River,2004,1,,260,98056
Kanektok River,2004,1,,261,98057
Kanektok River,2004,3,,262,98060
Kanektok River,2004,0,,263,98060
Kanektok River,2004,0,,264,98060
Kanektok River,2005,88,,189,88
Kanektok River,2005,340,,190,428
Kanektok River,2005,370,,191,798
Kanektok River,2005,289,,192,1087
Kanektok River,2005,174,,193,1261
Kanektok River,2005,204,,194,1465
Kanektok River,2005,209,,195,1674
Kanektok River,2005,188,,196,1862
Kanektok River,2005,265,,197,2127
Kanektok River,2005,177,,198,2304
Kanektok River,2005,87,,199,2391
Kanektok River,2005,116,,200,2507
Kanektok River,2005,171,,201,2678
Kanektok River,2005,162,,202,2840
Kanektok River,2005,93,,203,2933
Kanektok River,2005,86,,204,3019
Kanektok River,2005,135,,205,3154
Kanektok River,2005,47,,206,3201
Kanektok River,2005,81,,207,3282
Kanektok River,2005,49,,208,3331
Kanektok River,2005,37,,209,3368
Kanektok River,2005,31,,210,3399
Kanektok River,2005,29,,211,3428
Kanektok River,2005,25,,212,3453
Kanektok River,2005,5,,213,3458
Kanektok River,2005,14,,214,3472
Kanektok River,2005,4,,215,3476
Kanektok River,2005,8,,216,3484
Kanektok River,2005,4,,217,3488
Kanektok River,2005,5,,218,3493
Kanektok River,2005,1,,219,3494
Kanektok River,2005,3,,220,3497
Kanektok River,2005,2,,221,3499
Kanektok River,2005,2,,222,3501
Kanektok River,2005,1,,223,3502
Kanektok River,2005,1,,224,3503
Kanektok River,2005,3,,225,3506
Kanektok River,2005,3,,226,3509
Kanektok River,2005,2,,227,3511
Kanektok River,2005,2,,228,3513
Kanektok River,2005,3,,229,3516
Kanektok River,2005,1,,230,3517
Kanektok River,2005,2,,231,3519
Kanektok River,2005,1,,232,3520
Kanektok River,2005,1,,233,3521
Kanektok River,2005,0,,234,3521
Kanektok River,2005,7,,235,3528
Kanektok River,2005,0,,236,3528
Kanektok River,2005,0,,237,3528
Kanektok River,2005,1,,238,3529
Kanektok River,2005,0,,239,3529
Kanektok River,2005,0,,240,3529
Kanektok River,2005,0,,241,3529
Kanektok River,2005,0,,242,3529
Kanektok River,2005,0,,243,3529
Kanektok River,2005,0,,244,3529
Kanektok River,2005,0,,245,3529
Kanektok River,2005,0,,246,3529
Kanektok River,2005,0,,247,3529
Kanektok River,2005,0,,248,3529
Kanektok River,2005,0,,249,3529
Kanektok River,2005,0,,250,3529
Kanektok River,2005,1,,251,3530
Kanektok River,2007,0,,170,0
Kanektok River,2007,0,,171,0
Kanektok River,2007,0,,172,0
Kanektok River,2007,0,,173,0
Kanektok River,2007,0,,174,0
Kanektok River,2007,0,,175,0
Kanektok River,2007,0,,176,0
Kanektok River,2007,0,,177,0
Kanektok River,2007,0,,178,0
Kanektok River,2007,0,,179,0
Kanektok River,2007,0,,180,0
Kanektok River,2007,0,,181,0
Kanektok River,2007,0,,182,0
Kanektok River,2007,1,,183,1
Kanektok River,2007,2,,184,3
Kanektok River,2007,9,,185,12
Kanektok River,2007,7,,186,19
Kanektok River,2007,9,,187,28
Kanektok River,2007,9,,188,37
Kanektok River,2007,24,,189,61
Kanektok River,2007,42,,190,103
Kanektok River,2007,64,,191,167
Kanektok River,2007,49,,192,216
Kanektok River,2007,106,,193,322
Kanektok River,2007,52,,194,374
Kanektok River,2007,38,,195,412
Kanektok River,2007,49,,196,461
Kanektok River,2007,72,,197,533
Kanektok River,2007,137,,198,670
Kanektok River,2007,97,,199,767
Kanektok River,2007,164,,200,931
Kanektok River,2007,220,,201,1151
Kanektok River,2007,206,,202,1357
Kanektok River,2007,126,,203,1483
Kanektok River,2007,173,,204,1656
Kanektok River,2007,217,,205,1873
Kanektok River,2007,194,,206,2067
Kanektok River,2007,241,,207,2308
Kanektok River,2007,215,,208,2523
Kanektok River,2007,149,,209,2672
Kanektok River,2007,116,,210,2788
Kanektok River,2007,65,,211,2853
Kanektok River,2007,63,,212,2916
Kanektok River,2007,36,,213,2952
Kanektok River,2007,21,,214,2973
Kanektok River,2007,17,,215,2990
Kanektok River,2007,9,,216,2999
Kanektok River,2007,7,,217,3006
Kanektok River,2007,4,,218,3010
Kanektok River,2007,4,,219,3014
Kanektok River,2007,2,,220,3016
Kanektok River,2007,2,,221,3018
Kanektok River,2007,2,,222,3020
Kanektok River,2007,0,,223,3020
Kanektok River,2007,3,,224,3023
Kanektok River,2007,5,,225,3028
Kanektok River,2007,3,,226,3031
Kanektok River,2007,1,,227,3032
Kanektok River,2007,2,,228,3034
Kanektok River,2007,1,,229,3035
Kanektok River,2007,0,,230,3035
Kanektok River,2007,2,,231,3037
Kanektok River,2007,4,,232,3041
Kanektok River,2007,0,,233,3041
Kanektok River,2007,1,,234,3042
Kanektok River,2007,1,,235,3043
Kanektok River,2007,0,,236,3043
Kanektok River,2007,4,,237,3047
Kanektok River,2007,1,,238,3048
Kanektok River,2007,0,,239,3048
Kanektok River,2007,1,,240,3049
Kanektok River,2007,0,,241,3049
Kanektok River,2007,0,,242,3049
Kanektok River,2007,0,,243,3049
Kanektok River,2007,2,,244,3051
Kanektok River,2007,0,,245,3051
Kanektok River,2007,1,,246,3052
Kanektok River,2007,7,,247,3059
Kanektok River,2007,8,,248,3067
Kanektok River,2007,5,,249,3072
Kanektok River,2007,0,,250,3072
Kanektok River,2007,0,,251,3072
Kanektok River,2007,1,,252,3073
Kanektok River,2007,2,,253,3075
Kanektok River,2007,0,,254,3075
Kanektok River,2008,241,,199,241
Kanektok River,2008,413,,200,654
Kanektok River,2008,677,,201,1331
Kanektok River,2008,475,,202,1806
Kanektok River,2008,887,,203,2693
Kanektok River,2008,3363,,204,6056
Kanektok River,2008,2519,,205,8575
Kanektok River,2008,4049,,206,12624
Kanektok River,2008,6308,,207,18932
Kanektok River,2008,9700,,208,28632
Kanektok River,2008,9971,,209,38603
Kanektok River,2008,8268,,210,46871
Kanektok River,2008,9270,,211,56141
Kanektok River,2008,8464,,212,64605
Kanektok River,2008,10431,,213,75036
Kanektok River,2008,9588,,214,84624
Kanektok River,2008,9591,,215,94215
Kanektok River,2008,8294,,216,102509
Kanektok River,2008,5053,,217,107562
Kanektok River,2008,4172,,218,111734
Kanektok River,2008,6700,,219,118434
Kanektok River,2008,3176,,220,121610
Kanektok River,2008,4152,,221,125762
Kanektok River,2008,3064,,222,128826
Kanektok River,2008,2603,,223,131429
Kanektok River,2008,3170,,224,134599
Kanektok River,2008,1941,,225,136540
Kanektok River,2008,1860,,226,138400
Kanektok River,2008,1149,,227,139549
Kanektok River,2008,919,,228,140468
Kanektok River,2008,430,,229,140898
Kanektok River,2008,465,,230,141363
Kanektok River,2008,395,,231,141758
Kanektok River,2008,305,,232,142063
Kanektok River,2008,248,,233,142311
Kanektok River,2008,119,,234,142430
Kanektok River,2009,12,,186,12
Kanektok River,2009,24,,187,36
Kanektok River,2009,53,,188,89
Kanektok River,2009,39,,189,128
Kanektok River,2009,25,,190,153
Kanektok River,2009,22,,191,175
Kanektok River,2009,47,,192,222
Kanektok River,2009,65,,193,287
Kanektok River,2009,67,,194,354
Kanektok River,2009,104,,195,458
Kanektok River,2009,72,,196,530
Kanektok River,2009,50,,197,580
Kanektok River,2009,103,,198,683
Kanektok River,2009,84,,199,767
Kanektok River,2009,69,,200,836
Kanektok River,2009,69,,201,905
Kanektok River,2009,75,,202,980
Kanektok River,2009,65,,203,1045
Kanektok River,2009,59,,204,1104
Kanektok River,2009,47,,205,1151
Kanektok River,2009,26,,206,1177
Kanektok River,2009,17,,207,1194
Kanektok River,2009,14,,208,1208
Kanektok River,2009,9,,209,1217
Kanektok River,2009,3,,210,1220
Kanektok River,2009,2,,211,1222
Kanektok River,2009,0,,212,1222
Kanektok River,2009,1,,213,1223
Kanektok River,2009,7,,214,1230
Kanektok River,2009,1,,215,1231
Kanektok River,2009,3,,216,1234
Kanektok River,2009,2,,217,1236
Kanektok River,2009,0,,218,1236
Kanektok River,2009,0,,219,1236
Kanektok River,2009,2,,220,1238
Kanektok River,2009,4,,221,1242
Kanektok River,2009,2,,222,1244
Kanektok River,2009,2,,223,1246
Kanektok River,2010,0,,179,0
Kanektok River,2010,0,,180,0
Kanektok River,2010,0,,181,0
Kanektok River,2010,7,,182,7
Kanektok River,2010,14,,183,21
Kanektok River,2010,6,,184,27
Kanektok River,2010,17,,185,44
Kanektok River,2010,27,,186,71
Kanektok River,2010,17,,187,88
Kanektok River,2010,33,,188,121
Kanektok River,2010,29,,189,150
Kanektok River,2010,51,,190,201
Kanektok River,2010,57,,191,258
Kanektok River,2010,62,,192,320
Kanektok River,2010,180,,193,500
Kanektok River,2010,404,,194,904
Kanektok River,2010,762,,195,1666
Kanektok River,2010,1105,,196,2771
Kanektok River,2010,1241,,197,4012
Kanektok River,2010,1681,,198,5693
Kanektok River,2010,3213,,199,8906
Kanektok River,2010,2481,,200,11387
Kanektok River,2010,1618,,201,13005
Kanektok River,2010,3771,,202,16776
Kanektok River,2010,3044,,203,19820
Kanektok River,2010,3185,,204,23005
Kanektok River,2010,2612,,205,25617
Kanektok River,2010,4461,,206,30078
Kanektok River,2010,5103,,207,35181
Kanektok River,2010,5789,,208,40970
Kanektok River,2010,10926,,209,51896
Kanektok River,2010,11203,,210,63099
Kanektok River,2010,8444,,211,71543
Kanektok River,2010,3458,,212,75001
Kanektok River,2010,3689,,213,78690
Kanektok River,2010,8178,,214,86868
Kanektok River,2010,8466,,215,95334
Kanektok River,2010,6474,,216,101808
Kanektok River,2010,12266,,217,114074
Kanektok River,2011,3,,178,3
Kanektok River,2011,1,,179,4
Kanektok River,2011,6,,180,10
Kanektok River,2011,7,,181,17
Kanektok River,2011,17,,182,34
Kanektok River,2011,19,,183,53
Kanektok River,2011,13,,184,66
Kanektok River,2011,17,,185,83
Kanektok River,2011,55,,186,138
Kanektok River,2011,30,,187,168
Kanektok River,2011,27,,188,195
Kanektok River,2011,106,,189,301
Kanektok River,2011,20,,190,321
Kanektok River,2011,9,,191,330
Kanektok River,2011,25,,192,355
Kanektok River,2011,38,,193,393
Kanektok River,2011,27,,194,420
Kanektok River,2011,21,,195,441
Kanektok River,2011,3,,196,444
Kanektok River,2011,8,,197,452
Kanektok River,2011,8,,198,460
Kanektok River,2011,4,,199,464
Kanektok River,2011,12,,200,476
Kanektok River,2011,3,,201,479
Kanektok River,2011,0,,202,479
Kanektok River,2011,3,,203,482
Kanektok River,2011,3,,204,485
Kanektok River,2011,1,,205,486
Kanektok River,2011,1,,206,487
Kanektok River,2011,3,,207,490
Kanektok River,2011,0,,208,490
Kanektok River,2011,0,,209,490
Kanektok River,2011,1,,210,491
Kanektok River,2011,0,,211,491
Kanektok River,2011,0,,212,491
Kanektok River,2011,8,,213,499
Kanektok River,2011,4,,214,503
Kanektok River,2011,12,,215,515
Kanektok River,2011,3,,216,518
Kanektok River,2011,0,,217,518
Kanektok River,2011,3,,218,521
Kanektok River,2011,3,,219,524
Kanektok River,2011,1,,220,525
Kanektok River,2011,1,,221,526
Kanektok River,2011,3,,222,529
Kanektok River,2011,0,,223,529
Kanektok River,2011,0,,224,529
Kanektok River,2011,1,,225,530
Kanektok River,2011,0,,226,530
Kanektok River,2006,1,,184,1
Kanektok River,2006,0,,185,1
Kanektok River,2006,0,,186,1
Kanektok River,2006,0,,187,1
Kanektok River,2006,1,,188,2
Kanektok River,2006,1,,189,3
Kanektok River,2006,0,,190,3
Kanektok River,2006,0,,191,3
Kanektok River,2006,1,,192,4
Kanektok River,2006,0,,193,4
Kanektok River,2006,0,,194,4
Kanektok River,2006,0,,195,4
Kanektok River,2006,0,,196,4
Kanektok River,2006,1,,197,5
Kanektok River,2006,0,,198,5
Kanektok River,2006,0,,199,5
Kanektok River,2006,0,,200,5
Kanektok River,2006,0,,201,5
Kanektok River,2006,3,,202,8
Kanektok River,2006,0,,203,8
Kanektok River,2006,2,,204,10
Kanektok River,2006,17,,205,27
Kanektok River,2006,16,,206,43
Kanektok River,2006,1,,207,44
Kanektok River,2006,1,,208,45
Kanektok River,2006,4,,209,49
Kanektok River,2006,0,,210,49
Kanektok River,2006,0,,211,49
Kanektok River,2006,1,,212,50
Kanektok River,2006,8,,213,58
Kanektok River,2006,35,,214,93
Kanektok River,2006,11,,215,104
Kanektok River,2006,9052,,216,9156
Kanektok River,2006,53,,217,9209
Kanektok River,2006,38,,218,9247
Kanektok River,2006,0,,219,9247
Kanektok River,2006,55,,220,9302
Kanektok River,2006,2927,,221,12229
Kanektok River,2006,125,,222,12354
Kanektok River,2006,18501,,223,30855
Kanektok River,2006,28450,,224,59305
Kanektok River,2006,11418,,225,70723
Kanektok River,2006,9513,,226,80236
Kanektok River,2006,30134,,227,110370
Kanektok River,2006,31812,,228,142182
Kanektok River,2006,48755,,229,190937
Kanektok River,2006,75476,,230,266413
Kanektok River,2006,54786,,231,321199
Kanektok River,2006,70658,,232,391857
Kanektok River,2006,7522,,233,399379
Kanektok River,2006,44726,,234,444105
Kanektok River,2006,32217,,235,476322
Kanektok River,2006,39656,,236,515978
Kanektok River,2006,107098,,237,623076
Kanektok River,2006,67672,,238,690748
Kanektok River,2006,52275,,239,743023
Kanektok River,2006,63039,,240,806062
Kanektok River,2006,24583,,241,830645
Kanektok River,2006,8810,,242,839455
Kanektok River,2006,67538,,243,906993
Kanektok River,2006,12644,,244,919637
Kanektok River,2006,1083,,245,920720
Kanektok River,2006,4414,,246,925134
Kanektok River,2006,4805,,247,929939
Kanektok River,2006,6898,,248,936837
Kanektok River,2006,12890,,249,949727
Kanektok River,2006,9341,,250,959068
Kanektok River,2006,15610,,251,974678
Kanektok River,2006,11124,,252,985802
Kanektok River,2006,6210,,253,992012
Kanektok River,2006,4485,,254,996497
Kanektok River,2006,2141,,255,998638
Kanektok River,2006,733,,256,999371
Kanektok River,2006,9350,,257,1008721
Kanektok River,2006,4590,,258,1013311
Kanektok River,2006,2448,,259,1015759
Kanektok River,2006,2800,,260,1018559
Kanektok River,2006,92,,261,1018651
Kanektok River,2006,632,,262,1019283
Kanektok River,2007,0,,197,0
Kanektok River,2007,1,,198,1
Kanektok River,2007,0,,199,1
Kanektok River,2007,0,,200,1
Kanektok River,2007,3,,201,4
Kanektok River,2007,1,,202,5
Kanektok River,2007,2,,203,7
Kanektok River,2007,1,,204,8
Kanektok River,2007,0,,205,8
Kanektok River,2007,26,,206,34
Kanektok River,2007,54,,207,88
Kanektok River,2007,3,,208,91
Kanektok River,2007,1,,209,92
Kanektok River,2007,0,,210,92
Kanektok River,2007,1,,211,93
Kanektok River,2007,5,,212,98
Kanektok River,2007,0,,213,98
Kanektok River,2007,5,,214,103
Kanektok River,2007,77,,215,180
Kanektok River,2007,129,,216,309
Kanektok River,2007,1089,,217,1398
Kanektok River,2007,167,,218,1565
Kanektok River,2007,5,,219,1570
Kanektok River,2007,266,,220,1836
Kanektok River,2007,96,,221,1932
Kanektok River,2007,312,,222,2244
Kanektok River,2007,133,,223,2377
Kanektok River,2007,4,,224,2381
Kanektok River,2007,8,,225,2389
Kanektok River,2007,2620,,226,5009
Kanektok River,2007,540,,227,5549
Kanektok River,2007,382,,228,5931
Kanektok River,2007,1998,,229,7929
Kanektok River,2007,1294,,230,9223
Kanektok River,2007,943,,231,10166
Kanektok River,2007,1948,,232,12114
Kanektok River,2007,3353,,233,15467
Kanektok River,2007,2277,,234,17744
Kanektok River,2007,4105,,235,21849
Kanektok River,2007,14146,,236,35995
Kanektok River,2007,1613,,237,37608
Kanektok River,2007,271,,238,37879
Kanektok River,2007,3425,,239,41304
Kanektok River,2007,4039,,240,45343
Kanektok River,2007,21246,,241,66589
Kanektok River,2007,15801,,242,82390
Kanektok River,2007,6595,,244,88985
Kanektok River,2007,16836,,245,105821
Kanektok River,2007,7360,,246,113181
Kanektok River,2007,10937,,247,124118
Kanektok River,2007,52748,,248,176866
Kanektok River,2007,5919,,249,182785
Kanektok River,2007,1934,,250,184719
Kanektok River,2007,30507,,251,215226
Kanektok River,2007,5578,,252,220804
Kanektok River,2007,1315,,253,222119
Kanektok River,2007,304,,254,222423
Kanektok River,2007,3222,,255,225645
Kanektok River,2007,1058,,256,226703
Kanektok River,2007,3617,,257,230320
Kanektok River,2007,1035,,258,231355
Kanektok River,2007,283,,259,231638
Kanektok River,2007,5264,,260,236902
Kanektok River,2007,127,,261,237029
Kanektok River,2007,1693,,262,238722
Kanektok River,2007,17,,263,238739
Kanektok River,2007,89,,264,238828
Kanektok River,2007,9,,265,238837
Kanektok River,2007,202,,266,239039
Kanektok River,2007,30,,267,239069
Kanektok River,2007,13,,268,239082
Kanektok River,2007,0,Wier closed,269,239082
Kanektok River,2008,1,,180,1
Kanektok River,2008,0,,181,1
Kanektok River,2008,0,,182,1
Kanektok River,2008,1,,183,2
Kanektok River,2008,0,,184,2
Kanektok River,2008,0,,185,2
Kanektok River,2008,0,,186,2
Kanektok River,2008,0,,187,2
Kanektok River,2008,0,,188,2
Kanektok River,2008,1,,189,3
Kanektok River,2008,0,,190,3
Kanektok River,2008,0,,191,3
Kanektok River,2008,0,,192,3
Kanektok River,2008,0,,193,3
Kanektok River,2008,0,,194,3
Kanektok River,2008,0,,195,3
Kanektok River,2008,0,,196,3
Kanektok River,2008,0,,197,3
Kanektok River,2008,0,,198,3
Kanektok River,2008,0,,199,3
Kanektok River,2008,0,,200,3
Kanektok River,2008,1,,201,4
Kanektok River,2008,2,,202,6
Kanektok River,2008,3,,203,9
Kanektok River,2008,0,,204,9
Kanektok River,2008,6,,205,15
Kanektok River,2008,26,,206,41
Kanektok River,2008,84,,207,125
Kanektok River,2008,82,,208,207
Kanektok River,2008,8,,209,215
Kanektok River,2008,88,,210,303
Kanektok River,2008,42,,211,345
Kanektok River,2008,23,,212,368
Kanektok River,2008,99,,213,467
Kanektok River,2008,168,,214,635
Kanektok River,2008,2212,,215,2847
Kanektok River,2008,235,,216,3082
Kanektok River,2008,789,,217,3871
Kanektok River,2008,984,,218,4855
Kanektok River,2008,11882,,219,16737
Kanektok River,2008,15665,,220,32402
Kanektok River,2008,17950,,221,50352
Kanektok River,2008,11275,,222,61627
Kanektok River,2008,10110,,223,71737
Kanektok River,2008,198,,224,71935
Kanektok River,2008,8839,,225,80774
Kanektok River,2008,49841,,226,130615
Kanektok River,2008,26740,,227,157355
Kanektok River,2008,17566,,228,174921
Kanektok River,2008,10058,,229,184979
Kanektok River,2008,14075,,230,199054
Kanektok River,2008,10628,,231,209682
Kanektok River,2008,102150,,232,311832
Kanektok River,2008,93233,,233,405065
Kanektok River,2008,18960,,234,424025
Kanektok River,2008,6516,,235,430541
Kanektok River,2008,13785,,236,444326
Kanektok River,2008,30248,,237,474574
Kanektok River,2008,12015,,238,486589
Kanektok River,2008,4532,,239,491121
Kanektok River,2008,29140,,240,520261
Kanektok River,2008,22693,,241,542954
Kanektok River,2008,12467,,242,555421
Kanektok River,2008,9471,,243,564892
Kanektok River,2008,4579,,244,569471
Kanektok River,2008,29982,,245,599453
Kanektok River,2008,2888,,246,602341
Kanektok River,2008,4375,,247,606716
Kanektok River,2008,669,,248,607385
Kanektok River,2008,1309,,249,608694
Kanektok River,2008,301,,250,608995
Kanektok River,2008,30,,251,609025
Kanektok River,2008,300,,252,609325
Kanektok River,2008,5000,estimate,253,614325
Kanektok River,2008,5112,,254,619437
Kanektok River,2008,56,,255,619493
Kanektok River,2008,121,,256,619614
Kanektok River,2008,27,,257,619641
Kanektok River,2008,93,,258,619734
Kanektok River,2008,133,,259,619867
Kanektok River,2008,153,,260,620020
Kanektok River,2008,7,,261,620027
Kanektok River,2008,148,,262,620175
Kanektok River,2008,1250,,263,621425
Kanektok River,2008,76,,264,621501
Kanektok River,2008,0,,265,621501
Kanektok River,2008,0,"wier closed, post wier estimate",266,621501
Kanektok River,2009,1,,176,1
Kanektok River,2009,0,,177,1
Kanektok River,2009,0,,178,1
Kanektok River,2009,0,,179,1
Kanektok River,2009,0,,180,1
Kanektok River,2009,0,,181,1
Kanektok River,2009,0,,182,1
Kanektok River,2009,1,,183,2
Kanektok River,2009,0,,184,2
Kanektok River,2009,1,,185,3
Kanektok River,2009,0,,186,3
Kanektok River,2009,11,,187,14
Kanektok River,2009,3,,188,17
Kanektok River,2009,2,,189,19
Kanektok River,2009,0,,190,19
Kanektok River,2009,0,,191,19
Kanektok River,2009,0,,192,19
Kanektok River,2009,0,,193,19
Kanektok River,2009,0,,194,19
Kanektok River,2009,0,,195,19
Kanektok River,2009,0,,196,19
Kanektok River,2009,0,,197,19
Kanektok River,2009,0,,198,19
Kanektok River,2009,0,,199,19
Kanektok River,2009,0,,200,19
Kanektok River,2009,1,,201,20
Kanektok River,2009,0,,202,20
Kanektok River,2009,2,,203,22
Kanektok River,2009,2,,204,24
Kanektok River,2009,0,,205,24
Kanektok River,2009,3,,206,27
Kanektok River,2009,5,,207,32
Kanektok River,2009,13,,208,45
Kanektok River,2009,6,,209,51
Kanektok River,2009,12,,210,63
Kanektok River,2009,95,,211,158
Kanektok River,2009,171,,212,329
Kanektok River,2009,164,,213,493
Kanektok River,2009,185,,214,678
Kanektok River,2009,452,,215,1130
Kanektok River,2009,2301,,216,3431
Kanektok River,2009,1381,,217,4812
Kanektok River,2009,61,,218,4873
Kanektok River,2009,1567,,219,6440
Kanektok River,2009,99,,220,6539
Kanektok River,2009,1244,,221,7783
Kanektok River,2009,907,,222,8690
Kanektok River,2009,677,,223,9367
Kanektok River,2009,423,,224,9790
Kanektok River,2009,3347,,225,13137
Kanektok River,2009,1503,,226,14640
Kanektok River,2009,5566,,227,20206
Kanektok River,2009,272,,228,20478
Kanektok River,2009,1476,,229,21954
Kanektok River,2009,1564,,230,23518
Kanektok River,2009,530,,231,24048
Kanektok River,2009,3074,,232,27122
Kanektok River,2009,3702,,233,30824
Kanektok River,2009,2087,,234,32911
Kanektok River,2009,6512,,235,39423
Kanektok River,2009,3551,,236,42974
Kanektok River,2009,6778,,237,49752
Kanektok River,2009,5015,,238,54767
Kanektok River,2009,10924,,239,65691
Kanektok River,2009,6307,,240,71998
Kanektok River,2009,10926,,241,82924
Kanektok River,2009,7122,,242,90046
Kanektok River,2009,10221,,243,100267
Kanektok River,2009,4948,,244,105215
Kanektok River,2009,9275,,245,114490
Kanektok River,2009,10612,,246,125102
Kanektok River,2009,9801,,247,134903
Kanektok River,2009,9149,,248,144052
Kanektok River,2009,2957,,249,147009
Kanektok River,2009,1653,,250,148662
Kanektok River,2009,1338,,251,150000
Kanektok River,2009,3830,,252,153830
Kanektok River,2009,579,,253,154409
Kanektok River,2009,763,,254,155172
Kanektok River,2009,477,,255,155649
Kanektok River,2009,234,,256,155883
Kanektok River,2009,320,,257,156203
Kanektok River,2009,484,,258,156687
Kanektok River,2009,170,,259,156857
Kanektok River,2009,1055,,260,157912
Kanektok River,2009,516,,261,158428
Kanektok River,2009,159,,262,158587
Kanektok River,2009,26,,263,158613
Kanektok River,2009,36,,264,158649
Kanektok River,2009,24,,265,158673
Kanektok River,2009,13,,266,158686
Kanektok River,2009,10,,267,158696
Kanektok River,2009,18,,268,158714
Kanektok River,2009,36,,269,158750
Kanektok River,2009,143,,270,158893
Kanektok River,2009,204,,271,159097
Kanektok River,2009,0,"wier closed, post wier estimate",272,159097
Kanektok River,2010,10,,191,10
Kanektok River,2010,2,,192,12
Kanektok River,2010,3,,193,15
Kanektok River,2010,5,,194,20
Kanektok River,2010,0,,195,20
Kanektok River,2010,0,,196,20
Kanektok River,2010,3,,197,23
Kanektok River,2010,3,,198,26
Kanektok River,2010,1,,199,27
Kanektok River,2010,9,,200,36
Kanektok River,2010,1,,201,37
Kanektok River,2010,0,,202,37
Kanektok River,2010,2,,203,39
Kanektok River,2010,0,,204,39
Kanektok River,2010,8,,205,47
Kanektok River,2010,68,,206,115
Kanektok River,2010,381,,207,496
Kanektok River,2010,67,,208,563
Kanektok River,2010,85,,209,648
Kanektok River,2010,1771,,210,2419
Kanektok River,2010,1673,,211,4092
Kanektok River,2010,2005,,212,6097
Kanektok River,2010,2753,,213,8850
Kanektok River,2010,586,,214,9436
Kanektok River,2010,4665,,215,14101
Kanektok River,2010,4031,,216,18132
Kanektok River,2010,42132,,217,60264
Kanektok River,2010,9872,,218,70136
Kanektok River,2010,21103,,219,91239
Kanektok River,2010,28724,,220,119963
Kanektok River,2010,87829,,221,207792
Kanektok River,2010,8456,,222,216248
Kanektok River,2010,30263,,223,246511
Kanektok River,2010,7624,,224,254135
Kanektok River,2010,11689,,225,265824
Kanektok River,2010,58692,,226,324516
Kanektok River,2010,73588,,227,398104
Kanektok River,2010,78453,,228,476557
Kanektok River,2010,134710,,229,611267
Kanektok River,2010,63749,,230,675016
Kanektok River,2010,42922,,231,717938
Kanektok River,2010,33454,,232,751392
Kanektok River,2010,51911,,233,803303
Kanektok River,2010,28649,,234,831952
Kanektok River,2010,83430,,235,915382
Kanektok River,2010,66285,,236,981667
Kanektok River,2010,83143,,237,1064810
Kanektok River,2010,75672,,238,1140482
Kanektok River,2010,60953,,239,1201435
Kanektok River,2010,23736,,240,1225171
Kanektok River,2010,12904,,241,1238075
Kanektok River,2010,26584,,242,1264659
Kanektok River,2010,16358,,243,1281017
Kanektok River,2010,8382,,244,1289399
Kanektok River,2010,8466,,245,1297865
Kanektok River,2010,2580,,246,1300445
Kanektok River,2010,3919,,247,1304364
Kanektok River,2010,10166,,248,1314530
Kanektok River,2010,3697,,249,1318227
Kanektok River,2010,3557,,250,1321784
Kanektok River,2010,104,,251,1321888
Kanektok River,2010,563,,252,1322451
Kanektok River,2010,637,,253,1323088
Kanektok River,2010,562,,254,1323650
Kanektok River,2010,247,,255,1323897
Kanektok River,2010,130,,256,1324027
Kanektok River,2010,48,,257,1324075
Kanektok River,2010,84,,258,1324159
Kanektok River,2010,65,,259,1324224
Kanektok River,2010,54,,260,1324278
Kanektok River,2010,90,"wier closed, post wier estimate",261,1324368
Kanektok River,2011,1,,180,1
Kanektok River,2011,0,,181,1
Kanektok River,2011,6,,182,7
Kanektok River,2011,0,,183,7
Kanektok River,2011,0,,184,7
Kanektok River,2011,0,,185,7
Kanektok River,2011,1,,186,8
Kanektok River,2011,0,,187,8
Kanektok River,2011,0,,188,8
Kanektok River,2011,0,,189,8
Kanektok River,2011,0,,190,8
Kanektok River,2011,0,,191,8
Kanektok River,2011,0,,192,8
Kanektok River,2011,15,,193,23
Kanektok River,2011,1,,194,24
Kanektok River,2011,2,,195,26
Kanektok River,2011,0,,196,26
Kanektok River,2011,3,,197,29
Kanektok River,2011,3,,198,32
Kanektok River,2011,3,,199,35
Kanektok River,2011,5,,200,40
Kanektok River,2011,3,,201,43
Kanektok River,2011,2,,202,45
Kanektok River,2011,3,,203,48
Kanektok River,2011,8,,204,56
Kanektok River,2011,18,,205,74
Kanektok River,2011,6,,206,80
Kanektok River,2011,10,,207,90
Kanektok River,2011,211,,208,301
Kanektok River,2011,18,,209,319
Kanektok River,2011,33,,210,352
Kanektok River,2011,198,,211,550
Kanektok River,2011,565,,212,1115
Kanektok River,2011,60,,213,1175
Kanektok River,2011,3068,,214,4243
Kanektok River,2011,527,,215,4770
Kanektok River,2011,19,,216,4789
Kanektok River,2011,40,,217,4829
Kanektok River,2011,87,,218,4916
Kanektok River,2011,1995,,219,6911
Kanektok River,2011,610,,220,7521
Kanektok River,2011,859,,221,8380
Kanektok River,2011,2164,,222,10544
Kanektok River,2011,1806,,223,12350
Kanektok River,2011,649,,224,12999
Kanektok River,2011,951,,225,13950
Kanektok River,2011,4093,,226,18043
Kanektok River,2011,85,,227,18128
Kanektok River,2011,936,,228,19064
Kanektok River,2011,1614,,229,20678
Kanektok River,2011,2907,,230,23585
Kanektok River,2011,14399,,231,37984
Kanektok River,2011,1816,,232,39800
Kanektok River,2011,2136,,233,41936
Kanektok River,2011,1041,,234,42977
Kanektok River,2011,2083,,235,45060
Kanektok River,2011,2806,,236,47866
Kanektok River,2011,5934,,237,53800
Kanektok River,2011,4658,,238,58458
Kanektok River,2011,8437,,239,66895
Kanektok River,2011,13953,,240,80848
Kanektok River,2011,2903,,241,83751
Kanektok River,2011,6778,,242,90529
Kanektok River,2011,9454,,243,99983
Kanektok River,2011,5040,,244,105023
Kanektok River,2011,11695,,245,116718
Kanektok River,2011,7752,,246,124470
Kanektok River,2011,1530,,247,126000
Kanektok River,2011,3143,,248,129143
Kanektok River,2011,8427,,249,137570
Kanektok River,2011,2408,,250,139978
Kanektok River,2011,4090,,251,144068
Kanektok River,2011,3725,,252,147793
Kanektok River,2011,1823,,253,149616
Kanektok River,2011,1096,,254,150712
Kanektok River,2011,597,,255,151309
Kanektok River,2011,425,,256,151734
Kanektok River,2011,340,,257,152074
Kanektok River,2011,1850,,258,153924
Kanektok River,2011,355,,259,154279
Kanektok River,2011,139,,260,154418
Kanektok River,2011,66,,261,154484
Kanektok River,2011,44,,262,154528
Kanektok River,2011,1048,,263,155576
Kanektok River,2011,79,,264,155655
Kanektok River,2011,0,wier pulled for season,265,155655
Kanektok River,2012,4,,175,4
Kanektok River,2012,0,,176,4
Kanektok River,2012,0,,177,4
Kanektok River,2012,20,,178,24
Kanektok River,2012,10,,179,34
Kanektok River,2012,6,,180,40
Kanektok River,2012,4,,181,44
Kanektok River,2012,3,,182,47
Kanektok River,2012,3,,183,50
Kanektok River,2012,0,,184,50
Kanektok River,2012,1,,185,51
Kanektok River,2012,0,,186,51
Kanektok River,2012,10,,187,61
Kanektok River,2012,16,,188,77
Kanektok River,2012,57,,189,134
Kanektok River,2012,6,,190,140
Kanektok River,2012,7,,191,147
Kanektok River,2012,17,,192,164
Kanektok River,2012,2,,193,166
Kanektok River,2012,187,,194,353
Kanektok River,2012,20,,195,373
Kanektok River,2012,20,,196,393
Kanektok River,2012,2,,197,395
Kanektok River,2012,0,,198,395
Kanektok River,2012,1,,199,396
Kanektok River,2012,10,,200,406
Kanektok River,2012,1,,201,407
Kanektok River,2012,1,,202,408
Kanektok River,2012,0,,203,408
Kanektok River,2012,1,,204,409
Kanektok River,2012,0,,205,409
Kanektok River,2012,11,,206,420
Kanektok River,2012,28,,207,448
Kanektok River,2012,103,,208,551
Kanektok River,2012,355,,209,906
Kanektok River,2012,717,,210,1623
Kanektok River,2012,551,,211,2174
Kanektok River,2012,2535,,212,4709
Kanektok River,2012,258,,213,4967
Kanektok River,2012,43,,214,5010
Kanektok River,2012,6103,,215,11113
Kanektok River,2012,4701,,216,15814
Kanektok River,2012,2148,,217,17962
Kanektok River,2012,4091,,218,22053
Kanektok River,2012,22985,,219,45038
Kanektok River,2012,7690,,220,52728
Kanektok River,2012,36103,,221,88831
Kanektok River,2012,41646,,222,130477
Kanektok River,2012,38782,,223,169259
Kanektok River,2012,2576,,224,171835
Kanektok River,2012,15877,,225,187712
Kanektok River,2012,18111,,226,205823
Kanektok River,2012,19161,,227,224984
Kanektok River,2012,118072,,228,343056
Kanektok River,2012,39918,,229,382974
Kanektok River,2012,45185,,230,428159
Kanektok River,2012,36765,,231,464924
Kanektok River,2012,97292,,232,562216
Kanektok River,2012,95416,,233,657632
Kanektok River,2012,31489,,234,689121
Kanektok River,2012,6574,,235,695695
Kanektok River,2012,112388,,236,808083
Kanektok River,2012,46159,,237,854242
Kanektok River,2012,20476,,238,874718
Kanektok River,2012,23904,,239,898622
Kanektok River,2012,17898,,240,916520
Kanektok River,2012,10860,,241,927380
Kanektok River,2012,32412,,242,959792
Kanektok River,2012,40258,,243,1000050
Kanektok River,2012,12565,,244,1012615
Kanektok River,2012,4063,,245,1016678
Kanektok River,2012,6321,,246,1022999
Kanektok River,2012,7101,,247,1030100
Kanektok River,2012,4712,,248,1034812
Kanektok River,2012,5000,"estimate, high water",249,1039812
Kanektok River,2012,5000,"estimate, high water",250,1044812
Kanektok River,2012,1013,,251,1045825
Kanektok River,2012,1000,"estimate, high water",252,1046825
Kanektok River,2012,330,,253,1047155
Kanektok River,2012,163,,254,1047318
Kanektok River,2012,513,,255,1047831
Kanektok River,2012,957,,256,1048788
Kanektok River,2012,178,,257,1048966
Kanektok River,2012,446,,258,1049412
Kanektok River,2012,287,,259,1049699
Kanektok River,2012,200,"estimate, high water",260,1049899
Kanektok River,2012,0,"estimate, high water, wier puller for season",261,1049899
Kogrukluk River,1982,1,,194,1
Kogrukluk River,1982,4,,195,5
Kogrukluk River,1982,3,,196,8
Kogrukluk River,1982,1,,197,9
Kogrukluk River,1982,2,,198,11
Kogrukluk River,1982,1,,199,12
Kogrukluk River,1982,1,,200,13
Kogrukluk River,1982,1,,206,14
Kogrukluk River,1982,1,,210,15
Kogrukluk River,1982,2,,211,17
Kogrukluk River,1984,1,,188,1
Kogrukluk River,1984,1,,197,2
Kogrukluk River,1984,1,,198,3
Kogrukluk River,1984,1,,199,4
Kogrukluk River,1984,3,,200,7
Kogrukluk River,1984,2,,202,9
Kogrukluk River,1984,3,,203,12
Kogrukluk River,1984,2,,205,14
Kogrukluk River,1984,1,,206,15
Kogrukluk River,1984,1,,207,16
Kogrukluk River,1984,1,,215,17
Kogrukluk River,1985,1,,201,1
Kogrukluk River,1985,2,,202,3
Kogrukluk River,1985,2,,212,5
Kogrukluk River,1985,1,,223,6
Kogrukluk River,1985,1,,236,7
Kogrukluk River,1986,1,,191,1
Kogrukluk River,1986,1,,192,2
Kogrukluk River,1986,2,,193,4
Kogrukluk River,1986,1,,196,5
Kogrukluk River,1986,1,,197,6
Kogrukluk River,1986,1,,198,7
Kogrukluk River,1986,1,,199,8
Kogrukluk River,1986,2,,233,10
Kogrukluk River,1988,1,,193,1
Kogrukluk River,1988,1,,199,2
Kogrukluk River,1988,1,,201,3
Kogrukluk River,1988,2,,202,5
Kogrukluk River,1988,4,,203,9
Kogrukluk River,1988,5,,204,14
Kogrukluk River,1988,5,,205,19
Kogrukluk River,1988,3,,207,22
Kogrukluk River,1988,1,,211,23
Kogrukluk River,1992,1,,191,1
Kogrukluk River,1992,1,,194,2
Kogrukluk River,1992,3,,197,5
Kogrukluk River,1992,1,,206,6
Kogrukluk River,1992,4,,226,10
Kogrukluk River,1995,1,,202,1
Kogrukluk River,1995,1,,203,2
Kogrukluk River,1995,1,,205,3
Kogrukluk River,1995,1,,207,4
Kogrukluk River,1995,2,,209,6
Kogrukluk River,1995,3,,230,9
Kogrukluk River,2001,5,,214,5
Kogrukluk River,2001,2,,215,7
Kogrukluk River,2001,1,,216,8
Kogrukluk River,2001,1,,248,9
Kogrukluk River,2004,1,,216,1
Kogrukluk River,2004,2,,217,3
Kogrukluk River,2004,1,,220,4
Kogrukluk River,2004,1,,221,5
Kogrukluk River,2004,3,,224,8
Kogrukluk River,2004,2,,228,10
Kogrukluk River,2004,4,,229,14
Kogrukluk River,2004,1,,230,15
Kogrukluk River,2004,1,,231,16
Kogrukluk River,2005,1,,188,1
Kogrukluk River,2005,4,,189,5
Kogrukluk River,2005,1,,190,6
Kogrukluk River,2005,2,,191,8
Kogrukluk River,2005,8,,192,16
Kogrukluk River,2005,6,,193,22
Kogrukluk River,2005,4,,194,26
Kogrukluk River,2005,14,,195,40
Kogrukluk River,2005,1,,196,41
Kogrukluk River,2005,6,,197,47
Kogrukluk River,2005,3,,198,50
Kogrukluk River,2005,2,,199,52
Kogrukluk River,2005,4,,200,56
Kogrukluk River,2005,4,,201,60
Kogrukluk River,2005,10,,202,70
Kogrukluk River,2005,1,,203,71
Kogrukluk River,2005,4,,204,75
Kogrukluk River,2005,1,,205,76
Kogrukluk River,2005,8,,206,84
Kogrukluk River,2005,3,,207,87
Kogrukluk River,2005,5,,208,92
Kogrukluk River,2005,3,,209,95
Kogrukluk River,2005,4,,210,99
Kogrukluk River,2005,3,,211,102
Kogrukluk River,2005,3,,212,105
Kogrukluk River,2005,1,,214,106
Kogrukluk River,2005,1,,215,107
Kogrukluk River,2005,1,,221,108
Kogrukluk River,2005,1,,225,109
Kogrukluk River,2006,1,,183,1
Kogrukluk River,2006,2,,184,3
Kogrukluk River,2006,3,,185,6
Kogrukluk River,2006,4,,186,10
Kogrukluk River,2006,3,,187,13
Kogrukluk River,2006,7,,189,20
Kogrukluk River,2006,3,,190,23
Kogrukluk River,2006,8,,191,31
Kogrukluk River,2006,6,,192,37
Kogrukluk River,2006,7,,193,44
Kogrukluk River,2006,9,,194,53
Kogrukluk River,2006,5,,195,58
Kogrukluk River,2006,2,,196,60
Kogrukluk River,2006,7,,197,67
Kogrukluk River,2006,2,,198,69
Kogrukluk River,2006,4,,199,73
Kogrukluk River,2006,6,,200,79
Kogrukluk River,2006,3,,201,82
Kogrukluk River,2006,6,,202,88
Kogrukluk River,2006,4,,203,92
Kogrukluk River,2006,6,,204,98
Kogrukluk River,2006,6,,205,104
Kogrukluk River,2006,12,,206,116
Kogrukluk River,2006,8,,207,124
Kogrukluk River,2006,5,,208,129
Kogrukluk River,2006,9,,209,138
Kogrukluk River,2006,11,,210,149
Kogrukluk River,2006,18,,211,167
Kogrukluk River,2006,27,,212,194
Kogrukluk River,2006,15,,213,209
Kogrukluk River,2006,28,,214,237
Kogrukluk River,2006,42,,215,279
Kogrukluk River,2006,51,,216,330
Kogrukluk River,2006,74,,217,404
Kogrukluk River,2006,52,,218,456
Kogrukluk River,2006,107,,219,563
Kogrukluk River,2006,78,,220,641
Kogrukluk River,2006,61,,221,702
Kogrukluk River,2006,87,,222,789
Kogrukluk River,2006,117,,223,906
Kogrukluk River,2006,3,,237,909
Kogrukluk River,2006,6,,238,915
Kogrukluk River,2006,3,,239,918
Kogrukluk River,2006,5,,240,923
Kogrukluk River,2006,5,,241,928
Kogrukluk River,2006,2,,242,930
Kogrukluk River,2006,2,,253,932
Kogrukluk River,2006,1,,255,933
Kogrukluk River,2007,1,,198,1
Kogrukluk River,2007,4,,199,5
Kogrukluk River,2007,1,,200,6
Kogrukluk River,2007,2,,203,8
Kogrukluk River,2007,5,,204,13
Kogrukluk River,2007,3,,205,16
Kogrukluk River,2007,3,,206,19
Kogrukluk River,2007,4,,207,23
Kogrukluk River,2007,3,,208,26
Kogrukluk River,2007,1,,209,27
Kogrukluk River,2007,2,,210,29
Kogrukluk River,2007,3,,211,32
Kogrukluk River,2008,1,,187,1
Kogrukluk River,2008,1,,191,2
Kogrukluk River,2008,1,,193,3
Kogrukluk River,2008,1,,194,4
Kogrukluk River,2008,3,,195,7
Kogrukluk River,2008,6,,196,13
Kogrukluk River,2008,4,,197,17
Kogrukluk River,2008,8,,198,25
Kogrukluk River,2008,7,,199,32
Kogrukluk River,2008,6,,200,38
Kogrukluk River,2008,2,,201,40
Kogrukluk River,2008,11,,202,51
Kogrukluk River,2008,6,,203,57
Kogrukluk River,2008,9,,204,66
Kogrukluk River,2008,7,,205,73
Kogrukluk River,2008,4,,206,77
Kogrukluk River,2008,3,,207,80
Kogrukluk River,2008,6,,208,86
Kogrukluk River,2008,4,,209,90
Kogrukluk River,2008,13,,210,103
Kogrukluk River,2008,6,,211,109
Kogrukluk River,2008,21,,212,130
Kogrukluk River,2008,21,,213,151
Kogrukluk River,2008,12,,214,163
Kogrukluk River,2008,19,,215,182
Kogrukluk River,2008,31,,216,213
Kogrukluk River,2008,50,,217,263
Kogrukluk River,2008,85,,218,348
Kogrukluk River,2008,20,,219,368
Kogrukluk River,2008,64,,220,432
Kogrukluk River,2008,60,,221,492
Kogrukluk River,2008,58,,222,550
Kogrukluk River,2008,39,,223,589
Kogrukluk River,2008,79,,224,668
Kogrukluk River,2008,79,,225,747
Kogrukluk River,2008,72,,226,819
Kogrukluk River,2008,67,,227,886
Kogrukluk River,2008,44,,228,930
Kogrukluk River,2008,20,,229,950
Kogrukluk River,2008,23,,230,973
Kogrukluk River,2008,16,,231,989
Kogrukluk River,2008,13,,232,1002
Kogrukluk River,2008,7,,233,1009
Kogrukluk River,2008,8,,234,1017
Kogrukluk River,2008,6,,235,1023
Kogrukluk River,2008,4,,236,1027
Kogrukluk River,2008,1,,237,1028
Kogrukluk River,2008,1,,238,1029
Kogrukluk River,2008,2,,239,1031
Kogrukluk River,2008,3,,240,1034
Kogrukluk River,2008,1,,241,1035
Kogrukluk River,2008,1,,244,1036
Kogrukluk River,2009,1,,188,1
Kogrukluk River,2009,1,,190,2
Kogrukluk River,2009,1,,191,3
Kogrukluk River,2009,3,,192,6
Kogrukluk River,2009,1,,193,7
Kogrukluk River,2009,2,,195,9
Kogrukluk River,2009,2,,196,11
Kogrukluk River,2009,1,,197,12
Kogrukluk River,2009,1,,198,13
Kogrukluk River,2009,2,,199,15
Kogrukluk River,2009,4,,200,19
Kogrukluk River,2009,5,,201,24
Kogrukluk River,2009,2,,202,26
Kogrukluk River,2009,1,,203,27
Kogrukluk River,2009,2,,204,29
Kogrukluk River,2009,3,,206,32
Kogrukluk River,2009,5,,207,37
Kogrukluk River,2009,8,,208,45
Kogrukluk River,2009,1,,209,46
Kogrukluk River,2010,0,,178,0
Kogrukluk River,2010,0,,179,0
Kogrukluk River,2010,0,,180,0
Kogrukluk River,2010,0,,181,0
Kogrukluk River,2010,0,,182,0
Kogrukluk River,2010,0,,183,0
Kogrukluk River,2010,0,,184,0
Kogrukluk River,2010,0,,185,0
Kogrukluk River,2010,0,,186,0
Kogrukluk River,2010,2,,187,2
Kogrukluk River,2010,4,,188,6
Kogrukluk River,2010,0,,189,6
Kogrukluk River,2010,1,,190,7
Kogrukluk River,2010,4,,191,11
Kogrukluk River,2010,10,,192,21
Kogrukluk River,2010,6,,193,27
Kogrukluk River,2010,8,,194,35
Kogrukluk River,2010,6,,195,41
Kogrukluk River,2010,6,,196,47
Kogrukluk River,2010,6,,197,53
Kogrukluk River,2010,5,,198,58
Kogrukluk River,2010,13,,199,71
Kogrukluk River,2010,7,,200,78
Kogrukluk River,2010,4,,201,82
Kogrukluk River,2010,4,,202,86
Kogrukluk River,2010,4,,203,90
Kogrukluk River,2010,2,,204,92
Kogrukluk River,2010,10,,205,102
Kogrukluk River,2010,5,,206,107
Kogrukluk River,2010,1,,207,108
Kogrukluk River,2010,11,,208,119
Kogrukluk River,2010,11,,209,130
Kogrukluk River,2010,10,,210,140
Kogrukluk River,2010,0,Huge gap (KO),238,140
Kogrukluk River,2010,1,,239,141
Kogrukluk River,2010,0,,240,141
Kogrukluk River,2010,2,,241,143
Kogrukluk River,2010,3,,242,146
Kogrukluk River,2010,1,,243,147
Kogrukluk River,2010,0,,244,147
Kogrukluk River,2010,0,,245,147
Kogrukluk River,2010,0,,246,147
Kogrukluk River,2010,0,,247,147
Kogrukluk River,2010,0,,248,147
Kogrukluk River,2010,0,,249,147
Kogrukluk River,2010,1,,250,148
Kogrukluk River,2010,0,,251,148
Kogrukluk River,2010,0,,252,148
Kogrukluk River,2010,0,,253,148
Kogrukluk River,2010,0,,254,148
Kogrukluk River,2010,0,,255,148
Kogrukluk River,2010,0,,256,148
Kogrukluk River,2010,0,,257,148
Kogrukluk River,2010,0,,258,148
Kogrukluk River,2010,0,,259,148
Kogrukluk River,2010,0,,260,148
Kogrukluk River,2010,0,,261,148
Kogrukluk River,2010,0,,262,148
Kogrukluk River,2010,0,,263,148
Kogrukluk River,2010,0,,264,148
Kogrukluk River,2010,0,,265,148
Kogrukluk River,2011,0,,172,0
Kogrukluk River,2011,0,,173,0
Kogrukluk River,2011,0,,174,0
Kogrukluk River,2011,0,,175,0
Kogrukluk River,2011,0,,176,0
Kogrukluk River,2011,0,,177,0
Kogrukluk River,2011,0,,178,0
Kogrukluk River,2011,0,,179,0
Kogrukluk River,2011,0,,180,0
Kogrukluk River,2011,0,,181,0
Kogrukluk River,2011,0,,182,0
Kogrukluk River,2011,0,,183,0
Kogrukluk River,2011,0,,184,0
Kogrukluk River,2011,0,,185,0
Kogrukluk River,2011,0,,186,0
Kogrukluk River,2011,0,,187,0
Kogrukluk River,2011,0,,188,0
Kogrukluk River,2011,0,,189,0
Kogrukluk River,2011,0,,190,0
Kogrukluk River,2011,0,,191,0
Kogrukluk River,2011,0,,192,0
Kogrukluk River,2011,0,,193,0
Kogrukluk River,2011,0,,194,0
Kogrukluk River,2011,0,,195,0
Kogrukluk River,2011,1,,196,1
Kogrukluk River,2011,0,,197,1
Kogrukluk River,2011,0,,198,1
Kogrukluk River,2011,1,,199,2
Kogrukluk River,2011,2,,200,4
Kogrukluk River,2011,3,,201,7
Kogrukluk River,2011,4,,202,11
Kogrukluk River,2011,13,,203,24
Kogrukluk River,2011,8,,204,32
Kogrukluk River,2011,15,,205,47
Kogrukluk River,2011,7,,206,54
Kogrukluk River,2011,13,,207,67
Kogrukluk River,2011,8,,208,75
Kogrukluk River,2011,2,,209,77
Kogrukluk River,2011,5,,210,82
Kogrukluk River,2011,4,,211,86
Kogrukluk River,2011,2,,212,88
Kogrukluk River,2011,3,,213,91
Kogrukluk River,2011,3,,214,94
Kogrukluk River,2011,0,,215,94
Kogrukluk River,2011,0,,218,94
Kogrukluk River,2011,0,,219,94
Kogrukluk River,2011,0,,220,94
Kogrukluk River,2011,0,,221,94
Kogrukluk River,2011,1,,222,95
Kogrukluk River,2011,1,,223,96
Kogrukluk River,2011,0,,224,96
Kogrukluk River,2011,0,,227,96
Kogrukluk River,2011,0,,228,96
Kogrukluk River,2011,0,,229,96
Kogrukluk River,2011,0,,230,96
Kogrukluk River,2011,0,,231,96
Kogrukluk River,2011,0,,234,96
Kogrukluk River,2011,0,,235,96
Kogrukluk River,2011,0,,236,96
Kogrukluk River,2011,0,,237,96
Kogrukluk River,2011,0,,238,96
Kogrukluk River,2011,0,,239,96
Kogrukluk River,2011,0,,240,96
Kogrukluk River,2011,0,,241,96
Kogrukluk River,2011,0,,242,96
Kogrukluk River,2011,0,,243,96
Kogrukluk River,2011,0,,244,96
Kogrukluk River,2011,0,,245,96
Kogrukluk River,2011,0,,246,96
Kogrukluk River,2011,0,,247,96
Kogrukluk River,2011,0,,248,96
Kogrukluk River,2011,0,,249,96
Kogrukluk River,2011,0,,250,96
Kogrukluk River,2011,0,,251,96
Kogrukluk River,2011,0,,252,96
Kogrukluk River,2011,0,,253,96
Kogrukluk River,2011,0,,254,96
Kogrukluk River,2011,0,,255,96
Kogrukluk River,2011,0,,256,96
Kogrukluk River,2011,0,,257,96
Kogrukluk River,2011,0,,258,96
Kogrukluk River,2012,2,,187,2
Kogrukluk River,2012,2,,188,4
Kogrukluk River,2012,7,,210,11
Kogrukluk River,2012,8,,211,19
Kogrukluk River,2012,9,,213,28
Kogrukluk River,2012,19,,214,47
Kogrukluk River,2012,21,,215,68
Kogrukluk River,2012,13,,216,81
Kogrukluk River,2012,9,,217,90
Kogrukluk River,2012,11,,218,101
Kogrukluk River,2012,17,,219,118
Kogrukluk River,2012,19,,220,137
Kogrukluk River,2012,14,,221,151
Kogrukluk River,2012,20,,222,171
Kogrukluk River,2012,11,,223,182
Kogrukluk River,2012,6,,224,188
Kogrukluk River,2012,4,,225,192
Kogrukluk River,2012,7,,226,199
Kogrukluk River,2012,4,,227,203
Kogrukluk River,2012,3,,228,206
Kogrukluk River,2012,5,,229,211
Kogrukluk River,2012,2,,230,213
Kogrukluk River,2012,2,,231,215
Kogrukluk River,2012,5,,232,220
Kogrukluk River,2012,2,,233,222
Kogrukluk River,2012,4,,234,226
Kogrukluk River,2012,3,,235,229
Kogrukluk River,2012,2,,237,231
Kogrukluk River,2012,1,,238,232
Kogrukluk River,2012,2,,239,234
Kogrukluk River,2012,2,,240,236
Kogrukluk River,2012,1,,241,237
Nelson River Sapsuk,2006,1,,176,1
Nelson River Sapsuk,2006,0,,177,1
Nelson River Sapsuk,2006,0,,178,1
Nelson River Sapsuk,2006,0,,179,1
Nelson River Sapsuk,2006,1,,180,2
Nelson River Sapsuk,2006,3,,181,5
Nelson River Sapsuk,2006,6,,182,11
Nelson River Sapsuk,2006,10,,183,21
Nelson River Sapsuk,2006,3,,184,24
Nelson River Sapsuk,2006,8,,185,32
Nelson River Sapsuk,2006,3,,186,35
Nelson River Sapsuk,2006,6,,187,41
Nelson River Sapsuk,2006,2,,188,43
Nelson River Sapsuk,2006,2,,189,45
Nelson River Sapsuk,2006,2,,190,47
Nelson River Sapsuk,2006,13,,191,60
Nelson River Sapsuk,2006,9,,192,69
Nelson River Sapsuk,2006,5,,193,74
Nelson River Sapsuk,2006,22,,194,96
Nelson River Sapsuk,2006,0,,195,96
Nelson River Sapsuk,2006,0,,196,96
Nelson River Sapsuk,2006,0,,197,96
Nelson River Sapsuk,2006,20,,198,116
Nelson River Sapsuk,2006,28,,199,144
Nelson River Sapsuk,2006,19,,200,163
Nelson River Sapsuk,2007,1,,174,1
Nelson River Sapsuk,2007,1,,175,2
Nelson River Sapsuk,2007,2,,176,4
Nelson River Sapsuk,2007,0,,177,4
Nelson River Sapsuk,2007,0,,178,4
Nelson River Sapsuk,2007,0,,179,4
Nelson River Sapsuk,2007,0,,180,4
Nelson River Sapsuk,2007,0,,181,4
Nelson River Sapsuk,2007,1,,182,5
Nelson River Sapsuk,2007,2,,183,7
Nelson River Sapsuk,2007,3,,184,10
Nelson River Sapsuk,2007,2,,185,12
Nelson River Sapsuk,2007,1,,186,13
Nelson River Sapsuk,2007,3,,187,16
Nelson River Sapsuk,2007,6,,188,22
Nelson River Sapsuk,2007,4,,189,26
Nelson River Sapsuk,2007,3,,190,29
Nelson River Sapsuk,2007,2,,191,31
Nelson River Sapsuk,2007,6,,192,37
Nelson River Sapsuk,2007,4,,193,41
Nelson River Sapsuk,2007,0,,194,41
Nelson River Sapsuk,2007,13,,195,54
Nelson River Sapsuk,2007,8,,196,62
Nelson River Sapsuk,2007,8,,197,70
Nelson River Sapsuk,2007,3,,198,73
Nelson River Sapsuk,2007,4,,199,77
Nelson River Sapsuk,2007,3,,200,80
Nelson River Sapsuk,2007,2,,201,82
Nelson River Sapsuk,2007,3,,202,85
Nelson River Sapsuk,2007,5,,203,90
Nelson River Sapsuk,2007,16,,204,106
Nelson River Sapsuk,2007,18,,205,124
Nelson River Sapsuk,2007,9,,206,133
Nelson River Sapsuk,2007,12,,207,145
Nelson River Sapsuk,2007,6,,208,151
Nelson River Sapsuk,2007,2,,209,153
Nelson River Sapsuk,2007,0,Wier closed,210,153
Nelson River Sapsuk,2008,1,,181,1
Nelson River Sapsuk,2008,1,,182,2
Nelson River Sapsuk,2008,1,,183,3
Nelson River Sapsuk,2008,0,,184,3
Nelson River Sapsuk,2008,1,,185,4
Nelson River Sapsuk,2008,1,,186,5
Nelson River Sapsuk,2008,1,,187,6
Nelson River Sapsuk,2008,0,,188,6
Nelson River Sapsuk,2008,21,,189,27
Nelson River Sapsuk,2008,10,,190,37
Nelson River Sapsuk,2008,13,,191,50
Nelson River Sapsuk,2008,7,,192,57
Nelson River Sapsuk,2008,4,,193,61
Nelson River Sapsuk,2008,4,,194,65
Nelson River Sapsuk,2008,2,,195,67
Nelson River Sapsuk,2008,14,,196,81
Nelson River Sapsuk,2008,11,,197,92
Nelson River Sapsuk,2008,16,,198,108
Nelson River Sapsuk,2008,3,,199,111
Nelson River Sapsuk,2008,1,,200,112
Nelson River Sapsuk,2008,16,,201,128
Nelson River Sapsuk,2008,7,,202,135
Nelson River Sapsuk,2008,39,,203,174
Nelson River Sapsuk,2008,14,,204,188
Nelson River Sapsuk,2008,11,,205,199
Nelson River Sapsuk,2008,6,,206,205
Nelson River Sapsuk,2008,7,,207,212
Nelson River Sapsuk,2008,39,,208,251
Nelson River Sapsuk,2008,1,,209,252
Nelson River Sapsuk,2008,0,,210,252
Nelson River Sapsuk,2009,1,,178,1
Nelson River Sapsuk,2009,0,,179,1
Nelson River Sapsuk,2009,0,,180,1
Nelson River Sapsuk,2009,0,,181,1
Nelson River Sapsuk,2009,1,,182,2
Nelson River Sapsuk,2009,0,,183,2
Nelson River Sapsuk,2009,0,,184,2
Nelson River Sapsuk,2009,0,,185,2
Nelson River Sapsuk,2009,0,,186,2
Nelson River Sapsuk,2009,0,,187,2
Nelson River Sapsuk,2009,1,,188,3
Nelson River Sapsuk,2009,1,,189,4
Nelson River Sapsuk,2009,0,,190,4
Nelson River Sapsuk,2009,0,,191,4
Nelson River Sapsuk,2009,0,,192,4
Nelson River Sapsuk,2009,0,,193,4
Nelson River Sapsuk,2009,1,,194,5
Nelson River Sapsuk,2009,0,,195,5
Nelson River Sapsuk,2009,1,,196,6
Nelson River Sapsuk,2009,4,,197,10
Nelson River Sapsuk,2009,3,,198,13
Nelson River Sapsuk,2009,0,,199,13
Nelson River Sapsuk,2009,2,,200,15
Nelson River Sapsuk,2009,17,,201,32
Nelson River Sapsuk,2009,4,,202,36
Nelson River Sapsuk,2009,10,,203,46
Nelson River Sapsuk,2009,12,,204,58
Nelson River Sapsuk,2009,5,,205,63
Nelson River Sapsuk,2009,4,,206,67
Nelson River Sapsuk,2009,1,,207,68
Nelson River Sapsuk,2010,4,,189,4
Nelson River Sapsuk,2010,2,,190,6
Nelson River Sapsuk,2010,0,,191,6
Nelson River Sapsuk,2010,2,,192,8
Nelson River Sapsuk,2010,9,,193,17
Nelson River Sapsuk,2010,1,,194,18
Nelson River Sapsuk,2010,3,,195,21
Nelson River Sapsuk,2010,23,,196,44
Nelson River Sapsuk,2010,5,,197,49
Nelson River Sapsuk,2010,1,,198,50
Nelson River Sapsuk,2010,4,,199,54
Nelson River Sapsuk,2010,4,,200,58
Nelson River Sapsuk,2010,3,,201,61
Nelson River Sapsuk,2010,2,,202,63
Nelson River Sapsuk,2010,0,,203,63
Nelson River Sapsuk,2010,5,,204,68
Nelson River Sapsuk,2010,24,,205,92
Nelson River Sapsuk,2010,22,,206,114
Nelson River Sapsuk,2010,4,,207,118
Nelson River Sapsuk,2010,4,,208,122
Nelson River Sapsuk,2010,5,,209,127
Nelson River Sapsuk,2010,3,,210,130
Nelson River Sapsuk,2010,3,,211,133
Nelson River Sapsuk,2011,1,,188,1
Nelson River Sapsuk,2011,0,,189,1
Nelson River Sapsuk,2011,3,,190,4
Nelson River Sapsuk,2011,2,,191,6
Nelson River Sapsuk,2011,1,,192,7
Nelson River Sapsuk,2011,2,,193,9
Nelson River Sapsuk,2011,0,,194,9
Nelson River Sapsuk,2011,0,,195,9
Nelson River Sapsuk,2011,10,,196,19
Nelson River Sapsuk,2011,11,,197,30
Nelson River Sapsuk,2011,7,,198,37
Nelson River Sapsuk,2011,3,,199,40
Nelson River Sapsuk,2011,9,,200,49
Nelson River Sapsuk,2011,7,,201,56
Nelson River Sapsuk,2011,14,,202,70
Nelson River Sapsuk,2011,19,,203,89
Nelson River Sapsuk,2011,26,,204,115
Nelson River Sapsuk,2011,4,,205,119
Nelson River Sapsuk,2011,10,,206,129
Nelson River Sapsuk,2012,1,,182,1
Nelson River Sapsuk,2012,0,,183,1
Nelson River Sapsuk,2012,0,,184,1
Nelson River Sapsuk,2012,0,,185,1
Nelson River Sapsuk,2012,0,,186,1
Nelson River Sapsuk,2012,1,,187,2
Nelson River Sapsuk,2012,1,,188,3
Nelson River Sapsuk,2012,0,,189,3
Nelson River Sapsuk,2012,0,,190,3
Nelson River Sapsuk,2012,0,,191,3
Nelson River Sapsuk,2012,1,,192,4
Nelson River Sapsuk,2012,1,,193,5
Nelson River Sapsuk,2012,0,,194,5
Nelson River Sapsuk,2012,4,,195,9
Nelson River Sapsuk,2012,1,,196,10
Nelson River Sapsuk,2012,1,,197,11
Nelson River Sapsuk,2012,1,,198,12
Nelson River Sapsuk,2012,0,,199,12
Nelson River Sapsuk,2012,1,,200,13
Nelson River Sapsuk,2012,0,,201,13
Nelson River Sapsuk,2012,1,,202,14
Nelson River Sapsuk,2012,0,,203,14
Nelson River Sapsuk,2012,5,,204,19
Nelson River Sapsuk,2012,0,,205,19
Nelson River Sapsuk,2012,0,,206,19
Nelson River Sapsuk,2012,0,wier pulled for the season,207,19
North River,1996,0,,168,0
North River,1996,2,,169,2
North River,1996,2,,170,4
North River,1996,0,,171,4
North River,1996,0,,172,4
North River,1996,3,,173,7
North River,1996,6,,174,13
North River,1996,56,,175,69
North River,1996,114,,176,183
North River,1996,94,,177,277
North River,1996,189,,178,466
North River,1996,206,,179,672
North River,1996,286,,180,958
North River,1996,381,,181,1339
North River,1996,344,,182,1683
North River,1996,754,,183,2437
North River,1996,866,,184,3303
North River,1996,3606,,185,6909
North River,1996,21429,,186,28338
North River,1996,35867,,187,64205
North River,1996,60570,,188,124775
North River,1996,34752,,189,159527
North River,1996,24962,,190,184489
North River,1996,13764,,191,198253
North River,1996,15098,,192,213351
North River,1996,14080,,193,227431
North River,1996,13545,,194,240976
North River,1996,19198,,195,260174
North River,1996,9574,,196,269748
North River,1996,10214,,197,279962
North River,1996,8044,,198,288006
North River,1996,5076,,199,293082
North River,1996,6300,,200,299382
North River,1996,7604,,201,306986
North River,1996,7117,,202,314103
North River,1996,5798,,203,319901
North River,1996,5044,,204,324945
North River,1996,4348,,205,329293
North River,1996,2612,,206,331905
North River,1996,634,,207,332539
North River,1997,0,,167,0
North River,1997,0,,168,0
North River,1997,0,,169,0
North River,1997,0,,170,0
North River,1997,0,,171,0
North River,1997,0,,172,0
North River,1997,0,,173,0
North River,1997,0,,174,0
North River,1997,0,,175,0
North River,1997,0,,176,0
North River,1997,0,,177,0
North River,1997,0,,178,0
North River,1997,4,,179,4
North River,1997,20,,180,24
North River,1997,123,,181,147
North River,1997,208,,182,355
North River,1997,131,,183,486
North River,1997,206,,184,692
North River,1997,314,,185,1006
North River,1997,314,,186,1320
North River,1997,520,,187,1840
North River,1997,1228,,188,3068
North River,1997,1580,,189,4648
North River,1997,861,,190,5509
North River,1997,605,,191,6114
North River,1997,316,,192,6430
North River,1997,426,,193,6856
North River,1997,639,,194,7495
North River,1997,471,,195,7966
North River,1997,1044,,196,9010
North River,1997,7694,,197,16704
North River,1997,6626,,198,23330
North River,1997,7088,,199,30418
North River,1997,9965,,200,40383
North River,1997,10540,,201,50923
North River,1997,13976,,202,64899
North River,1997,4750,,203,69649
North River,1997,12273,,204,81922
North River,1997,4992,,205,86914
North River,1997,3608,,206,90522
North River,1997,2982,,207,93504
North River,1997,2455,,208,95959
North River,1997,2404,,209,98363
North River,1997,4343,,210,102706
North River,1997,6162,,211,108868
North River,1997,2334,,212,111202
North River,1997,2516,,213,113718
North River,1997,2772,,214,116490
North River,1997,2842,,215,119332
North River,1997,2560,,216,121892
North River,1997,1279,,217,123171
North River,1997,1058,,218,124229
North River,1997,506,,219,124735
North River,1997,696,,220,125431
North River,1997,711,,221,126142
North River,1997,645,,222,126787
North River,1997,564,,223,127351
North River,1997,423,,224,127774
North River,1997,172,,225,127946
North River,1997,43,,226,127989
North River,1997,43,,227,128032
North River,1997,43,,228,128075
North River,1997,43,,229,128118
North River,1997,43,,230,128161
North River,1997,43,,231,128204
North River,1997,-58,,232,128146
North River,1997,-146,,233,128000
North River,1997,-32,,234,127968
North River,1997,-4,,235,127964
North River,1997,-20,,236,127944
North River,1997,-14,,237,127930
North River,1997,-4,,238,127926
North River,1998,0,,166,0
North River,1998,0,,167,0
North River,1998,0,,168,0
North River,1998,0,,169,0
North River,1998,0,,170,0
North River,1998,0,,171,0
North River,1998,0,,172,0
North River,1998,0,,173,0
North River,1998,0,,174,0
North River,1998,0,,175,0
North River,1998,0,,176,0
North River,1998,16,,177,16
North River,1998,18,,178,34
North River,1998,19,,179,53
North River,1998,90,,180,143
North River,1998,80,,181,223
North River,1998,202,,182,425
North River,1998,848,,183,1273
North River,1998,354,,184,1627
North River,1998,2896,,185,4523
North River,1998,2935,,186,7458
North River,1998,5598,,187,13056
North River,1998,12116,,188,25172
North River,1998,3866,,189,29038
North River,1998,1428,,190,30466
North River,1998,7522,,191,37988
North River,1998,4844,,192,42832
North River,1998,4901,,193,47733
North River,1998,2782,,194,50515
North River,1998,1456,,195,51971
North River,1998,3254,,196,55225
North River,1998,3684,,197,58909
North River,1998,1736,,198,60645
North River,1998,2446,,199,63091
North River,1998,1501,,200,64592
North River,1998,1014,,201,65606
North River,1998,912,,202,66518
North River,1998,652,,203,67170
North River,1998,282,,204,67452
North River,1998,404,,205,67856
North River,1998,442,,206,68298
North River,1998,555,,207,68853
North River,1998,574,,208,69427
North River,1998,384,,209,69811
North River,1998,674,,210,70485
North River,1998,520,,211,71005
North River,1998,525,,212,71530
North River,1998,611,,213,72141
North River,1998,463,,214,72604
North River,1998,188,,215,72792
North River,1998,182,,216,72974
North River,1998,182,,217,73156
North River,1998,182,,218,73338
North River,1998,182,,219,73520
North River,1998,193,,220,73713
North River,1998,134,,221,73847
North River,1998,126,,222,73973
North River,1998,72,,223,74045
North River,1998,0,,224,74045
North River,1999,0,,181,0
North River,1999,0,,182,0
North River,1999,0,,183,0
North River,1999,0,,184,0
North River,1999,0,,185,0
North River,1999,0,,186,0
North River,1999,166,,187,166
North River,1999,1006,,188,1172
North River,1999,718,,189,1890
North River,1999,1763,,190,3653
North River,1999,1759,,191,5412
North River,1999,1299,,192,6711
North River,1999,600,,193,7311
North River,1999,2026,,194,9337
North River,1999,1208,,195,10545
North River,1999,2150,,196,12695
North River,1999,2169,,197,14864
North River,1999,5947,,198,20811
North River,1999,4058,,199,24869
North River,1999,2952,,200,27821
North River,1999,2418,,201,30239
North River,1999,1615,,202,31854
North River,1999,1615,,203,33469
North River,1999,1615,,204,35084
North River,1999,1615,,205,36699
North River,1999,1615,,206,38314
North River,1999,342,,207,38656
North River,1999,716,,208,39372
North River,1999,780,,209,40152
North River,1999,576,,210,40728
North River,1999,530,,211,41258
North River,1999,836,,212,42094
North River,1999,651,,213,42745
North River,1999,677,,214,43422
North River,1999,767,,215,44189
North River,1999,578,,216,44767
North River,1999,596,,217,45363
North River,1999,404,,218,45767
North River,1999,734,,219,46501
North River,1999,511,,220,47012
North River,1999,378,,221,47390
North River,1999,204,,222,47594
North River,1999,229,,223,47823
North River,1999,197,,224,48020
North River,1999,153,,225,48173
North River,1999,157,,226,48330
North River,1999,161,,227,48491
North River,1999,109,,228,48600
North River,1999,95,,229,48695
North River,1999,91,,230,48786
North River,1999,49,,231,48835
North River,1999,51,,232,48886
North River,1999,29,,233,48915
North River,1999,26,,234,48941
North River,1999,18,,235,48959
North River,1999,14,,236,48973
North River,1999,10,,237,48983
North River,1999,10,,238,48993
North River,1999,0,,239,48993
North River,1999,0,,240,48993
North River,1999,0,,241,48993
North River,1999,0,,242,48993
North River,1999,0,,243,48993
North River,2000,0,,169,0
North River,2000,0,,170,0
North River,2000,0,,171,0
North River,2000,0,,172,0
North River,2000,0,,173,0
North River,2000,0,,174,0
North River,2000,6,,175,6
North River,2000,1158,,176,1164
North River,2000,148,,177,1312
North River,2000,3046,,178,4358
North River,2000,1000,,179,5358
North River,2000,1666,,180,7024
North River,2000,150,,181,7174
North River,2000,1606,,182,8780
North River,2000,3072,,183,11852
North River,2000,9708,,184,21560
North River,2000,9206,,185,30766
North River,2000,8042,,186,38808
North River,2000,2444,,187,41252
North River,2000,1614,,188,42866
North River,2000,1092,,189,43958
North River,2000,4386,,190,48344
North River,2000,2241,,191,50585
North River,2000,3510,,192,54095
North River,2000,1068,,193,55163
North River,2000,1504,,194,56667
North River,2000,1662,,195,58329
North River,2000,2360,,196,60689
North River,2000,698,,197,61387
North River,2000,1555,,198,62942
North River,2000,870,,199,63812
North River,2000,866,,200,64678
North River,2000,870,,201,65548
North River,2000,866,,202,66414
North River,2000,706,,203,67120
North River,2000,706,,204,67826
North River,2000,706,,205,68532
North River,2000,302,,206,68834
North River,2000,104,,207,68938
North River,2000,274,,208,69212
North River,2000,20,,209,69232
North River,2000,70,,210,69302
North River,2000,90,,211,69392
North River,2000,170,,212,69562
North River,2000,136,,213,69698
North River,2000,-4,,214,69694
North River,2000,2,,215,69696
North River,2000,0,,216,69696
North River,2000,0,,217,69696
North River,2000,2,,218,69698
North River,2000,2,,219,69700
North River,2000,0,,220,69700
North River,2000,2,,221,69702
North River,2000,1,,222,69703
North River,2000,0,,223,69703
North River,2000,0,,224,69703
North River,2000,0,,225,69703
North River,2000,0,,226,69703
North River,2001,6,,186,6
North River,2001,78,,187,84
North River,2001,341,,188,425
North River,2001,238,,189,663
North River,2001,234,,190,897
North River,2001,125,,191,1022
North River,2001,112,,192,1134
North River,2001,131,,193,1265
North River,2001,259,,194,1524
North River,2001,156,,195,1680
North River,2001,150,,196,1830
North River,2001,482,,197,2312
North River,2001,363,,198,2675
North River,2001,363,,199,3038
North River,2001,363,,200,3401
North River,2001,235,,201,3636
North River,2001,221,,202,3857
North River,2001,261,,203,4118
North River,2001,209,,204,4327
North River,2001,1981,,205,6308
North River,2001,1445,,206,7753
North River,2001,1594,,207,9347
North River,2001,566,,208,9913
North River,2001,1739,,209,11652
North River,2001,1494,,210,13146
North River,2001,1421,,211,14567
North River,2001,949,,212,15516
North River,2001,1505,,213,17021
North River,2001,825,,214,17846
North River,2001,1680,,215,19526
North River,2001,508,,216,20034
North River,2001,619,,217,20653
North River,2001,583,,218,21236
North River,2001,741,,219,21977
North River,2001,575,,220,22552
North River,2001,699,,221,23251
North River,2001,417,,222,23668
North River,2001,417,,223,24085
North River,2001,266,,224,24351
North River,2001,75,,225,24426
North River,2001,61,,226,24487
North River,2001,54,,227,24541
North River,2001,53,,228,24594
North River,2001,53,,229,24647
North River,2001,48,,230,24695
North River,2001,28,,231,24723
North River,2001,4,,232,24727
North River,2001,6,,233,24733
North River,2001,4,,234,24737
North River,2001,0,,235,24737
North River,2001,0,,236,24737
North River,2001,0,,237,24737
North River,2001,0,,238,24737
North River,2001,0,,239,24737
North River,2001,0,,240,24737
North River,2001,0,,241,24737
North River,2001,0,,242,24737
North River,2001,0,,243,24737
North River,2001,0,,244,24737
North River,2001,0,,245,24737
North River,2001,0,,246,24737
North River,2001,0,,247,24737
North River,2001,0,,248,24737
North River,2001,0,,249,24737
North River,2001,0,,250,24737
North River,2001,0,,251,24737
North River,2001,0,,252,24737
North River,2001,0,,253,24737
North River,2001,0,,254,24737
North River,2001,0,,255,24737
North River,2001,0,,256,24737
North River,2001,0,,257,24737
North River,2001,0,,258,24737
North River,2002,4074,,170,4074
North River,2002,7784,,171,11858
North River,2002,6594,,172,18452
North River,2002,6096,,173,24548
North River,2002,12070,,174,36618
North River,2002,9482,,175,46100
North River,2002,3188,,176,49288
North River,2002,7184,,177,56472
North River,2002,6514,,178,62986
North River,2002,16948,,179,79934
North River,2002,4922,,180,84856
North River,2002,8262,,181,93118
North River,2002,12898,,182,106016
North River,2002,36218,,183,142234
North River,2002,32072,,184,174306
North River,2002,17506,,185,191812
North River,2002,24506,,186,216318
North River,2002,5114,,187,221432
North River,2002,6710,,188,228142
North River,2002,7640,,189,235782
North River,2002,8032,,190,243814
North River,2002,11152,,191,254966
North River,2002,12096,,192,267062
North River,2002,8426,,193,275488
North River,2002,8624,,194,284112
North River,2002,7388,,195,291500
North River,2002,6460,,196,297960
North River,2002,7028,,197,304988
North River,2002,5136,,198,310124
North River,2002,2806,,199,312930
North River,2002,3220,,200,316150
North River,2002,1780,,201,317930
North River,2002,1060,,202,318990
North River,2002,844,,203,319834
North River,2002,376,,204,320210
North River,2002,362,,205,320572
North River,2002,596,,206,321168
North River,2002,116,,207,321284
North River,2002,104,,208,321388
North River,2002,184,,209,321572
North River,2002,84,,210,321656
North River,2002,54,,211,321710
North River,2002,20,,212,321730
North River,2002,14,,213,321744
North River,2002,12,,214,321756
North River,2002,0,,215,321756
North River,2002,0,,216,321756
North River,2002,0,,217,321756
North River,2002,0,,218,321756
North River,2002,0,,219,321756
North River,2002,0,,220,321756
North River,2002,0,,221,321756
North River,2002,0,,222,321756
North River,2002,0,,223,321756
North River,2002,0,,224,321756
North River,2002,0,,225,321756
North River,2002,0,,226,321756
North River,2002,0,,227,321756
North River,2002,0,,228,321756
North River,2002,0,,229,321756
North River,2002,0,,230,321756
North River,2002,0,,231,321756
North River,2002,0,,232,321756
North River,2002,0,,233,321756
North River,2002,0,,234,321756
North River,2002,0,,235,321756
North River,2002,0,,236,321756
North River,2002,0,,237,321756
North River,2002,0,,238,321756
North River,2002,0,,239,321756
North River,2002,0,,240,321756
North River,2003,0,,166,0
North River,2003,0,,167,0
North River,2003,0,,168,0
North River,2003,0,,169,0
North River,2003,0,,170,0
North River,2003,0,,171,0
North River,2003,12,,172,12
North River,2003,48,,173,60
North River,2003,172,,174,232
North River,2003,110,,175,342
North River,2003,50,,176,392
North River,2003,22,,177,414
North River,2003,100,,178,514
North River,2003,78,,179,592
North River,2003,111,,180,703
North River,2003,34,,181,737
North River,2003,190,,182,927
North River,2003,111,,183,1038
North River,2003,103,,184,1141
North River,2003,118,,185,1259
North River,2003,300,,186,1559
North River,2003,458,,187,2017
North River,2003,1606,,188,3623
North River,2003,6568,,189,10191
North River,2003,8468,,190,18659
North River,2003,5078,,191,23737
North River,2003,6796,,192,30533
North River,2003,5442,,193,35975
North River,2003,12038,,194,48013
North River,2003,11684,,195,59697
North River,2003,21204,,196,80901
North River,2003,6518,,197,87419
North River,2003,18500,,198,105919
North River,2003,18174,,199,124093
North River,2003,28067,,200,152160
North River,2003,17240,,201,169400
North River,2003,12704,,202,182104
North River,2003,10624,,203,192728
North River,2003,5814,,204,198542
North River,2003,8838,,205,207380
North River,2003,14577,,206,221957
North River,2003,12760,,207,234717
North River,2003,8505,,208,243222
North River,2003,3540,,209,246762
North River,2003,9604,,210,256366
North River,2003,10201,,211,266567
North River,2003,2600,,212,269167
North River,2003,3334,,213,272501
North River,2003,1551,,214,274052
North River,2003,916,,215,274968
North River,2003,558,,216,275526
North River,2003,652,,217,276178
North River,2003,578,,218,276756
North River,2003,630,,219,277386
North River,2003,496,,220,277882
North River,2003,810,,221,278692
North River,2003,616,,222,279308
North River,2003,102,,223,279410
North River,2003,120,,224,279530
North River,2003,70,,225,279600
North River,2003,108,,226,279708
North River,2003,92,,227,279800
North River,2003,68,,228,279868
North River,2003,16,,229,279884
North River,2003,86,,230,279970
North River,2003,26,,231,279996
North River,2003,56,,232,280052
North River,2003,16,,233,280068
North River,2003,11,,234,280079
North River,2003,27,,235,280106
North River,2003,15,,236,280121
North River,2003,13,,237,280134
North River,2003,13,,238,280147
North River,2003,13,,239,280160
North River,2003,13,,240,280173
North River,2003,13,,241,280186
North River,2003,0,,242,280186
North River,2003,5,,243,280191
North River,2003,6,,244,280197
North River,2003,-4,,245,280193
North River,2003,10,,246,280203
North River,2003,4,,247,280207
North River,2003,2,,248,280209
North River,2003,5,,249,280214
North River,2003,4,,250,280218
North River,2003,0,,251,280218
North River,2003,-4,,252,280214
North River,2003,-2,,253,280212
North River,2003,0,,254,280212
North River,2003,0,,255,280212
North River,2003,0,,256,280212
North River,2004,10,,167,10
North River,2004,366,,168,376
North River,2004,216,,169,592
North River,2004,84,,170,676
North River,2004,248,,171,924
North River,2004,1386,,172,2310
North River,2004,842,,173,3152
North River,2004,904,,174,4056
North River,2004,1712,,175,5768
North River,2004,2312,,176,8080
North River,2004,1596,,177,9676
North River,2004,4160,,178,13836
North River,2004,23266,,179,37102
North River,2004,69000,,180,106102
North River,2004,111152,,181,217254
North River,2004,48714,,182,265968
North River,2004,21028,,183,286996
North River,2004,29632,,184,316628
North River,2004,3366,,185,319994
North River,2004,28588,,186,348582
North River,2004,10896,,187,359478
North River,2004,73240,,188,432718
North River,2004,34716,,189,467434
North River,2004,36192,,190,503626
North River,2004,11700,,191,515326
North River,2004,45904,,192,561230
North River,2004,74302,,193,635532
North River,2004,93770,,194,729302
North River,2004,98084,,195,827386
North River,2004,104650,,196,932036
North River,2004,44670,,197,976706
North River,2004,17300,,198,994006
North River,2004,8930,,199,1002936
North River,2004,21020,,200,1023956
North River,2004,16270,,201,1040226
North River,2004,30966,,202,1071192
North River,2004,21632,,203,1092824
North River,2004,14590,,204,1107414
North River,2004,5688,,205,1113102
North River,2004,7802,,206,1120904
North River,2004,4582,,207,1125486
North River,2004,3270,,208,1128756
North River,2004,1242,,209,1129998
North River,2004,2896,,210,1132894
North River,2004,2538,,211,1135432
North River,2004,2172,,212,1137604
North River,2004,1718,,213,1139322
North River,2004,1366,,214,1140688
North River,2004,1134,,215,1141822
North River,2004,1000,,216,1142822
North River,2004,1128,,217,1143950
North River,2004,918,,218,1144868
North River,2004,1010,,219,1145878
North River,2004,1004,,220,1146882
North River,2004,794,,221,1147676
North River,2004,626,,222,1148302
North River,2004,390,,223,1148692
North River,2004,330,,224,1149022
North River,2004,178,,225,1149200
North River,2004,0,,226,1149200
North River,2004,0,,227,1149200
North River,2004,0,,228,1149200
North River,2004,0,,229,1149200
North River,2004,4,,230,1149204
North River,2004,34,,231,1149238
North River,2004,42,,232,1149280
North River,2004,0,,233,1149280
North River,2004,14,,234,1149294
North River,2004,-8,,235,1149286
North River,2004,0,,236,1149286
North River,2004,2,,237,1149288
North River,2004,-18,,238,1149270
North River,2004,14,,239,1149284
North River,2004,16,,240,1149300
North River,2004,8,,241,1149308
North River,2004,-6,,242,1149302
North River,2004,-4,,243,1149298
North River,2004,0,,244,1149298
North River,2004,0,,245,1149298
North River,2004,-4,,246,1149294
North River,2004,-6,,247,1149288
North River,2004,0,,248,1149288
North River,2004,-4,,249,1149284
North River,2004,4,,250,1149288
North River,2004,0,,251,1149288
North River,2004,0,,252,1149288
North River,2004,0,,253,1149288
North River,2004,4,,254,1149292
North River,2004,0,,255,1149292
North River,2004,0,,256,1149292
North River,2004,-2,,257,1149290
North River,2004,4,,258,1149294
North River,2005,0,,168,0
North River,2005,4,,169,4
North River,2005,4,,170,8
North River,2005,4,,171,12
North River,2005,13,,172,25
North River,2005,14,,173,39
North River,2005,8,,174,47
North River,2005,74,,175,121
North River,2005,104,,176,225
North River,2005,208,,177,433
North River,2005,1174,,178,1607
North River,2005,12972,,179,14579
North River,2005,94454,,180,109033
North River,2005,109156,,181,218189
North River,2005,81462,,182,299651
North River,2005,50352,,183,350003
North River,2005,55306,,184,405309
North River,2005,65904,,185,471213
North River,2005,5326,,186,476539
North River,2005,31014,,187,507553
North River,2005,50102,,188,557655
North River,2005,6148,,189,563803
North River,2005,6016,,190,569819
North River,2005,18682,,191,588501
North River,2005,30912,,192,619413
North River,2005,13986,,193,633399
North River,2005,37136,,194,670535
North River,2005,54020,,195,724555
North River,2005,103790,,196,828345
North River,2005,86883,,197,915228
North River,2005,75358,,198,990586
North River,2005,72000,,199,1062586
North River,2005,33674,,200,1096260
North River,2005,52532,,201,1148792
North River,2005,73394,,202,1222186
North River,2005,86552,,203,1308738
North River,2005,64933,,204,1373671
North River,2005,78112,,205,1451783
North River,2005,54198,,206,1505981
North River,2005,34008,,207,1539989
North River,2005,13448,,208,1553437
North River,2005,17624,,209,1571061
North River,2005,21422,,210,1592483
North River,2005,19379,,211,1611862
North River,2005,11460,,212,1623322
North River,2005,6550,,213,1629872
North River,2005,5848,,214,1635720
North River,2005,4708,,215,1640428
North River,2005,5396,,216,1645824
North River,2005,3118,,217,1648942
North River,2005,3111,,218,1652053
North River,2005,3184,,219,1655237
North River,2005,2602,,220,1657839
North River,2005,2608,,221,1660447
North River,2005,2692,,222,1663139
North River,2005,2084,,223,1665223
North River,2005,1302,,224,1666525
North River,2005,1054,,225,1667579
North River,2005,500,,226,1668079
North River,2005,478,,227,1668557
North River,2005,352,,228,1668909
North River,2005,362,,229,1669271
North River,2005,290,,230,1669561
North River,2005,392,,231,1669953
North River,2005,299,,232,1670252
North River,2005,188,,233,1670440
North River,2005,136,,234,1670576
North River,2005,54,,235,1670630
North River,2005,132,,236,1670762
North River,2005,54,,237,1670816
North River,2005,38,,238,1670854
North River,2005,3,,239,1670857
North River,2005,20,,240,1670877
North River,2005,18,,241,1670895
North River,2005,8,,242,1670903
North River,2005,22,,243,1670925
North River,2005,-8,,244,1670917
North River,2005,-2,,245,1670915
North River,2005,-7,,246,1670908
North River,2005,-2,,247,1670906
North River,2005,4,,248,1670910
North River,2005,10,,249,1670920
North River,2005,-2,,250,1670918
North River,2005,0,,251,1670918
North River,2005,-8,,252,1670910
North River,2005,0,,253,1670910
North River,2005,16,,254,1670926
North River,2005,8,,255,1670934
North River,2005,0,,256,1670934
North River,2006,0,,169,0
North River,2006,16,,170,16
North River,2006,6,,171,22
North River,2006,18,,172,40
North River,2006,276,,173,316
North River,2006,228,,174,544
North River,2006,172,,175,716
North River,2006,1248,,176,1964
North River,2006,8734,,177,10698
North River,2006,20018,,178,30716
North River,2006,13806,,179,44522
North River,2006,11522,,180,56044
North River,2006,13310,,181,69354
North River,2006,18314,,182,87668
North River,2006,35238,,183,122906
North River,2006,33950,,184,156856
North River,2006,140984,,185,297840
North River,2006,100264,,186,398104
North River,2006,217676,,187,615780
North River,2006,299814,,188,915594
North River,2006,233016,,189,1148610
North River,2006,160496,,190,1309106
North River,2006,134302,,191,1443408
North River,2006,140704,,192,1584112
North River,2006,188000,,193,1772112
North River,2006,91110,,194,1863222
North River,2006,24956,,195,1888178
North River,2006,34279,,196,1922457
North River,2006,34430,,197,1956887
North River,2006,6445,,198,1963332
North River,2006,2740,,199,1966072
North River,2006,18196,,200,1984268
North River,2006,25622,,201,2009890
North River,2006,13372,,202,2023262
North River,2006,14792,,203,2038054
North River,2006,18514,,204,2056568
North River,2006,14834,,205,2071402
North River,2006,16408,,206,2087810
North River,2006,22720,,207,2110530
North River,2006,20082,,208,2130612
North River,2006,11902,,209,2142514
North River,2006,10736,,210,2153250
North River,2006,964,,211,2154214
North River,2006,1096,,212,2155310
North River,2006,1228,,213,2156538
North River,2006,1756,,214,2158294
North River,2006,1448,,215,2159742
North River,2006,2212,,216,2161954
North River,2006,1784,,217,2163738
North River,2006,1164,,218,2164902
North River,2006,764,,219,2165666
North River,2006,352,,220,2166018
North River,2006,558,,221,2166576
North River,2006,396,,222,2166972
North River,2006,616,,223,2167588
North River,2006,506,,224,2168094
North River,2006,336,,225,2168430
North River,2006,356,,226,2168786
North River,2006,232,,227,2169018
North River,2006,160,,228,2169178
North River,2006,182,,229,2169360
North River,2006,102,,230,2169462
North River,2006,51,,231,2169513
North River,2006,46,,232,2169559
North River,2006,58,,233,2169617
North River,2006,12,,234,2169629
North River,2006,46,,235,2169675
North River,2006,62,,236,2169737
North River,2006,48,,237,2169785
North River,2006,3,,238,2169788
North River,2006,34,,239,2169822
North River,2006,24,,240,2169846
North River,2006,-6,,241,2169840
North River,2006,0,,242,2169840
North River,2006,22,,243,2169862
North River,2006,-4,,244,2169858
North River,2006,4,,245,2169862
North River,2006,0,,246,2169862
North River,2006,4,,247,2169866
North River,2006,6,,248,2169872
North River,2006,2,,249,2169874
North River,2006,12,,250,2169886
North River,2006,2,,251,2169888
North River,2006,10,,252,2169898
North River,2006,12,,253,2169910
North River,2006,2,,254,2169912
North River,2006,-6,,255,2169906
North River,2006,-6,,256,2169900
North River,2006,-4,,257,2169896
North River,2006,-6,,258,2169890
North River,2007,0,,167,0
North River,2007,0,,168,0
North River,2007,0,,169,0
North River,2007,-30,,170,-30
North River,2007,0,,171,-30
North River,2007,0,,172,-30
North River,2007,0,,173,-30
North River,2007,0,,174,-30
North River,2007,30,,175,0
North River,2007,66,,176,66
North River,2007,30,,177,96
North River,2007,36,,178,132
North River,2007,60,,179,192
North River,2007,36,,180,228
North River,2007,42,,181,270
North River,2007,66,,182,336
North River,2007,144,,183,480
North River,2007,270,,184,750
North River,2007,4338,,185,5088
North River,2007,9654,,186,14742
North River,2007,12426,,187,27168
North River,2007,20802,,188,47970
North River,2007,11742,,189,59712
North River,2007,15774,,190,75486
North River,2007,14592,,191,90078
North River,2007,15462,,192,105540
North River,2007,19524,,193,125064
North River,2007,16740,,194,141804
North River,2007,41382,,195,183186
North River,2007,4878,,196,188064
North River,2007,4434,,197,192498
North River,2007,3696,,198,196194
North River,2007,6966,,199,203160
North River,2007,23010,,200,226170
North River,2007,14706,,201,240876
North River,2007,27378,,202,268254
North River,2007,32280,,203,300534
North River,2007,30684,,204,331218
North River,2007,27582,,205,358800
North River,2007,43026,,206,401826
North River,2007,38046,,207,439872
North River,2007,34662,,208,474534
North River,2007,16338,,209,490872
North River,2007,17526,,210,508398
North River,2007,15126,,211,523524
North River,2007,8358,,212,531882
North River,2007,9738,,213,541620
North River,2007,8790,,214,550410
North River,2007,6600,,215,557010
North River,2007,7797,,216,564807
North River,2007,5454,,217,570261
North River,2007,1998,,218,572259
North River,2007,1432,,219,573691
North River,2007,1584,,220,575275
North River,2007,951,,221,576226
North River,2007,18,,222,576244
North River,2007,39,,223,576283
North River,2007,12,,224,576295
North River,2007,246,,225,576541
North River,2007,255,,226,576796
North River,2007,244,,227,577040
North River,2007,244,,228,577284
North River,2007,210,,229,577494
North River,2007,189,,230,577683
North River,2007,180,,231,577863
North River,2007,414,,232,578277
North River,2007,354,,233,578631
North River,2007,552,,234,579183
North River,2007,258,,235,579441
North River,2007,336,,236,579777
North River,2007,342,,237,580119
North River,2007,216,,238,580335
North River,2007,96,,239,580431
North River,2007,114,,240,580545
North River,2007,120,,241,580665
North River,2007,30,,242,580695
North River,2007,78,,243,580773
North River,2007,63,,244,580836
North River,2007,66,,245,580902
North River,2007,12,,246,580914
North River,2007,12,,247,580926
North River,2007,6,,248,580932
North River,2007,0,,249,580932
North River,2007,6,,250,580938
North River,2008,6,,172,6
North River,2008,84,,173,90
North River,2008,138,,174,228
North River,2008,156,,175,384
North River,2008,54,,176,438
North River,2008,54,,177,492
North River,2008,156,,178,648
North River,2008,342,,179,990
North River,2008,522,,180,1512
North River,2008,1674,,181,3186
North River,2008,1566,,182,4752
North River,2008,858,,183,5610
North River,2008,606,,184,6216
North River,2008,3396,,185,9612
North River,2008,6592,,186,16204
North River,2008,13110,,187,29314
North River,2008,24822,,188,54136
North River,2008,18192,,189,72328
North River,2008,28344,,190,100672
North River,2008,8246,,191,108918
North River,2008,1356,,192,110274
North River,2008,1350,,193,111624
North River,2008,6450,,194,118074
North River,2008,7734,,195,125808
North River,2008,6096,,196,131904
North River,2008,8160,,197,140064
North River,2008,5118,,198,145182
North River,2008,5982,,199,151164
North River,2008,6306,,200,157470
North River,2008,6594,,201,164064
North River,2008,8094,,202,172158
North River,2008,7200,,203,179358
North River,2008,7248,,204,186606
North River,2008,6114,,205,192720
North River,2008,6618,,206,199338
North River,2008,4518,,207,203856
North River,2008,4116,,208,207972
North River,2008,3336,,209,211308
North River,2008,2514,,210,213822
North River,2008,2664,,211,216486
North River,2008,2110,,212,218596
North River,2008,3210,,213,221806
North River,2008,1998,,214,223804
North River,2008,2262,,215,226066
North River,2008,1920,,216,227986
North River,2008,1338,,217,229324
North River,2008,1758,,218,231082
North River,2008,2124,,219,233206
North River,2008,1374,,220,234580
North River,2008,1092,,221,235672
North River,2008,666,,222,236338
North River,2008,864,,223,237202
North River,2008,918,,224,238120
North River,2008,672,,225,238792
North River,2008,432,,226,239224
North River,2008,282,,227,239506
North River,2008,288,,228,239794
North River,2008,210,,229,240004
North River,2008,72,,230,240076
North River,2008,0,,231,240076
North River,2008,30,,232,240106
North River,2008,48,,233,240154
North River,2008,24,,234,240178
North River,2008,6,,235,240184
North River,2008,60,,236,240244
North River,2008,42,,237,240286
North River,2008,0,,238,240286
North River,2008,0,,239,240286
North River,2008,0,,240,240286
North River,2008,6,,241,240292
North River,2008,-6,,242,240286
North River,2008,0,,243,240286
North River,2008,0,,244,240286
North River,2008,0,,245,240286
North River,2008,0,,246,240286
North River,2008,0,,247,240286
North River,2008,0,,248,240286
North River,2008,0,,249,240286
North River,2009,0,,170,0
North River,2009,0,,171,0
North River,2009,0,,172,0
North River,2009,0,,173,0
North River,2009,0,,174,0
North River,2009,0,,175,0
North River,2009,0,,176,0
North River,2009,0,,177,0
North River,2009,6,,178,6
North River,2009,0,,179,6
North River,2009,0,,180,6
North River,2009,96,,181,102
North River,2009,24,,182,126
North River,2009,60,,183,186
North River,2009,126,,184,312
North River,2009,60,,185,372
North River,2009,12,,186,384
North River,2009,72,,187,456
North River,2009,234,,188,690
North River,2009,378,,189,1068
North River,2009,288,,190,1356
North River,2009,216,,191,1572
North River,2009,3240,,192,4812
North River,2009,8370,,193,13182
North River,2009,13626,,194,26808
North River,2009,6336,,195,33144
North River,2009,5073,,196,38217
North River,2009,3609,,197,41826
North River,2009,13164,,198,54990
North River,2009,6786,,199,61776
North River,2009,5598,,200,67374
North River,2009,12600,,201,79974
North River,2009,9036,,202,89010
North River,2009,19272,,203,108282
North River,2009,7656,,204,115938
North River,2009,5928,,205,121866
North River,2009,6060,,206,127926
North River,2009,6012,,207,133938
North River,2009,8304,,208,142242
North River,2009,8520,,209,150762
North River,2009,4506,,210,155268
North River,2009,4770,,211,160038
North River,2009,4410,,212,164448
North River,2009,4470,,213,168918
North River,2009,3000,,214,171918
North River,2009,2928,,215,174846
North River,2009,2766,,216,177612
North River,2009,1908,,217,179520
North River,2009,1314,,218,180834
North River,2009,1386,,219,182220
North River,2009,1500,,220,183720
North River,2009,909,,221,184629
North River,2009,858,,222,185487
North River,2009,948,,223,186435
North River,2009,588,,224,187023
North River,2009,468,,225,187491
North River,2009,504,,226,187995
North River,2009,432,,227,188427
North River,2009,510,,228,188937
North River,2009,426,,229,189363
North River,2009,120,,230,189483
North River,2009,36,,231,189519
North River,2009,90,,232,189609
North River,2009,72,,233,189681
North River,2009,96,,234,189777
North River,2009,6,,235,189783
North River,2009,42,,236,189825
North River,2009,0,,237,189825
North River,2009,18,,238,189843
North River,2009,0,,239,189843
North River,2009,18,,240,189861
North River,2009,12,,241,189873
North River,2009,18,,242,189891
North River,2009,0,,243,189891
North River,2009,12,,244,189903
North River,2009,24,,245,189927
North River,2009,0,,246,189927
North River,2009,0,,247,189927
North River,2009,0,,248,189927
North River,2009,0,,249,189927
North River,2009,6,,250,189933
North River,2009,0,,251,189933
North River,2009,0,,252,189933
North River,2009,6,,253,189939
North River,2009,0,,254,189939
North River,2010,0,,170,0
North River,2010,0,,171,0
North River,2010,0,,172,0
North River,2010,42,,173,42
North River,2010,30,,174,72
North River,2010,42,,175,114
North River,2010,39,,176,153
North River,2010,60,,177,213
North River,2010,6,,178,219
North River,2010,36,,179,255
North River,2010,84,,180,339
North River,2010,300,,181,639
North River,2010,618,,182,1257
North River,2010,1062,,183,2319
North River,2010,4296,,184,6615
North River,2010,3678,,185,10293
North River,2010,11826,,186,22119
North River,2010,6276,,187,28395
North River,2010,990,,188,29385
North River,2010,5166,,189,34551
North River,2010,9036,,190,43587
North River,2010,15672,,191,59259
North River,2010,4026,,192,63285
North River,2010,4812,,193,68097
North River,2010,5502,,194,73599
North River,2010,5844,,195,79443
North River,2010,7596,,196,87039
North River,2010,6462,,197,93501
North River,2010,9324,,198,102825
North River,2010,3396,,199,106221
North River,2010,5958,,200,112179
North River,2010,3690,,201,115869
North River,2010,3444,,202,119313
North River,2010,2376,,203,121689
North River,2010,2484,,204,124173
North River,2010,3510,,205,127683
North River,2010,2550,,206,130233
North River,2010,2190,,207,132423
North River,2010,2892,,208,135315
North River,2010,2766,,209,138081
North River,2010,1674,,210,139755
North River,2010,1878,,211,141633
North River,2010,1512,,212,143145
North River,2010,1290,,213,144435
North River,2010,906,,214,145341
North River,2010,870,,215,146211
North River,2010,630,,216,146841
North River,2010,714,,217,147555
North River,2010,660,,218,148215
North River,2010,414,,219,148629
North River,2010,438,,220,149067
North River,2010,390,,221,149457
North River,2010,300,,222,149757
North River,2010,158,,223,149915
North River,2010,179,,224,150094
North River,2010,179,,225,150273
North River,2010,179,,226,150452
North River,2010,179,,227,150631
North River,2010,79,,228,150710
North River,2010,6,,229,150716
North River,2010,2,,230,150718
North River,2010,5,,231,150723
North River,2010,-18,,232,150705
North River,2010,12,,233,150717
North River,2010,-6,,234,150711
North River,2010,0,,235,150711
North River,2010,24,,236,150735
North River,2010,36,,237,150771
North River,2010,6,,238,150777
North River,2010,0,,239,150777
North River,2010,0,,240,150777
North River,2010,-6,,241,150771
North River,2010,6,,242,150777
North River,2010,0,,243,150777
North River,2010,6,,244,150783
North River,2010,-6,,245,150777
North River,2010,30,,246,150807
North River,2010,0,,247,150807
North River,2010,0,,248,150807
North River,2010,0,,249,150807
North River,2010,0,,250,150807
North River,2011,0,,168,0
North River,2011,0,,169,0
North River,2011,0,,170,0
North River,2011,0,,171,0
North River,2011,0,,172,0
North River,2011,0,,173,0
North River,2011,0,,174,0
North River,2011,0,,175,0
North River,2011,0,,176,0
North River,2011,0,,177,0
North River,2011,0,,178,0
North River,2011,0,,179,0
North River,2011,0,,180,0
North River,2011,12,,181,12
North River,2011,0,,182,12
North River,2011,0,,183,12
North River,2011,0,,184,12
North River,2011,0,,185,12
North River,2011,0,,186,12
North River,2011,54,,187,66
North River,2011,24,,188,90
North River,2011,36,,189,126
North River,2011,60,,190,186
North River,2011,66,,191,252
North River,2011,198,,192,450
North River,2011,510,,193,960
North River,2011,120,,194,1080
North River,2011,342,,195,1422
North River,2011,1014,,196,2436
North River,2011,1422,,197,3858
North River,2011,810,,198,4668
North River,2011,1062,,199,5730
North River,2011,1344,,200,7074
North River,2011,6594,,201,13668
North River,2011,11736,,202,25404
North River,2011,8286,,203,33690
North River,2011,11748,,204,45438
North River,2011,4080,,205,49518
North River,2011,7906,,206,57424
North River,2011,8370,,207,65794
North River,2011,9390,,208,75184
North River,2011,14448,,209,89632
North River,2011,15024,,210,104656
North River,2011,972,,211,105628
North River,2011,2052,,212,107680
North River,2011,2430,,213,110110
North River,2011,3216,,214,113326
North River,2011,2574,,215,115900
North River,2011,1470,,216,117370
North River,2011,1248,,217,118618
North River,2011,918,,218,119536
North River,2011,612,,219,120148
North River,2011,546,,220,120694
North River,2011,900,,221,121594
North River,2011,996,,222,122590
North River,2011,552,,223,123142
North River,2011,48,,224,123190
North River,2011,12,,234,123202
North River,2011,132,,235,123334
North River,2011,72,,236,123406
North River,2011,42,,237,123448
North River,2011,162,,238,123610
North River,2011,138,,239,123748
North River,2011,24,,240,123772
North River,2011,12,,241,123784
North River,2011,66,,242,123850
North River,2011,30,,243,123880
North River,2011,0,,244,123880
North River,2011,0,,245,123880
North River,2011,12,,246,123892
North River,2011,0,,247,123892
North River,2011,0,,248,123892
North River,2011,0,,249,123892
North River,2011,0,,250,123892
North River,2012,24,,179,24
North River,2012,18,,180,42
North River,2012,42,,181,84
North River,2012,54,,182,138
North River,2012,6,,183,144
North River,2012,102,,184,246
North River,2012,186,,185,432
North River,2012,144,,186,576
North River,2012,132,,187,708
North River,2012,452,,188,1160
North River,2012,4980,,189,6140
North River,2012,5642,,190,11782
North River,2012,3570,,191,15352
North River,2012,3420,,192,18772
North River,2012,3372,,193,22144
North River,2012,6708,,194,28852
North River,2012,6090,,195,34942
North River,2012,5076,,196,40018
North River,2012,8490,,197,48508
North River,2012,7886,,198,56394
Nushagak River,2012,704,Only 1 year (KO),201,704
Nushagak River,2012,3035,,202,3739
Nushagak River,2012,5839,,203,9578
Nushagak River,2012,2533,,204,12111
Nushagak River,2012,355,,205,12466
Nushagak River,2012,6851,,206,19317
Nushagak River,2012,10924,,207,30241
Nushagak River,2012,11590,,208,41831
Nushagak River,2012,26207,,209,68038
Nushagak River,2012,58812,,210,126850
Nushagak River,2012,57062,,211,183912
Nushagak River,2012,72600,,212,256512
Nushagak River,2012,89805,,213,346317
Nushagak River,2012,73920,,214,420237
Nushagak River,2012,42859,,215,463096
Nushagak River,2012,33098,,216,496194
Nushagak River,2012,37276,,217,533470
Nushagak River,2012,22399,,218,555869
Nushagak River,2012,28566,,219,584435
Nushagak River,2012,142750,,220,727185
Nushagak River,2012,126939,,221,854124
Nushagak River,2012,96946,,222,951070
Nushagak River,2012,86207,,223,1037277
Nushagak River,2012,65822,,224,1103099
Nushagak River,2012,34231,,225,1137330
Nushagak River,2012,23656,,226,1160986
Nushagak River,2012,23440,,227,1184426
Nushagak River,2012,16319,,228,1200745
Nushagak River,2012,3802,,229,1204547
Nushagak River,2012,8364,,230,1212911
Nushagak River,2012,2396,,231,1215307
Nushagak River,2012,363,,232,1215670
Olga Creek Upper Station,2006,2,,197,2
Olga Creek Upper Station,2006,0,,198,2
Olga Creek Upper Station,2006,0,,199,2
Olga Creek Upper Station,2006,4,,200,6
Olga Creek Upper Station,2006,0,,201,6
Olga Creek Upper Station,2006,0,,202,6
Olga Creek Upper Station,2006,3,,203,9
Olga Creek Upper Station,2006,2,,204,11
Olga Creek Upper Station,2006,3,,205,14
Olga Creek Upper Station,2006,8,,206,22
Olga Creek Upper Station,2006,33,,207,55
Olga Creek Upper Station,2006,22,,208,77
Olga Creek Upper Station,2006,13,,209,90
Olga Creek Upper Station,2006,1,,210,91
Olga Creek Upper Station,2006,5,,211,96
Olga Creek Upper Station,2006,78,,212,174
Olga Creek Upper Station,2006,13,,213,187
Olga Creek Upper Station,2006,16,,214,203
Olga Creek Upper Station,2006,92,,215,295
Olga Creek Upper Station,2006,91,,216,386
Olga Creek Upper Station,2006,33,,217,419
Olga Creek Upper Station,2006,5,,218,424
Olga Creek Upper Station,2006,29,,219,453
Olga Creek Upper Station,2006,148,,220,601
Olga Creek Upper Station,2006,0,no contact,221,601
Olga Creek Upper Station,2006,167,,222,768
Olga Creek Upper Station,2006,317,,223,1085
Olga Creek Upper Station,2006,235,,224,1320
Olga Creek Upper Station,2006,350,,225,1670
Olga Creek Upper Station,2006,388,,226,2058
Olga Creek Upper Station,2006,319,,227,2377
Olga Creek Upper Station,2006,254,,228,2631
Olga Creek Upper Station,2006,275,,229,2906
Olga Creek Upper Station,2006,471,,230,3377
Olga Creek Upper Station,2006,330,,231,3707
Olga Creek Upper Station,2006,408,,232,4115
Olga Creek Upper Station,2006,422,,233,4537
Olga Creek Upper Station,2006,202,,234,4739
Olga Creek Upper Station,2006,42,,235,4781
Olga Creek Upper Station,2006,44,,236,4825
Olga Creek Upper Station,2006,45,,237,4870
Olga Creek Upper Station,2006,181,,238,5051
Olga Creek Upper Station,2006,292,,239,5343
Olga Creek Upper Station,2006,926,,240,6269
Olga Creek Upper Station,2006,711,,241,6980
Olga Creek Upper Station,2006,278,,242,7258
Olga Creek Upper Station,2006,68,,243,7326
Olga Creek Upper Station,2006,242,,244,7568
Olga Creek Upper Station,2006,69,,245,7637
Olga Creek Upper Station,2006,43,,246,7680
Olga Creek Upper Station,2006,87,,247,7767
Olga Creek Upper Station,2006,270,,248,8037
Olga Creek Upper Station,2006,410,,249,8447
Olga Creek Upper Station,2006,175,,250,8622
Olga Creek Upper Station,2006,125,,251,8747
Olga Creek Upper Station,2006,152,,252,8899
Olga Creek Upper Station,2006,192,,253,9091
Olga Creek Upper Station,2006,7,,254,9098
Olga Creek Upper Station,2006,46,,255,9144
Olga Creek Upper Station,2006,1,wier closed,256,9145
Olga Creek Upper Station,2007,1,,200,1
Olga Creek Upper Station,2007,5,,201,6
Olga Creek Upper Station,2007,1,,202,7
Olga Creek Upper Station,2007,1,,203,8
Olga Creek Upper Station,2007,18,,204,26
Olga Creek Upper Station,2007,0,,205,26
Olga Creek Upper Station,2007,0,,206,26
Olga Creek Upper Station,2007,0,,207,26
Olga Creek Upper Station,2007,0,,208,26
Olga Creek Upper Station,2007,0,,209,26
Olga Creek Upper Station,2007,20,,210,46
Olga Creek Upper Station,2007,16,,211,62
Olga Creek Upper Station,2007,2,,212,64
Olga Creek Upper Station,2007,2,,213,66
Olga Creek Upper Station,2007,1,,214,67
Olga Creek Upper Station,2007,0,,215,67
Olga Creek Upper Station,2007,1,,216,68
Olga Creek Upper Station,2007,1,,217,69
Olga Creek Upper Station,2007,9,,218,78
Olga Creek Upper Station,2007,21,,219,99
Olga Creek Upper Station,2007,5,,220,104
Olga Creek Upper Station,2007,6,,221,110
Olga Creek Upper Station,2007,6,,222,116
Olga Creek Upper Station,2007,9,,223,125
Olga Creek Upper Station,2007,21,,224,146
Olga Creek Upper Station,2007,24,,225,170
Olga Creek Upper Station,2007,262,,226,432
Olga Creek Upper Station,2007,113,,227,545
Olga Creek Upper Station,2007,39,,228,584
Olga Creek Upper Station,2007,295,,229,879
Olga Creek Upper Station,2007,136,,230,1015
Olga Creek Upper Station,2007,51,,231,1066
Olga Creek Upper Station,2007,34,,232,1100
Olga Creek Upper Station,2007,68,,233,1168
Olga Creek Upper Station,2007,119,,234,1287
Olga Creek Upper Station,2007,113,,235,1400
Olga Creek Upper Station,2007,48,,236,1448
Olga Creek Upper Station,2007,393,,237,1841
Olga Creek Upper Station,2007,269,,238,2110
Olga Creek Upper Station,2007,327,,239,2437
Olga Creek Upper Station,2007,377,,240,2814
Olga Creek Upper Station,2007,66,,241,2880
Olga Creek Upper Station,2007,369,,242,3249
Olga Creek Upper Station,2007,418,,244,3667
Olga Creek Upper Station,2007,154,,245,3821
Olga Creek Upper Station,2007,546,,246,4367
Olga Creek Upper Station,2007,964,,247,5331
Olga Creek Upper Station,2007,217,,248,5548
Olga Creek Upper Station,2007,134,,249,5682
Olga Creek Upper Station,2007,349,,250,6031
Olga Creek Upper Station,2007,273,,251,6304
Olga Creek Upper Station,2007,123,,252,6427
Olga Creek Upper Station,2007,163,,253,6590
Olga Creek Upper Station,2007,45,,254,6635
Olga Creek Upper Station,2007,316,,255,6951
Olga Creek Upper Station,2007,205,,256,7156
Olga Creek Upper Station,2008,6,,199,6
Olga Creek Upper Station,2008,1,,200,7
Olga Creek Upper Station,2008,2,,201,9
Olga Creek Upper Station,2008,4,,202,13
Olga Creek Upper Station,2008,2,,203,15
Olga Creek Upper Station,2008,3,,204,18
Olga Creek Upper Station,2008,9,,205,27
Olga Creek Upper Station,2008,12,,206,39
Olga Creek Upper Station,2008,27,,207,66
Olga Creek Upper Station,2008,60,,208,126
Olga Creek Upper Station,2008,23,,209,149
Olga Creek Upper Station,2008,162,,210,311
Olga Creek Upper Station,2008,100,,211,411
Olga Creek Upper Station,2008,54,,212,465
Olga Creek Upper Station,2008,54,,213,519
Olga Creek Upper Station,2008,62,,214,581
Olga Creek Upper Station,2008,103,,215,684
Olga Creek Upper Station,2008,39,,216,723
Olga Creek Upper Station,2008,159,,217,882
Olga Creek Upper Station,2008,211,,218,1093
Olga Creek Upper Station,2008,293,,219,1386
Olga Creek Upper Station,2008,433,,220,1819
Olga Creek Upper Station,2008,232,,221,2051
Olga Creek Upper Station,2008,176,,222,2227
Olga Creek Upper Station,2008,67,,224,2294
Olga Creek Upper Station,2008,117,,225,2411
Olga Creek Upper Station,2008,100,,226,2511
Olga Creek Upper Station,2008,265,,227,2776
Olga Creek Upper Station,2008,235,,228,3011
Olga Creek Upper Station,2008,309,,229,3320
Olga Creek Upper Station,2008,257,,230,3577
Olga Creek Upper Station,2008,293,,231,3870
Olga Creek Upper Station,2008,510,,232,4380
Olga Creek Upper Station,2008,183,,233,4563
Olga Creek Upper Station,2008,170,,234,4733
Olga Creek Upper Station,2008,106,,235,4839
Olga Creek Upper Station,2008,88,,236,4927
Olga Creek Upper Station,2008,84,,237,5011
Olga Creek Upper Station,2008,47,,238,5058
Olga Creek Upper Station,2008,37,,239,5095
Olga Creek Upper Station,2008,17,,240,5112
Olga Creek Upper Station,2008,41,,241,5153
Olga Creek Upper Station,2008,35,,242,5188
Olga Creek Upper Station,2008,22,,243,5210
Olga Creek Upper Station,2008,24,,244,5234
Olga Creek Upper Station,2008,69,,245,5303
Olga Creek Upper Station,2008,18,,246,5321
Olga Creek Upper Station,2008,9,,247,5330
Olga Creek Upper Station,2008,5,,248,5335
Olga Creek Upper Station,2008,9,,249,5344
Olga Creek Upper Station,2008,3,,250,5347
Olga Creek Upper Station,2008,1,,251,5348
Olga Creek Upper Station,2008,1,,252,5349
Olga Creek Upper Station,2008,6,,253,5355
Olga Creek Upper Station,2008,3,,254,5358
Olga Creek Upper Station,2008,2,,255,5360
Olga Creek Upper Station,2008,0,,256,5360
Olga Creek Upper Station,2008,1,,257,5361
Olga Creek Upper Station,2008,0,,258,5361
Olga Creek Upper Station,2008,0,,259,5361
Olga Creek Upper Station,2008,0,,260,5361
Olga Creek Upper Station,2008,0,wier closed,261,5361
Olga Creek Upper Station,2009,5,,198,5
Olga Creek Upper Station,2009,0,,199,5
Olga Creek Upper Station,2009,0,,200,5
Olga Creek Upper Station,2009,0,,201,5
Olga Creek Upper Station,2009,11,,202,16
Olga Creek Upper Station,2009,0,,203,16
Olga Creek Upper Station,2009,6,,204,22
Olga Creek Upper Station,2009,0,,205,22
Olga Creek Upper Station,2009,0,,206,22
Olga Creek Upper Station,2009,0,,207,22
Olga Creek Upper Station,2009,0,,208,22
Olga Creek Upper Station,2009,0,,209,22
Olga Creek Upper Station,2009,0,,210,22
Olga Creek Upper Station,2009,4,,211,26
Olga Creek Upper Station,2009,0,,212,26
Olga Creek Upper Station,2009,3,,213,29
Olga Creek Upper Station,2009,0,,214,29
Olga Creek Upper Station,2009,0,,215,29
Olga Creek Upper Station,2009,1,,216,30
Olga Creek Upper Station,2009,0,,217,30
Olga Creek Upper Station,2009,0,,218,30
Olga Creek Upper Station,2009,0,,219,30
Olga Creek Upper Station,2009,0,,220,30
Olga Creek Upper Station,2009,4,,221,34
Olga Creek Upper Station,2009,9,,222,43
Olga Creek Upper Station,2009,10,,223,53
Olga Creek Upper Station,2009,121,,224,174
Olga Creek Upper Station,2009,181,,225,355
Olga Creek Upper Station,2009,879,,226,1234
Olga Creek Upper Station,2009,694,,227,1928
Olga Creek Upper Station,2009,780,,228,2708
Olga Creek Upper Station,2009,1333,,229,4041
Olga Creek Upper Station,2009,445,,230,4486
Olga Creek Upper Station,2009,986,,231,5472
Olga Creek Upper Station,2009,191,,232,5663
Olga Creek Upper Station,2009,397,,233,6060
Olga Creek Upper Station,2009,338,,234,6398
Olga Creek Upper Station,2009,1136,,235,7534
Olga Creek Upper Station,2009,1099,,236,8633
Olga Creek Upper Station,2009,2794,,237,11427
Olga Creek Upper Station,2009,448,,238,11875
Olga Creek Upper Station,2009,337,,239,12212
Olga Creek Upper Station,2009,68,,240,12280
Olga Creek Upper Station,2009,90,,241,12370
Olga Creek Upper Station,2009,130,,242,12500
Olga Creek Upper Station,2009,73,,243,12573
Olga Creek Upper Station,2009,192,,244,12765
Olga Creek Upper Station,2009,222,,245,12987
Olga Creek Upper Station,2009,82,,246,13069
Olga Creek Upper Station,2009,53,,247,13122
Olga Creek Upper Station,2009,69,,248,13191
Olga Creek Upper Station,2009,40,,249,13231
Olga Creek Upper Station,2009,47,,250,13278
Olga Creek Upper Station,2009,10,,251,13288
Olga Creek Upper Station,2009,12,,252,13300
Olga Creek Upper Station,2009,11,,253,13311
Olga Creek Upper Station,2009,10,,254,13321
Olga Creek Upper Station,2009,18,,255,13339
Olga Creek Upper Station,2009,2,,256,13341
Olga Creek Upper Station,2009,7,,257,13348
Olga Creek Upper Station,2009,0,wier closed,258,13348
Olga Creek Upper Station,2010,1,,198,1
Olga Creek Upper Station,2010,4,,199,5
Olga Creek Upper Station,2010,0,,200,5
Olga Creek Upper Station,2010,0,,201,5
Olga Creek Upper Station,2010,0,,202,5
Olga Creek Upper Station,2010,0,,203,5
Olga Creek Upper Station,2010,2,,204,7
Olga Creek Upper Station,2010,3,,205,10
Olga Creek Upper Station,2010,5,,206,15
Olga Creek Upper Station,2010,2,,207,17
Olga Creek Upper Station,2010,8,,208,25
Olga Creek Upper Station,2010,47,,209,72
Olga Creek Upper Station,2010,93,,210,165
Olga Creek Upper Station,2010,59,,211,224
Olga Creek Upper Station,2010,8,,212,232
Olga Creek Upper Station,2010,19,,213,251
Olga Creek Upper Station,2010,54,,214,305
Olga Creek Upper Station,2010,130,,215,435
Olga Creek Upper Station,2010,314,,216,749
Olga Creek Upper Station,2010,966,,217,1715
Olga Creek Upper Station,2010,976,,218,2691
Olga Creek Upper Station,2010,452,,219,3143
Olga Creek Upper Station,2010,220,,220,3363
Olga Creek Upper Station,2010,367,,221,3730
Olga Creek Upper Station,2010,440,,222,4170
Olga Creek Upper Station,2010,1140,,223,5310
Olga Creek Upper Station,2010,1018,,224,6328
Olga Creek Upper Station,2010,791,,225,7119
Olga Creek Upper Station,2010,310,,226,7429
Olga Creek Upper Station,2010,1777,,227,9206
Olga Creek Upper Station,2010,365,,228,9571
Olga Creek Upper Station,2010,1455,,229,11026
Olga Creek Upper Station,2010,1261,,230,12287
Olga Creek Upper Station,2010,658,,231,12945
Olga Creek Upper Station,2010,746,,232,13691
Olga Creek Upper Station,2010,451,,233,14142
Olga Creek Upper Station,2010,780,,234,14922
Olga Creek Upper Station,2010,285,,235,15207
Olga Creek Upper Station,2010,167,,236,15374
Olga Creek Upper Station,2010,650,,237,16024
Olga Creek Upper Station,2010,594,,238,16618
Olga Creek Upper Station,2010,313,,239,16931
Olga Creek Upper Station,2010,353,,240,17284
Olga Creek Upper Station,2010,174,,241,17458
Olga Creek Upper Station,2010,246,,242,17704
Olga Creek Upper Station,2010,132,,243,17836
Olga Creek Upper Station,2010,106,,244,17942
Olga Creek Upper Station,2010,149,,245,18091
Olga Creek Upper Station,2010,112,,246,18203
Olga Creek Upper Station,2010,36,,247,18239
Olga Creek Upper Station,2010,263,,248,18502
Olga Creek Upper Station,2010,176,,249,18678
Olga Creek Upper Station,2010,72,,250,18750
Olga Creek Upper Station,2010,64,,251,18814
Olga Creek Upper Station,2010,44,,252,18858
Olga Creek Upper Station,2010,14,,253,18872
Olga Creek Upper Station,2010,117,,254,18989
Olga Creek Upper Station,2010,147,,255,19136
Olga Creek Upper Station,2010,114,,256,19250
Olga Creek Upper Station,2010,23,,257,19273
Olga Creek Upper Station,2010,0,,258,19273
Olga Creek Upper Station,2010,40,,259,19313
Olga Creek Upper Station,2010,10,,260,19323
Olga Creek Upper Station,2010,0,"wier closed, post wier estimate",261,19323
Olga Creek Upper Station,2011,4,,193,4
Olga Creek Upper Station,2011,0,,194,4
Olga Creek Upper Station,2011,0,,195,4
Olga Creek Upper Station,2011,0,,196,4
Olga Creek Upper Station,2011,2,,197,6
Olga Creek Upper Station,2011,0,,198,6
Olga Creek Upper Station,2011,0,,199,6
Olga Creek Upper Station,2011,0,,200,6
Olga Creek Upper Station,2011,0,,201,6
Olga Creek Upper Station,2011,33,,202,39
Olga Creek Upper Station,2011,20,,203,59
Olga Creek Upper Station,2011,6,,204,65
Olga Creek Upper Station,2011,4,,205,69
Olga Creek Upper Station,2011,1,,206,70
Olga Creek Upper Station,2011,16,,209,86
Olga Creek Upper Station,2011,26,,210,112
Olga Creek Upper Station,2011,1,,211,113
Olga Creek Upper Station,2011,5,,212,118
Olga Creek Upper Station,2011,45,,213,163
Olga Creek Upper Station,2011,57,,214,220
Olga Creek Upper Station,2011,53,,215,273
Olga Creek Upper Station,2011,0,,216,273
Olga Creek Upper Station,2011,4,,217,277
Olga Creek Upper Station,2011,1,,218,278
Olga Creek Upper Station,2011,52,,219,330
Olga Creek Upper Station,2011,26,,220,356
Olga Creek Upper Station,2011,7,,221,363
Olga Creek Upper Station,2011,68,,222,431
Olga Creek Upper Station,2011,230,,223,661
Olga Creek Upper Station,2011,533,,224,1194
Olga Creek Upper Station,2011,548,,225,1742
Olga Creek Upper Station,2011,850,,226,2592
Olga Creek Upper Station,2011,905,,227,3497
Olga Creek Upper Station,2011,720,,228,4217
Olga Creek Upper Station,2011,978,,229,5195
Olga Creek Upper Station,2011,1659,,230,6854
Olga Creek Upper Station,2011,1448,,231,8302
Olga Creek Upper Station,2011,850,,232,9152
Olga Creek Upper Station,2011,1123,,233,10275
Olga Creek Upper Station,2011,1048,,234,11323
Olga Creek Upper Station,2011,989,,235,12312
Olga Creek Upper Station,2011,1018,,236,13330
Olga Creek Upper Station,2011,618,,237,13948
Olga Creek Upper Station,2011,1077,,238,15025
Olga Creek Upper Station,2011,811,,239,15836
Olga Creek Upper Station,2011,518,,240,16354
Olga Creek Upper Station,2011,923,,241,17277
Olga Creek Upper Station,2011,539,,242,17816
Olga Creek Upper Station,2011,1034,,243,18850
Olga Creek Upper Station,2011,87,,244,18937
Olga Creek Upper Station,2011,252,,245,19189
Olga Creek Upper Station,2011,164,,246,19353
Olga Creek Upper Station,2011,137,,247,19490
Olga Creek Upper Station,2011,9,,248,19499
Olga Creek Upper Station,2011,358,,249,19857
Olga Creek Upper Station,2011,251,,250,20108
Olga Creek Upper Station,2011,247,,251,20355
Olga Creek Upper Station,2011,124,,252,20479
Olga Creek Upper Station,2011,84,,253,20563
Olga Creek Upper Station,2011,177,,254,20740
Olga Creek Upper Station,2011,204,,255,20944
Olga Creek Upper Station,2011,44,,256,20988
Olga Creek Upper Station,2011,162,,257,21150
Olga Creek Upper Station,2011,133,,258,21283
Olga Creek Upper Station,2011,300,"wier pulled for season, post wier estimate",259,21583
Olga Creek Upper Station,2012,1,,199,1
Olga Creek Upper Station,2012,0,,200,1
Olga Creek Upper Station,2012,0,,201,1
Olga Creek Upper Station,2012,1,,202,2
Olga Creek Upper Station,2012,2,,203,4
Olga Creek Upper Station,2012,0,,204,4
Olga Creek Upper Station,2012,0,,205,4
Olga Creek Upper Station,2012,17,,206,21
Olga Creek Upper Station,2012,0,,207,21
Olga Creek Upper Station,2012,1,,208,22
Olga Creek Upper Station,2012,0,,209,22
Olga Creek Upper Station,2012,6,,210,28
Olga Creek Upper Station,2012,0,,211,28
Olga Creek Upper Station,2012,34,,212,62
Olga Creek Upper Station,2012,78,,213,140
Olga Creek Upper Station,2012,37,,214,177
Olga Creek Upper Station,2012,15,,215,192
Olga Creek Upper Station,2012,1,,216,193
Olga Creek Upper Station,2012,3,,217,196
Olga Creek Upper Station,2012,1,,218,197
Olga Creek Upper Station,2012,0,,219,197
Olga Creek Upper Station,2012,1,,220,198
Olga Creek Upper Station,2012,117,,221,315
Olga Creek Upper Station,2012,62,,222,377
Olga Creek Upper Station,2012,58,,223,435
Olga Creek Upper Station,2012,80,,224,515
Olga Creek Upper Station,2012,0,,225,515
Olga Creek Upper Station,2012,15,,226,530
Olga Creek Upper Station,2012,30,,229,560
Olga Creek Upper Station,2012,9,,230,569
Olga Creek Upper Station,2012,143,,231,712
Olga Creek Upper Station,2012,480,,232,1192
Olga Creek Upper Station,2012,176,,234,1368
Olga Creek Upper Station,2012,279,,235,1647
Olga Creek Upper Station,2012,76,,236,1723
Olga Creek Upper Station,2012,364,,237,2087
Olga Creek Upper Station,2012,225,,238,2312
Olga Creek Upper Station,2012,66,,240,2378
Olga Creek Upper Station,2012,135,,241,2513
Olga Creek Upper Station,2012,183,,242,2696
Olga Creek Upper Station,2012,901,,243,3597
Olga Creek Upper Station,2012,52,,244,3649
Olga Creek Upper Station,2012,43,,245,3692
Olga Creek Upper Station,2012,174,,246,3866
Olga Creek Upper Station,2012,230,,247,4096
Olga Creek Upper Station,2012,13,,248,4109
Olga Creek Upper Station,2012,43,,249,4152
Olga Creek Upper Station,2012,61,,250,4213
Olga Creek Upper Station,2012,7,,251,4220
Olga Creek Upper Station,2012,4,,252,4224
Olga Creek Upper Station,2012,15,,253,4239
Olga Creek Upper Station,2012,5,,255,4244
Olga Creek Upper Station,2012,17,,256,4261
Olga Creek Upper Station,2012,13,,257,4274
Olga Creek Upper Station,2012,0,wier pulled for season,258,4274
Orzinski Lake,2007,6,,213,6
Orzinski Lake,2007,2,,214,8
Orzinski Lake,2007,0,,215,8
Orzinski Lake,2007,14,,216,22
Orzinski Lake,2007,3,,219,25
Orzinski Lake,2007,234,,220,259
Orzinski Lake,2007,82,,221,341
Orzinski Lake,2007,789,,222,1130
Orzinski Lake,2007,331,,223,1461
Orzinski Lake,2007,260,,224,1721
Orzinski Lake,2007,1382,,225,3103
Orzinski Lake,2007,1171,,226,4274
Orzinski Lake,2007,0,wier closed,227,4274
Orzinski Lake,2008,7,,189,7
Orzinski Lake,2008,4,,190,11
Orzinski Lake,2008,0,,191,11
Orzinski Lake,2008,1,,192,12
Orzinski Lake,2008,0,,193,12
Orzinski Lake,2008,4,,194,16
Orzinski Lake,2008,0,,195,16
Orzinski Lake,2008,0,,196,16
Orzinski Lake,2008,25,,197,41
Orzinski Lake,2008,11,,198,52
Orzinski Lake,2008,7,,199,59
Orzinski Lake,2008,4,,200,63
Orzinski Lake,2008,4,,201,67
Orzinski Lake,2008,29,,202,96
Orzinski Lake,2008,39,,203,135
Orzinski Lake,2008,39,,204,174
Orzinski Lake,2008,6,,205,180
Orzinski Lake,2008,31,,206,211
Orzinski Lake,2008,94,,207,305
Orzinski Lake,2008,22,,208,327
Orzinski Lake,2008,15,,209,342
Orzinski Lake,2008,34,,210,376
Orzinski Lake,2008,175,,211,551
Orzinski Lake,2008,34,,212,585
Orzinski Lake,2008,36,,213,621
Orzinski Lake,2008,76,,214,697
Orzinski Lake,2008,4,,215,701
Orzinski Lake,2008,54,,216,755
Orzinski Lake,2008,139,,217,894
Orzinski Lake,2008,17,,218,911
Orzinski Lake,2008,29,,219,940
Orzinski Lake,2008,113,,220,1053
Orzinski Lake,2008,22,,221,1075
Orzinski Lake,2008,12,,222,1087
Orzinski Lake,2008,17,,223,1104
Orzinski Lake,2008,333,,224,1437
Orzinski Lake,2008,2901,wier closed,225,4338
Orzinski Lake,2009,42,,187,42
Orzinski Lake,2009,43,,188,85
Orzinski Lake,2009,0,,189,85
Orzinski Lake,2009,117,,190,202
Orzinski Lake,2009,58,,191,260
Orzinski Lake,2009,13,,192,273
Orzinski Lake,2009,284,,193,557
Orzinski Lake,2009,96,,194,653
Orzinski Lake,2009,0,,195,653
Orzinski Lake,2009,14,,196,667
Orzinski Lake,2009,6,,197,673
Orzinski Lake,2009,22,,198,695
Orzinski Lake,2009,3,,199,698
Orzinski Lake,2009,7,,200,705
Orzinski Lake,2009,0,,201,705
Orzinski Lake,2009,23,,202,728
Orzinski Lake,2009,60,,203,788
Orzinski Lake,2009,3,,204,791
Orzinski Lake,2009,5,,205,796
Orzinski Lake,2009,15,,206,811
Orzinski Lake,2009,10,,207,821
Orzinski Lake,2009,13,,208,834
Orzinski Lake,2009,6,,209,840
Orzinski Lake,2009,24,,210,864
Orzinski Lake,2009,39,,211,903
Orzinski Lake,2009,11,,212,914
Orzinski Lake,2009,30,,213,944
Orzinski Lake,2009,789,,214,1733
Orzinski Lake,2009,141,wier closed,215,1874
Orzinski Lake,2010,1,,208,1
Orzinski Lake,2010,0,,209,1
Orzinski Lake,2010,0,,210,1
Orzinski Lake,2010,2,,211,3
Orzinski Lake,2010,1,,212,4
Orzinski Lake,2010,1,,213,5
Orzinski Lake,2010,0,,214,5
Orzinski Lake,2010,159,,215,164
Orzinski Lake,2010,11,,216,175
Orzinski Lake,2010,10,,217,185
Orzinski Lake,2010,0,wier closed,218,185
Orzinski Lake,2011,1,,179,1
Orzinski Lake,2011,0,,180,1
Orzinski Lake,2011,0,,181,1
Orzinski Lake,2011,0,,182,1
Orzinski Lake,2011,0,,184,1
Orzinski Lake,2011,0,,185,1
Orzinski Lake,2011,0,,186,1
Orzinski Lake,2011,0,,187,1
Orzinski Lake,2011,2,,188,3
Orzinski Lake,2011,0,,189,3
Orzinski Lake,2011,1,,190,4
Orzinski Lake,2011,5,,191,9
Orzinski Lake,2011,3,,192,12
Orzinski Lake,2011,0,,193,12
Orzinski Lake,2011,10,,194,22
Orzinski Lake,2011,0,,195,22
Orzinski Lake,2011,10,,196,32
Orzinski Lake,2011,3,,197,35
Orzinski Lake,2011,9,,198,44
Orzinski Lake,2011,4,,199,48
Orzinski Lake,2011,1,,200,49
Orzinski Lake,2011,17,,201,66
Orzinski Lake,2011,3,,202,69
Orzinski Lake,2011,0,,203,69
Orzinski Lake,2011,5,,204,74
Orzinski Lake,2011,7,,205,81
Orzinski Lake,2011,1,,206,82
Orzinski Lake,2011,6,,207,88
Orzinski Lake,2011,44,,208,132
Orzinski Lake,2011,18,,209,150
Orzinski Lake,2011,9,,210,159
Orzinski Lake,2011,11,,212,170
Orzinski Lake,2011,14,,213,184
Orzinski Lake,2012,1,,193,1
Orzinski Lake,2012,0,,194,1
Orzinski Lake,2012,1,,195,2
Orzinski Lake,2012,0,,196,2
Orzinski Lake,2012,3,,197,5
Orzinski Lake,2012,5,,198,10
Orzinski Lake,2012,3,,199,13
Orzinski Lake,2012,0,,200,13
Orzinski Lake,2012,0,,201,13
Orzinski Lake,2012,1,,202,14
Orzinski Lake,2012,0,,203,14
Orzinski Lake,2012,0,,204,14
Orzinski Lake,2012,1,,205,15
Orzinski Lake,2012,2,,206,17
Orzinski Lake,2012,0,,207,17
Orzinski Lake,2012,3,,208,20
Orzinski Lake,2012,9,,209,29
Orzinski Lake,2012,2,,210,31
Orzinski Lake,2012,9,,211,40
Orzinski Lake,2012,2,,212,42
Orzinski Lake,2012,5,,213,47
Orzinski Lake,2012,4,,214,51
Orzinski Lake,2012,7,,215,58
Orzinski Lake,2012,6,,216,64
Orzinski Lake,2012,0,wier pulled for season,217,64
Pasagshak,2011,3,,211,3
Pasagshak,2011,0,,212,3
Pasagshak,2011,2,,213,5
Pasagshak,2011,0,,214,5
Pasagshak,2011,0,,215,5
Pasagshak,2011,0,,216,5
Pasagshak,2011,1,,217,6
Pasagshak,2011,1,,218,7
Pasagshak,2011,0,,219,7
Pasagshak,2011,0,,220,7
Pasagshak,2011,10,,221,17
Pasagshak,2011,3,,222,20
Pasagshak,2011,2,,223,22
Pasagshak,2011,8,,224,30
Pasagshak,2011,10,,225,40
Pasagshak,2011,27,,226,67
Pasagshak,2011,46,,227,113
Pasagshak,2011,0,wier pulled for season,228,113
Pasagshak,2012,1,,197,1
Pasagshak,2012,1,,198,2
Pasagshak,2012,0,,199,2
Pasagshak,2012,0,,200,2
Pasagshak,2012,1,,201,3
Pasagshak,2012,0,,202,3
Pasagshak,2012,0,,203,3
Pasagshak,2012,0,,204,3
Pasagshak,2012,0,,205,3
Pasagshak,2012,1,,206,4
Pasagshak,2012,0,,207,4
Pasagshak,2012,0,,208,4
Pasagshak,2012,0,,209,4
Pasagshak,2012,0,,210,4
Pasagshak,2012,0,,211,4
Pasagshak,2012,4,,212,8
Pasagshak,2012,0,,213,8
Pasagshak,2012,1,,214,9
Pasagshak,2012,0,,215,9
Pasagshak,2012,0,,216,9
Pasagshak,2012,0,,217,9
Pasagshak,2012,0,,218,9
Pasagshak,2012,1,,219,10
Pasagshak,2012,0,,220,10
Pasagshak,2012,0,,221,10
Pasagshak,2012,0,,222,10
Pasagshak,2012,0,,223,10
Pasagshak,2012,0,,224,10
Pasagshak,2012,0,,225,10
Pasagshak,2012,0,,226,10
Pasagshak,2012,0,,227,10
Pasagshak,2012,15,,228,25
Salmon River,2006,3,,182,3
Salmon River,2006,3,,183,6
Salmon River,2006,3,,184,9
Salmon River,2006,7,,185,16
Salmon River,2006,14,,186,30
Salmon River,2006,27,,187,57
Salmon River,2006,20,,188,77
Salmon River,2006,15,,189,92
Salmon River,2006,29,,190,121
Salmon River,2006,39,,191,160
Salmon River,2006,67,,192,227
Salmon River,2006,104,,193,331
Salmon River,2006,114,,194,445
Salmon River,2006,120,,195,565
Salmon River,2006,94,,196,659
Salmon River,2006,167,,197,826
Salmon River,2006,201,,198,1027
Salmon River,2006,245,,199,1272
Salmon River,2006,169,,200,1441
Salmon River,2006,190,,201,1631
Salmon River,2006,213,,202,1844
Salmon River,2006,144,,203,1988
Salmon River,2006,89,,204,2077
Salmon River,2006,70,,205,2147
Salmon River,2006,90,,206,2237
Salmon River,2006,101,,207,2338
Salmon River,2006,62,,208,2400
Salmon River,2006,38,,209,2438
Salmon River,2006,17,,210,2455
Salmon River,2006,15,,211,2470
Salmon River,2006,20,,212,2490
Salmon River,2006,18,,213,2508
Salmon River,2006,10,,214,2518
Salmon River,2006,11,,215,2529
Salmon River,2006,14,,216,2543
Salmon River,2006,14,,217,2557
Salmon River,2006,10,,218,2567
Salmon River,2006,11,,219,2578
Salmon River,2006,10,,220,2588
Salmon River,2007,2,,191,2
Salmon River,2007,3,,194,5
Salmon River,2007,2,,196,7
Salmon River,2007,6,,197,13
Salmon River,2007,7,,198,20
Salmon River,2007,8,,199,28
Salmon River,2007,5,,200,33
Salmon River,2007,5,,201,38
Salmon River,2007,2,,202,40
Salmon River,2007,4,,203,44
Salmon River,2007,4,,204,48
Salmon River,2007,4,,205,52
Salmon River,2007,7,,207,59
Salmon River,2007,6,,208,65
Salmon River,2007,2,,209,67
Salmon River,2007,2,,210,69
Salmon River,2007,1,,211,70
Salmon River,2007,4,,213,74
Salmon River,2007,1,,214,75
Salmon River,2007,3,,215,78
Salmon River,2007,1,,216,79
Salmon River,2007,2,,217,81
Salmon River,2007,1,,219,82
Salmon River,2007,1,,224,83
Salmon River,2007,1,,225,84
Salmon River,2008,0,,176,0
Salmon River,2008,0,,177,0
Salmon River,2008,0,,178,0
Salmon River,2008,0,,179,0
Salmon River,2008,0,,180,0
Salmon River,2008,0,,181,0
Salmon River,2008,0,,182,0
Salmon River,2008,0,,183,0
Salmon River,2008,0,,184,0
Salmon River,2008,0,,185,0
Salmon River,2008,0,,186,0
Salmon River,2008,0,,187,0
Salmon River,2008,0,,188,0
Salmon River,2008,0,,189,0
Salmon River,2008,0,,190,0
Salmon River,2008,0,,191,0
Salmon River,2008,1,,192,1
Salmon River,2008,0,,193,1
Salmon River,2008,0,,194,1
Salmon River,2008,0,,195,1
Salmon River,2008,0,,196,1
Salmon River,2008,2,,197,3
Salmon River,2008,0,,198,3
Salmon River,2008,1,,199,4
Salmon River,2008,2,,200,6
Salmon River,2008,0,,201,6
Salmon River,2008,4,,202,10
Salmon River,2008,3,,203,13
Salmon River,2008,0,,204,13
Salmon River,2008,1,,205,14
Salmon River,2008,0,,206,14
Salmon River,2008,0,,207,14
Salmon River,2008,0,,208,14
Salmon River,2008,0,,209,14
Salmon River,2008,0,,210,14
Salmon River,2008,0,,211,14
Salmon River,2008,0,,212,14
Salmon River,2008,0,,213,14
Salmon River,2008,0,,214,14
Salmon River,2008,0,,215,14
Salmon River,2008,1,,216,15
Salmon River,2008,2,,217,17
Salmon River,2008,1,,218,18
Salmon River,2008,1,,219,19
Salmon River,2008,0,,220,19
Salmon River,2008,0,,221,19
Salmon River,2008,0,,222,19
Salmon River,2008,0,,223,19
Salmon River,2008,0,,224,19
Salmon River,2008,0,,225,19
Salmon River,2008,0,,226,19
Salmon River,2008,0,,227,19
Salmon River,2008,0,,228,19
Salmon River,2008,3,,229,22
Salmon River,2008,0,,230,22
Salmon River,2008,0,,231,22
Salmon River,2008,0,,232,22
Salmon River,2008,3,,233,25
Salmon River,2008,0,,234,25
Salmon River,2008,0,,235,25
Salmon River,2008,0,,236,25
Salmon River,2008,1,,237,26
Salmon River,2008,2,,238,28
Salmon River,2008,2,,239,30
Salmon River,2008,0,,240,30
Salmon River,2008,0,,241,30
Salmon River,2008,0,,242,30
Salmon River,2008,0,,243,30
Salmon River,2008,1,,244,31
Salmon River,2008,0,,245,31
Salmon River,2008,0,,246,31
Salmon River,2008,0,,247,31
Salmon River,2008,0,,248,31
Salmon River,2008,0,,249,31
Salmon River,2008,0,,250,31
Salmon River,2008,0,,251,31
Salmon River,2008,0,,252,31
Salmon River,2008,0,,253,31
Salmon River,2008,0,,254,31
Salmon River,2008,0,,255,31
Salmon River,2008,0,,256,31
Salmon River,2008,0,,257,31
Salmon River,2008,0,,258,31
Salmon River,2008,0,,259,31
Salmon River,2008,0,,260,31
Salmon River,2008,0,,261,31
Salmon River,2008,0,,262,31
Salmon River,2008,0,,263,31
Salmon River,2008,0,,264,31
Salmon River,2008,0,,265,31
Salmon River,2008,0,,266,31
Salmon River,2009,0,,194,0
Salmon River,2009,0,,195,0
Salmon River,2009,0,,196,0
Salmon River,2009,2,,197,2
Salmon River,2009,3,,198,5
Salmon River,2009,3,,199,8
Salmon River,2009,8,,200,16
Salmon River,2009,3,,201,19
Salmon River,2009,3,,202,22
Salmon River,2009,16,,203,38
Salmon River,2009,4,,204,42
Salmon River,2009,5,,205,47
Salmon River,2009,3,,206,50
Salmon River,2009,4,,207,54
Salmon River,2009,6,,208,60
Salmon River,2009,8,,209,68
Salmon River,2009,3,,210,71
Salmon River,2009,0,,211,71
Salmon River,2009,4,,212,75
Salmon River,2009,4,,213,79
Salmon River,2009,1,,214,80
Salmon River,2009,4,,215,84
Salmon River,2009,1,,216,85
Salmon River,2009,1,,217,86
Salmon River,2009,1,,218,87
Salmon River,2009,0,,219,87
Salmon River,2009,1,,220,88
Salmon River,2009,0,,221,88
Salmon River,2009,0,,222,88
Salmon River,2009,0,,223,88
Salmon River,2009,0,,224,88
Salmon River,2009,0,,225,88
Salmon River,2009,0,,226,88
Salmon River,2009,0,,227,88
Salmon River,2009,1,,228,89
Salmon River,2009,0,,229,89
Salmon River,2009,0,,230,89
Salmon River,2009,0,,231,89
Salmon River,2009,0,,232,89
Salmon River,2009,0,,233,89
Salmon River,2009,0,,234,89
Salmon River,2009,0,,235,89
Salmon River,2009,0,,236,89
Salmon River,2009,0,,237,89
Salmon River,2009,0,,238,89
Salmon River,2009,0,,239,89
Salmon River,2009,0,,240,89
Salmon River,2009,0,,241,89
Salmon River,2009,0,,242,89
Salmon River,2009,0,,243,89
Salmon River,2009,0,,244,89
Salmon River,2009,0,,245,89
Salmon River,2009,0,,246,89
Salmon River,2009,0,,247,89
Salmon River,2009,0,,248,89
Salmon River,2009,0,,249,89
Salmon River,2009,0,,250,89
Salmon River,2009,0,,251,89
Salmon River,2009,0,,252,89
Salmon River,2009,0,,253,89
Salmon River,2009,0,,254,89
Salmon River,2009,0,,255,89
Salmon River,2009,0,,256,89
Salmon River,2009,0,,257,89
Salmon River,2009,0,,258,89
Salmon River,2009,0,,259,89
Salmon River,2009,0,,260,89
Salmon River,2009,0,,261,89
Salmon River,2009,0,,262,89
Salmon River,2009,0,,263,89
Salmon River,2009,0,,264,89
Salmon River,2009,0,,265,89
Salmon River,2009,0,,266,89
Salmon River,2009,0,,267,89
Salmon River,2009,0,,268,89
Salmon River,2009,0,,269,89
Salmon River,2012,4,,200,4
Salmon River,2012,9,,201,13
Salmon River,2012,3,,202,16
Salmon River,2012,9,,203,25
Salmon River,2012,1,,204,26
Salmon River,2012,6,,208,32
Salmon River,2012,1,,209,33
Salmon River,2012,6,,210,39
Salmon River,2012,4,,211,43
Salmon River,2012,2,,216,45
Salmon River,2012,1,,218,46
Salmon River,2012,2,,220,48
Salmon River,2012,4,,221,52
Salmon River,2012,3,,223,55
Salmon River,2012,3,,225,58
Salmon River,2012,1,,226,59
Salmon River,2012,1,,229,60
Salmon River,2012,2,,230,62
Saltery Creek,2008,1,,185,1
Saltery Creek,2008,2,,186,3
Saltery Creek,2008,5,,187,8
Saltery Creek,2008,2,,188,10
Saltery Creek,2008,4,,189,14
Saltery Creek,2008,5,,190,19
Saltery Creek,2008,6,,191,25
Saltery Creek,2008,7,,192,32
Saltery Creek,2008,10,,193,42
Saltery Creek,2008,30,,194,72
Saltery Creek,2008,46,,195,118
Saltery Creek,2008,33,,196,151
Saltery Creek,2008,11,,197,162
Saltery Creek,2008,10,,198,172
Saltery Creek,2008,18,,199,190
Saltery Creek,2008,9,,200,199
Saltery Creek,2008,14,,201,213
Saltery Creek,2008,59,,202,272
Saltery Creek,2008,32,,203,304
Saltery Creek,2008,25,,204,329
Saltery Creek,2008,39,,205,368
Saltery Creek,2008,288,,206,656
Saltery Creek,2008,261,,207,917
Saltery Creek,2008,47,,208,964
Saltery Creek,2008,51,,209,1015
Saltery Creek,2008,195,,210,1210
Saltery Creek,2008,519,,211,1729
Saltery Creek,2008,170,,212,1899
Saltery Creek,2008,239,,213,2138
Saltery Creek,2008,819,,214,2957
Saltery Creek,2008,292,,215,3249
Saltery Creek,2008,590,,216,3839
Saltery Creek,2008,1831,,217,5670
Saltery Creek,2008,1689,,218,7359
Saltery Creek,2008,557,,219,7916
Saltery Creek,2008,0,wier closed,220,7916
Saltery Creek,2008,5000,post wier estimate,221,12916
Saltery Creek,2009,1,,185,1
Saltery Creek,2009,1,,186,2
Saltery Creek,2009,0,,187,2
Saltery Creek,2009,2,,188,4
Saltery Creek,2009,4,,189,8
Saltery Creek,2009,5,,190,13
Saltery Creek,2009,22,,191,35
Saltery Creek,2009,11,,192,46
Saltery Creek,2009,17,,193,63
Saltery Creek,2009,19,,194,82
Saltery Creek,2009,22,,195,104
Saltery Creek,2009,28,,196,132
Saltery Creek,2009,8,,197,140
Saltery Creek,2009,35,,198,175
Saltery Creek,2009,60,,199,235
Saltery Creek,2009,220,,200,455
Saltery Creek,2009,337,,201,792
Saltery Creek,2009,974,,202,1766
Saltery Creek,2009,95,,203,1861
Saltery Creek,2009,113,,204,1974
Saltery Creek,2009,458,,205,2432
Saltery Creek,2009,669,,206,3101
Saltery Creek,2009,226,,207,3327
Saltery Creek,2009,93,,208,3420
Saltery Creek,2009,204,,209,3624
Saltery Creek,2009,336,,210,3960
Saltery Creek,2009,413,,211,4373
Saltery Creek,2009,577,,212,4950
Saltery Creek,2009,656,,213,5606
Saltery Creek,2009,870,,214,6476
Saltery Creek,2009,1319,,215,7795
Saltery Creek,2009,785,,216,8580
Saltery Creek,2009,475,,217,9055
Saltery Creek,2009,489,,218,9544
Saltery Creek,2009,732,,219,10276
Saltery Creek,2009,1273,,220,11549
Saltery Creek,2009,1093,,221,12642
Saltery Creek,2009,526,,222,13168
Saltery Creek,2009,117,,223,13285
Saltery Creek,2009,8000,post wier estimate,224,21285
Saltery Creek,2010,6,,190,6
Saltery Creek,2010,31,,191,37
Saltery Creek,2010,5,,192,42
Saltery Creek,2010,3,,193,45
Saltery Creek,2010,37,,194,82
Saltery Creek,2010,23,,195,105
Saltery Creek,2010,15,,196,120
Saltery Creek,2010,25,,197,145
Saltery Creek,2010,13,,198,158
Saltery Creek,2010,32,,199,190
Saltery Creek,2010,52,,200,242
Saltery Creek,2010,77,,201,319
Saltery Creek,2010,12,,202,331
Saltery Creek,2010,10,,203,341
Saltery Creek,2010,40,,204,381
Saltery Creek,2010,10,,205,391
Saltery Creek,2010,12,,206,403
Saltery Creek,2010,16,,207,419
Saltery Creek,2010,42,,208,461
Saltery Creek,2010,163,,209,624
Saltery Creek,2010,72,,210,696
Saltery Creek,2010,167,,211,863
Saltery Creek,2010,15,,212,878
Saltery Creek,2010,12,,213,890
Saltery Creek,2010,47,,214,937
Saltery Creek,2010,66,,215,1003
Saltery Creek,2010,83,,216,1086
Saltery Creek,2010,854,,217,1940
Saltery Creek,2010,509,,218,2449
Saltery Creek,2010,374,,219,2823
Saltery Creek,2010,266,,220,3089
Saltery Creek,2010,18,wier closed,221,3107
Saltery Creek,2010,0,wier closed,222,3107
Saltery Creek,2011,2,,186,2
Saltery Creek,2011,0,,187,2
Saltery Creek,2011,0,,188,2
Saltery Creek,2011,0,,189,2
Saltery Creek,2011,0,,190,2
Saltery Creek,2011,0,,191,2
Saltery Creek,2011,0,,192,2
Saltery Creek,2011,2,,193,4
Saltery Creek,2011,1,,194,5
Saltery Creek,2011,5,,195,10
Saltery Creek,2011,2,,196,12
Saltery Creek,2011,3,,197,15
Saltery Creek,2011,4,,198,19
Saltery Creek,2011,10,,199,29
Saltery Creek,2011,5,,200,34
Saltery Creek,2011,10,,201,44
Saltery Creek,2011,3,,202,47
Saltery Creek,2011,12,,203,59
Saltery Creek,2011,34,,204,93
Saltery Creek,2011,31,,205,124
Saltery Creek,2011,37,,206,161
Saltery Creek,2011,78,,207,239
Saltery Creek,2011,174,,208,413
Saltery Creek,2011,187,,209,600
Saltery Creek,2011,36,,210,636
Saltery Creek,2011,184,,211,820
Saltery Creek,2011,242,,212,1062
Saltery Creek,2011,86,,213,1148
Saltery Creek,2011,174,,214,1322
Saltery Creek,2011,48,,215,1370
Saltery Creek,2011,65,,216,1435
Saltery Creek,2011,65,,217,1500
Saltery Creek,2011,75,,218,1575
Saltery Creek,2011,243,,219,1818
Saltery Creek,2011,237,,220,2055
Saltery Creek,2011,25,,221,2080
Saltery Creek,2011,3055,"wier pulled for season, post wier estimate",222,5135
Saltery Creek,2012,2,,187,2
Saltery Creek,2012,1,,188,3
Saltery Creek,2012,7,,189,10
Saltery Creek,2012,0,,190,10
Saltery Creek,2012,0,,191,10
Saltery Creek,2012,4,,192,14
Saltery Creek,2012,8,,193,22
Saltery Creek,2012,2,,194,24
Saltery Creek,2012,4,,195,28
Saltery Creek,2012,6,,196,34
Saltery Creek,2012,10,,197,44
Saltery Creek,2012,11,,198,55
Saltery Creek,2012,17,,199,72
Saltery Creek,2012,13,,200,85
Saltery Creek,2012,42,,201,127
Saltery Creek,2012,160,,202,287
Saltery Creek,2012,115,,203,402
Saltery Creek,2012,61,,204,463
Saltery Creek,2012,73,,205,536
Saltery Creek,2012,82,,206,618
Saltery Creek,2012,263,,207,881
Saltery Creek,2012,132,,208,1013
Saltery Creek,2012,475,,209,1488
Saltery Creek,2012,605,,210,2093
Saltery Creek,2012,255,,211,2348
Saltery Creek,2012,1555,,212,3903
Saltery Creek,2012,635,,213,4538
Saltery Creek,2012,1605,,214,6143
Saltery Creek,2012,474,,215,6617
Saltery Creek,2012,1538,,216,8155
Saltery Creek,2012,2418,,217,10573
Saltery Creek,2012,1680,,218,12253
Saltery Creek,2012,1022,,219,13275
Saltery Creek,2012,584,,220,13859
Saltery Creek,2012,4096,,221,17955
Saltery Creek,2012,1688,,222,19643
Sandy River,2006,4,,178,4
Sandy River,2006,5,,179,9
Sandy River,2006,9,,180,18
Sandy River,2006,3,,181,21
Sandy River,2006,2,,182,23
Sandy River,2006,1,,183,24
Sandy River,2006,16,,184,40
Sandy River,2006,2,,185,42
Sandy River,2006,33,,186,75
Sandy River,2006,12,,187,87
Sandy River,2006,24,,188,111
Sandy River,2006,31,,189,142
Sandy River,2006,31,,190,173
Sandy River,2006,0,no count high water,191,173
Sandy River,2006,13,,192,186
Sandy River,2006,12,,193,198
Sandy River,2006,1,,194,199
Sandy River,2006,0,,195,199
Sandy River,2006,0,,196,199
Sandy River,2006,0,no count high water,197,199
Sandy River,2006,0,no count high water,198,199
Sandy River,2006,0,no count high water,199,199
Sandy River,2006,0,,200,199
Sandy River,2007,4,,184,4
Sandy River,2007,1,,185,5
Sandy River,2007,1,,186,6
Sandy River,2007,0,,187,6
Sandy River,2007,4,,188,10
Sandy River,2007,2,,189,12
Sandy River,2007,9,,190,21
Sandy River,2007,1,,191,22
Sandy River,2007,18,,192,40
Sandy River,2007,21,,193,61
Sandy River,2007,22,,194,83
Sandy River,2007,22,,195,105
Sandy River,2007,26,,196,131
Sandy River,2007,20,,197,151
Sandy River,2007,3,,199,154
Sandy River,2007,3,,200,157
Sandy River,2007,0,,201,157
Sandy River,2007,0,,202,157
Sandy River,2007,0,,203,157
Sandy River,2007,0,,204,157
Sandy River,2007,0,wier closed,205,157
Sandy River,2008,1,,182,1
Sandy River,2008,0,,183,1
Sandy River,2008,0,,184,1
Sandy River,2008,0,,185,1
Sandy River,2008,0,,186,1
Sandy River,2008,0,,187,1
Sandy River,2008,5,,188,6
Sandy River,2008,1,,189,7
Sandy River,2008,0,,190,7
Sandy River,2008,0,,191,7
Sandy River,2008,0,,192,7
Sandy River,2008,0,,193,7
Sandy River,2008,0,,194,7
Sandy River,2008,0,,195,7
Sandy River,2008,1,,196,8
Sandy River,2008,4,,197,12
Sandy River,2008,0,,198,12
Sandy River,2008,1,,199,13
Sandy River,2008,0,,200,13
Sandy River,2008,0,,201,13
Sandy River,2008,0,,202,13
Sandy River,2008,20,,203,33
Sandy River,2008,7,,204,40
Sandy River,2008,3,,205,43
Sandy River,2009,5,,190,5
Sandy River,2009,2,,191,7
Sandy River,2009,7,,192,14
Sandy River,2009,4,,193,18
Sandy River,2009,2,,194,20
Sandy River,2009,1,,195,21
Sandy River,2009,0,,196,21
Sandy River,2009,0,,197,21
Sandy River,2009,0,,198,21
Sandy River,2009,0,,199,21
Sandy River,2009,1,,200,22
Sandy River,2009,2,,201,24
Sandy River,2009,0,,202,24
Sandy River,2009,10,,203,34
Sandy River,2009,3,,204,37
Sandy River,2009,5,,205,42
Sandy River,2009,12,,206,54
Sandy River,2009,0,wier closed,207,54
Sandy River,2010,8,,199,8
Sandy River,2010,12,,200,20
Sandy River,2010,3,,201,23
Sandy River,2010,0,,202,23
Sandy River,2010,0,wier closed,203,23
Sandy River,2011,2,,195,2
Sandy River,2011,6,,196,8
Sandy River,2011,0,,197,8
Sandy River,2011,2,,198,10
Sandy River,2011,5,,199,15
Sandy River,2011,2,,200,17
Sandy River,2011,2,,201,19
Sandy River,2011,2,,202,21
Sandy River,2011,0,,203,21
Sandy River,2011,0,,204,21
Sandy River,2011,0,wier pulled for season,205,21
Sandy River,2012,2,,179,2
Sandy River,2012,1,,180,3
Sandy River,2012,0,,181,3
Sandy River,2012,3,,182,6
Sandy River,2012,0,,183,6
Sandy River,2012,2,,184,8
Sandy River,2012,1,,185,9
Sandy River,2012,0,,186,9
Sandy River,2012,0,,187,9
Sandy River,2012,1,,188,10
Sandy River,2012,0,,189,10
Sandy River,2012,0,,190,10
Sandy River,2012,2,,191,12
Sandy River,2012,14,,192,26
Sandy River,2012,19,,193,45
Sandy River,2012,24,,194,69
Sandy River,2012,32,,195,101
Sandy River,2012,27,,196,128
Sandy River,2012,20,,197,148
Sandy River,2012,9,,198,157
Sandy River,2012,6,,199,163
Sandy River,2012,51,,200,214
Sandy River,2012,69,,201,283
Sandy River,2012,46,,202,329
Sandy River,2012,332,,203,661
Sandy River,2012,85,,204,746
Sandy River,2012,0,wier pulled for season,205,746
Tatlawiksuk River,2006,0,,166,0
Tatlawiksuk River,2006,0,,167,0
Tatlawiksuk River,2006,0,,168,0
Tatlawiksuk River,2006,0,,169,0
Tatlawiksuk River,2006,0,,170,0
Tatlawiksuk River,2006,0,,171,0
Tatlawiksuk River,2006,0,,172,0
Tatlawiksuk River,2006,0,,173,0
Tatlawiksuk River,2006,0,,174,0
Tatlawiksuk River,2006,0,,175,0
Tatlawiksuk River,2006,0,,176,0
Tatlawiksuk River,2006,0,,177,0
Tatlawiksuk River,2006,0,,178,0
Tatlawiksuk River,2006,0,,179,0
Tatlawiksuk River,2006,0,,180,0
Tatlawiksuk River,2006,0,,181,0
Tatlawiksuk River,2006,0,,182,0
Tatlawiksuk River,2006,0,,183,0
Tatlawiksuk River,2006,0,,184,0
Tatlawiksuk River,2006,0,,185,0
Tatlawiksuk River,2006,0,,186,0
Tatlawiksuk River,2006,0,,187,0
Tatlawiksuk River,2006,0,,188,0
Tatlawiksuk River,2006,0,,189,0
Tatlawiksuk River,2006,0,,190,0
Tatlawiksuk River,2006,0,,191,0
Tatlawiksuk River,2006,0,,192,0
Tatlawiksuk River,2006,0,,193,0
Tatlawiksuk River,2006,0,,194,0
Tatlawiksuk River,2006,0,,195,0
Tatlawiksuk River,2006,0,,196,0
Tatlawiksuk River,2006,0,,197,0
Tatlawiksuk River,2006,1,,198,1
Tatlawiksuk River,2006,1,,199,2
Tatlawiksuk River,2006,1,,200,3
Tatlawiksuk River,2006,1,,201,4
Tatlawiksuk River,2006,1,,202,5
Tatlawiksuk River,2006,3,,203,8
Tatlawiksuk River,2006,1,,204,9
Tatlawiksuk River,2006,3,,205,12
Tatlawiksuk River,2006,2,,206,14
Tatlawiksuk River,2006,2,,207,16
Tatlawiksuk River,2006,1,,208,17
Tatlawiksuk River,2006,0,,209,17
Tatlawiksuk River,2006,1,,210,18
Tatlawiksuk River,2006,0,,211,18
Tatlawiksuk River,2006,1,,212,19
Tatlawiksuk River,2006,0,,213,19
Tatlawiksuk River,2006,0,,214,19
Tatlawiksuk River,2006,0,,215,19
Tatlawiksuk River,2006,0,,216,19
Tatlawiksuk River,2006,0,,217,19
Tatlawiksuk River,2006,1,,218,20
Tatlawiksuk River,2006,0,,219,20
Tatlawiksuk River,2006,0,,220,20
Tatlawiksuk River,2006,0,,221,20
Tatlawiksuk River,2006,0,,222,20
Tatlawiksuk River,2006,0,,223,20
Tatlawiksuk River,2006,0,,224,20
Tatlawiksuk River,2006,0,,225,20
Tatlawiksuk River,2006,0,,226,20
Tatlawiksuk River,2006,0,,227,20
Tatlawiksuk River,2006,0,,228,20
Tatlawiksuk River,2006,0,,229,20
Tatlawiksuk River,2006,0,,230,20
Tatlawiksuk River,2007,0,,165,0
Tatlawiksuk River,2007,0,,166,0
Tatlawiksuk River,2007,0,,167,0
Tatlawiksuk River,2007,0,,168,0
Tatlawiksuk River,2007,0,,169,0
Tatlawiksuk River,2007,0,,170,0
Tatlawiksuk River,2007,0,,171,0
Tatlawiksuk River,2007,0,,172,0
Tatlawiksuk River,2007,0,,173,0
Tatlawiksuk River,2007,0,,174,0
Tatlawiksuk River,2007,0,,175,0
Tatlawiksuk River,2007,0,,176,0
Tatlawiksuk River,2007,0,,177,0
Tatlawiksuk River,2007,0,,178,0
Tatlawiksuk River,2007,0,,179,0
Tatlawiksuk River,2007,0,,180,0
Tatlawiksuk River,2007,0,,181,0
Tatlawiksuk River,2007,0,,182,0
Tatlawiksuk River,2007,0,,183,0
Tatlawiksuk River,2007,0,,184,0
Tatlawiksuk River,2007,0,,185,0
Tatlawiksuk River,2007,0,,186,0
Tatlawiksuk River,2007,0,,187,0
Tatlawiksuk River,2007,0,,188,0
Tatlawiksuk River,2007,0,,189,0
Tatlawiksuk River,2007,0,,190,0
Tatlawiksuk River,2007,0,,191,0
Tatlawiksuk River,2007,0,,192,0
Tatlawiksuk River,2007,0,,193,0
Tatlawiksuk River,2007,0,,194,0
Tatlawiksuk River,2007,0,,195,0
Tatlawiksuk River,2007,0,,196,0
Tatlawiksuk River,2007,1,,197,1
Tatlawiksuk River,2007,0,,198,1
Tatlawiksuk River,2007,0,,199,1
Tatlawiksuk River,2007,0,,200,1
Tatlawiksuk River,2007,0,,201,1
Tatlawiksuk River,2007,0,,202,1
Tatlawiksuk River,2007,1,,203,2
Tatlawiksuk River,2007,1,,204,3
Tatlawiksuk River,2007,2,,205,5
Tatlawiksuk River,2007,1,,206,6
Tatlawiksuk River,2007,0,,207,6
Tatlawiksuk River,2007,1,,208,7
Tatlawiksuk River,2007,0,,209,7
Tatlawiksuk River,2007,0,,210,7
Tatlawiksuk River,2007,0,,211,7
Tatlawiksuk River,2007,0,,212,7
Tatlawiksuk River,2007,0,,213,7
Tatlawiksuk River,2007,0,,214,7
Tatlawiksuk River,2007,0,,215,7
Tatlawiksuk River,2007,0,,216,7
Tatlawiksuk River,2007,0,,217,7
Tatlawiksuk River,2007,0,,224,7
Tatlawiksuk River,2007,0,,225,7
Tatlawiksuk River,2007,0,,226,7
Tatlawiksuk River,2007,0,,227,7
Tatlawiksuk River,2007,0,,228,7
Tatlawiksuk River,2007,0,,229,7
Tatlawiksuk River,2007,0,,230,7
Tatlawiksuk River,2007,0,,231,7
Tatlawiksuk River,2007,0,,232,7
Tatlawiksuk River,2007,0,,233,7
Tatlawiksuk River,2007,0,,234,7
Tatlawiksuk River,2007,0,,235,7
Tatlawiksuk River,2007,0,,236,7
Tatlawiksuk River,2007,0,,237,7
Tatlawiksuk River,2007,0,,238,7
Tatlawiksuk River,2007,0,,239,7
Tatlawiksuk River,2007,0,,240,7
Tatlawiksuk River,2007,0,,241,7
Tatlawiksuk River,2007,0,,242,7
Tatlawiksuk River,2007,0,,243,7
Tatlawiksuk River,2007,0,,244,7
Tatlawiksuk River,2007,0,,245,7
Tatlawiksuk River,2007,0,,246,7
Tatlawiksuk River,2007,0,,247,7
Tatlawiksuk River,2007,0,,248,7
Tatlawiksuk River,2007,0,,249,7
Tatlawiksuk River,2007,0,,250,7
Tatlawiksuk River,2007,0,,251,7
Tatlawiksuk River,2007,0,,252,7
Tatlawiksuk River,2007,0,,253,7
Tatlawiksuk River,2007,0,,254,7
Tatlawiksuk River,2007,0,,255,7
Tatlawiksuk River,2007,0,,256,7
Tatlawiksuk River,2007,0,,257,7
Tatlawiksuk River,2007,0,,258,7
Tatlawiksuk River,2008,0,,167,0
Tatlawiksuk River,2008,0,,168,0
Tatlawiksuk River,2008,0,,169,0
Tatlawiksuk River,2008,0,,170,0
Tatlawiksuk River,2008,0,,171,0
Tatlawiksuk River,2008,0,,172,0
Tatlawiksuk River,2008,0,,173,0
Tatlawiksuk River,2008,0,,174,0
Tatlawiksuk River,2008,0,,175,0
Tatlawiksuk River,2008,0,,176,0
Tatlawiksuk River,2008,0,,177,0
Tatlawiksuk River,2008,0,,178,0
Tatlawiksuk River,2008,0,,179,0
Tatlawiksuk River,2008,0,,180,0
Tatlawiksuk River,2008,,,181,0
Tatlawiksuk River,2008,,,182,0
Tatlawiksuk River,2008,,,183,0
Tatlawiksuk River,2008,,,184,0
Tatlawiksuk River,2008,,,185,0
Tatlawiksuk River,2008,,,186,0
Tatlawiksuk River,2008,,,187,0
Tatlawiksuk River,2008,,,188,0
Tatlawiksuk River,2008,,,189,0
Tatlawiksuk River,2008,0,,190,0
Tatlawiksuk River,2008,0,,191,0
Tatlawiksuk River,2008,0,,192,0
Tatlawiksuk River,2008,0,,193,0
Tatlawiksuk River,2008,0,,194,0
Tatlawiksuk River,2008,0,,195,0
Tatlawiksuk River,2008,0,,196,0
Tatlawiksuk River,2008,0,,197,0
Tatlawiksuk River,2008,0,,198,0
Tatlawiksuk River,2008,0,,199,0
Tatlawiksuk River,2008,0,,200,0
Tatlawiksuk River,2008,1,,201,1
Tatlawiksuk River,2008,0,,202,1
Tatlawiksuk River,2008,2,,203,3
Tatlawiksuk River,2008,3,,204,6
Tatlawiksuk River,2008,0,,205,6
Tatlawiksuk River,2008,2,,206,8
Tatlawiksuk River,2008,0,,207,8
Tatlawiksuk River,2008,0,,208,8
Tatlawiksuk River,2008,0,,209,8
Tatlawiksuk River,2008,2,,210,10
Tatlawiksuk River,2008,3,,211,13
Tatlawiksuk River,2008,0,,212,13
Tatlawiksuk River,2008,1,,213,14
Tatlawiksuk River,2008,3,,214,17
Tatlawiksuk River,2008,0,,215,17
Tatlawiksuk River,2008,0,,216,17
Tatlawiksuk River,2008,0,,217,17
Tatlawiksuk River,2008,0,,218,17
Tatlawiksuk River,2008,1,,219,18
Tatlawiksuk River,2008,0,,220,18
Tatlawiksuk River,2008,0,,221,18
Tatlawiksuk River,2008,0,,222,18
Tatlawiksuk River,2008,0,,223,18
Tatlawiksuk River,2008,0,,224,18
Tatlawiksuk River,2008,1,,225,19
Tatlawiksuk River,2008,0,,226,19
Tatlawiksuk River,2008,0,,227,19
Tatlawiksuk River,2008,0,,228,19
Tatlawiksuk River,2008,0,,229,19
Tatlawiksuk River,2008,0,,230,19
Tatlawiksuk River,2008,0,,231,19
Tatlawiksuk River,2008,0,,232,19
Tatlawiksuk River,2008,0,,233,19
Tatlawiksuk River,2008,0,,234,19
Tatlawiksuk River,2008,0,,235,19
Tatlawiksuk River,2008,0,,236,19
Tatlawiksuk River,2008,0,,237,19
Tatlawiksuk River,2008,0,,238,19
Tatlawiksuk River,2008,0,,239,19
Tatlawiksuk River,2008,0,,240,19
Tatlawiksuk River,2008,0,,241,19
Tatlawiksuk River,2008,0,,242,19
Tatlawiksuk River,2008,0,,243,19
Tatlawiksuk River,2008,0,,244,19
Tatlawiksuk River,2008,0,,245,19
Tatlawiksuk River,2008,0,,246,19
Tatlawiksuk River,2008,0,,247,19
Tatlawiksuk River,2008,0,,248,19
Tatlawiksuk River,2008,0,,249,19
Tatlawiksuk River,2008,0,,250,19
Tatlawiksuk River,2008,0,,251,19
Tatlawiksuk River,2008,0,,252,19
Tatlawiksuk River,2008,0,,253,19
Tatlawiksuk River,2008,0,,254,19
Tatlawiksuk River,2008,0,,255,19
Tatlawiksuk River,2008,0,,256,19
Tatlawiksuk River,2008,0,,257,19
Tatlawiksuk River,2008,0,,258,19
Tatlawiksuk River,2008,0,,259,19
Tatlawiksuk River,2008,0,,260,19
Tatlawiksuk River,2008,0,,261,19
Tatlawiksuk River,2008,0,,262,19
Tatlawiksuk River,2008,,,263,19
Tatlawiksuk River,2008,,,264,19
Tatlawiksuk River,2010,2,,200,2
Tatlawiksuk River,2010,3,,201,5
Tatlawiksuk River,2010,1,,202,6
Tatlawiksuk River,2010,3,,203,9
Tatlawiksuk River,2010,1,,208,10
Tatlawiksuk River,2010,3,,209,13
Tatlawiksuk River,2010,1,,211,14
Tatlawiksuk River,2010,1,,212,15
Tatlawiksuk River,2010,5,,213,20
Tatlawiksuk River,2010,1,,218,21
Tatlawiksuk River,2010,1,,219,22
Tatlawiksuk River,2011,0,,166,0
Tatlawiksuk River,2011,0,,167,0
Tatlawiksuk River,2011,0,,168,0
Tatlawiksuk River,2011,0,,169,0
Tatlawiksuk River,2011,0,,170,0
Tatlawiksuk River,2011,0,,171,0
Tatlawiksuk River,2011,0,,172,0
Tatlawiksuk River,2011,0,,173,0
Tatlawiksuk River,2011,0,,174,0
Tatlawiksuk River,2011,0,,175,0
Tatlawiksuk River,2011,0,,176,0
Tatlawiksuk River,2011,0,,177,0
Tatlawiksuk River,2011,0,,178,0
Tatlawiksuk River,2011,0,,179,0
Tatlawiksuk River,2011,0,,180,0
Tatlawiksuk River,2011,0,,181,0
Tatlawiksuk River,2011,0,,182,0
Tatlawiksuk River,2011,0,,183,0
Tatlawiksuk River,2011,0,,184,0
Tatlawiksuk River,2011,0,,185,0
Tatlawiksuk River,2011,0,,186,0
Tatlawiksuk River,2011,0,,187,0
Tatlawiksuk River,2011,0,,188,0
Tatlawiksuk River,2011,0,,189,0
Tatlawiksuk River,2011,1,,190,1
Tatlawiksuk River,2011,0,,191,1
Tatlawiksuk River,2011,0,,192,1
Tatlawiksuk River,2011,0,,193,1
Tatlawiksuk River,2011,0,,194,1
Tatlawiksuk River,2011,0,,195,1
Tatlawiksuk River,2011,0,,196,1
Tatlawiksuk River,2011,3,,197,4
Tatlawiksuk River,2011,4,,198,8
Tatlawiksuk River,2011,4,,199,12
Tatlawiksuk River,2011,9,,200,21
Tatlawiksuk River,2011,11,,201,32
Tatlawiksuk River,2011,9,,202,41
Tatlawiksuk River,2011,9,,203,50
Tatlawiksuk River,2011,0,,204,50
Tatlawiksuk River,2011,2,,205,52
Tatlawiksuk River,2011,2,,206,54
Tatlawiksuk River,2011,1,,207,55
Tatlawiksuk River,2011,28,,208,83
Tatlawiksuk River,2011,13,,209,96
Tatlawiksuk River,2011,5,,210,101
Tatlawiksuk River,2011,1,,211,102
Tatlawiksuk River,2011,1,,212,103
Tatlawiksuk River,2011,1,,213,104
Tatlawiksuk River,2011,1,,214,105
Tatlawiksuk River,2011,1,,215,106
Tatlawiksuk River,2011,0,,231,106
Tatlawiksuk River,2011,0,,232,106
Tatlawiksuk River,2011,0,,233,106
Tatlawiksuk River,2011,0,,234,106
Tatlawiksuk River,2011,0,,235,106
Tatlawiksuk River,2011,0,,236,106
Tatlawiksuk River,2011,0,,237,106
Tatlawiksuk River,2011,0,,238,106
Tatlawiksuk River,2011,0,,239,106
Tatlawiksuk River,2011,0,,240,106
Tatlawiksuk River,2011,0,,241,106
Tatlawiksuk River,2011,0,,242,106
Tatlawiksuk River,2011,0,,243,106
Tatlawiksuk River,2011,0,,244,106
Tatlawiksuk River,2011,0,,245,106
Tatlawiksuk River,2011,0,,246,106
Tatlawiksuk River,2011,0,,247,106
Tatlawiksuk River,2011,0,,248,106
Tatlawiksuk River,2011,0,,249,106
Tatlawiksuk River,2011,0,,250,106
Tatlawiksuk River,2011,0,,251,106
Tatlawiksuk River,2011,0,,252,106
Tatlawiksuk River,2011,0,,253,106
Tatlawiksuk River,2011,0,,254,106
Tatlawiksuk River,2011,0,,255,106
Tatlawiksuk River,2011,0,,256,106
Tatlawiksuk River,2011,0,,257,106
Tatlawiksuk River,2011,0,,258,106
Tatlawiksuk River,2011,0,,259,106
Tatlawiksuk River,2011,0,,260,106
Tatlawiksuk River,2011,0,,261,106
Tatlawiksuk River,2011,0,,262,106
Tatlawiksuk River,2012,1,,193,1
Tatlawiksuk River,2012,3,,195,4
Tatlawiksuk River,2012,1,,200,5
Tatlawiksuk River,2012,1,,201,6
Tatlawiksuk River,2012,1,,202,7
Tatlawiksuk River,2012,4,,203,11
Tatlawiksuk River,2012,2,,205,13
Tatlawiksuk River,2012,5,,206,18
Tatlawiksuk River,2012,8,,207,26
Tatlawiksuk River,2012,1,,208,27
Unalakleet River,2010,0,,173,0
Unalakleet River,2010,7,,174,7
Unalakleet River,2010,350,,175,357
Unalakleet River,2010,649,,176,1006
Unalakleet River,2010,883,,177,1889
Unalakleet River,2010,868,,178,2757
Unalakleet River,2010,185,,179,2942
Unalakleet River,2010,297,,180,3239
Unalakleet River,2010,4799,,181,8038
Unalakleet River,2010,12054,,182,20092
Unalakleet River,2010,16679,,183,36771
Unalakleet River,2010,21790,,184,58561
Unalakleet River,2010,21876,,185,80437
Unalakleet River,2010,58472,,186,138909
Unalakleet River,2010,20583,,187,159492
Unalakleet River,2010,9389,,188,168881
Unalakleet River,2010,11457,,189,180338
Unalakleet River,2010,36995,,190,217333
Unalakleet River,2010,92673,,191,310006
Unalakleet River,2010,34565,,192,344571
Unalakleet River,2010,26337,,193,370908
Unalakleet River,2010,17534,,194,388442
Unalakleet River,2010,46435,,195,434877
Unalakleet River,2010,22438,,196,457315
Unalakleet River,2010,37851,,197,495166
Unalakleet River,2010,41672,,198,536838
Unalakleet River,2010,84057,,199,620895
Unalakleet River,2010,25883,,200,646778
Unalakleet River,2010,30515,,201,677293
Unalakleet River,2010,26659,,202,703952
Unalakleet River,2010,16598,,203,720550
Unalakleet River,2010,12206,,204,732756
Unalakleet River,2010,20448,,205,753204
Unalakleet River,2010,28231,,206,781435
Unalakleet River,2010,12460,,207,793895
Unalakleet River,2010,11732,,208,805627
Unalakleet River,2010,8159,,209,813786
Unalakleet River,2010,9917,,210,823703
Unalakleet River,2010,4761,,211,828464
Unalakleet River,2010,4440,,212,832904
Unalakleet River,2011,0,,168,0
Unalakleet River,2011,0,,169,0
Unalakleet River,2011,0,,170,0
Unalakleet River,2011,0,,171,0
Unalakleet River,2011,0,,172,0
Unalakleet River,2011,0,,173,0
Unalakleet River,2011,3,,174,3
Unalakleet River,2011,7,,175,10
Unalakleet River,2011,2,,176,12
Unalakleet River,2011,5,,177,17
Unalakleet River,2011,1,,178,18
Unalakleet River,2011,3,,179,21
Unalakleet River,2011,3,,180,24
Unalakleet River,2011,1,,181,25
Unalakleet River,2011,0,,182,25
Unalakleet River,2011,10,,183,35
Unalakleet River,2011,23,,184,58
Unalakleet River,2011,5,,185,63
Unalakleet River,2011,2,,186,65
Unalakleet River,2011,43,,187,108
Unalakleet River,2011,182,,188,290
Unalakleet River,2011,343,,189,633
Unalakleet River,2011,380,,190,1013
Unalakleet River,2011,104,,191,1117
Unalakleet River,2011,690,,192,1807
Unalakleet River,2011,930,,193,2737
Unalakleet River,2011,961,,194,3698
Unalakleet River,2011,595,,195,4293
Unalakleet River,2011,1387,,196,5680
Unalakleet River,2011,2709,,197,8389
Unalakleet River,2011,2728,,198,11117
Unalakleet River,2011,4879,,199,15996
Unalakleet River,2011,6297,,200,22293
Unalakleet River,2011,12560,,201,34853
Unalakleet River,2011,11406,,202,46259
Unalakleet River,2011,13502,,203,59761
Unalakleet River,2011,19298,,204,79059
Unalakleet River,2011,12184,,205,91243
Unalakleet River,2011,15740,,206,106983
Unalakleet River,2011,23339,,207,130322
Unalakleet River,2011,24960,,208,155282
Unalakleet River,2011,25965,,209,181247
Unalakleet River,2011,61654,,210,242901
Unalakleet River,2011,27843,,211,270744
Unalakleet River,2011,22328,,212,293072
Unalakleet River,2011,18183,,213,311255
Unalakleet River,2011,11121,,214,322376
Unalakleet River,2011,12849,,215,335225
Unalakleet River,2011,12005,,216,347230
Unalakleet River,2011,8446,,217,355676
Unalakleet River,2011,7498,,218,363174
Unalakleet River,2011,812,,219,363986
Wasilla Creek,1998,0,,206,0
Wasilla Creek,1998,0,,207,0
Wasilla Creek,1998,0,,208,0
Wasilla Creek,1998,0,,209,0
Wasilla Creek,1998,0,,210,0
Wasilla Creek,1998,0,,211,0
Wasilla Creek,1998,0,,212,0
Wasilla Creek,1998,0,,213,0
Wasilla Creek,1998,0,,214,0
Wasilla Creek,1998,0,,215,0
Wasilla Creek,1998,0,,216,0
Wasilla Creek,1998,0,,217,0
Wasilla Creek,1998,1,,218,1
Wasilla Creek,1998,0,,219,1
Wasilla Creek,1998,4,,220,5
Wasilla Creek,1998,4,,221,9
Wasilla Creek,1998,2,,222,11
Wasilla Creek,1998,11,,223,22
Wasilla Creek,1998,5,,224,27
Wasilla Creek,1998,7,,225,34
Wasilla Creek,1998,6,,226,40
Wasilla Creek,1998,9,,227,49
Wasilla Creek,1998,5,,228,54
Wasilla Creek,1998,3,,229,57
Wasilla Creek,1998,5,,230,62
Wasilla Creek,1998,2,,231,64
Wasilla Creek,1998,4,,232,68
Wasilla Creek,1998,0,,233,68
Wasilla Creek,1998,6,,234,74
Wasilla Creek,1998,2,,235,76
Wasilla Creek,1998,3,,236,79
Wasilla Creek,1998,1,,237,80
Wasilla Creek,1998,0,,238,80
Wasilla Creek,1998,3,,239,83
Wasilla Creek,1998,0,,240,83
Wasilla Creek,1998,2,,241,85
Wasilla Creek,1998,1,,242,86
Wasilla Creek,1998,1,,243,87
Wasilla Creek,1998,1,,244,88
Wasilla Creek,1998,0,,245,88
Wasilla Creek,1998,0,,246,88
Wasilla Creek,1998,0,,247,88
Wasilla Creek,1998,1,,248,89
Wasilla Creek,1998,0,,249,89
Wasilla Creek,1998,0,,250,89
Wasilla Creek,1998,0,,251,89
Wasilla Creek,1998,0,,252,89
Wasilla Creek,1998,0,,253,89
Wasilla Creek,1998,0,,254,89
Wasilla Creek,1998,0,,255,89
Wasilla Creek,1998,0,,256,89
Wasilla Creek,1998,0,,257,89
Wasilla Creek,1998,0,,258,89
Wasilla Creek,1998,0,,259,89
Wasilla Creek,1998,0,,260,89
Wasilla Creek,1998,0,,261,89
Wasilla Creek,1998,0,,262,89
Wasilla Creek,1998,0,,263,89
Wasilla Creek,1998,0,,264,89
Wasilla Creek,1998,0,,265,89
Wasilla Creek,1998,0,,266,89
Wasilla Creek,1998,0,,267,89
Wasilla Creek,1998,0,,268,89
Wasilla Creek,1998,0,,269,89
Wasilla Creek,1998,0,,270,89
Wasilla Creek,1998,0,,271,89
Wasilla Creek,1998,0,,272,89
Wasilla Creek,1998,0,,273,89
Wasilla Creek,1998,0,,274,89
Wasilla Creek,1998,0,,275,89
Wasilla Creek,1998,0,,276,89
Wasilla Creek,1998,0,,277,89
Wasilla Creek,1998,0,,278,89
Wasilla Creek,1998,0,,279,89
Wasilla Creek,1998,0,,280,89
Wasilla Creek,1998,0,,281,89
Wasilla Creek,1998,0,,282,89
Wasilla Creek,1998,0,,283,89
Wasilla Creek,1998,0,,284,89
Wasilla Creek,2000,0,,214,0
Wasilla Creek,2000,2,,215,2
Wasilla Creek,2000,1,,216,3
Wasilla Creek,2000,1,,217,4
Wasilla Creek,2000,1,,218,5
Wasilla Creek,2000,1,,219,6
Wasilla Creek,2000,3,,220,9
Wasilla Creek,2000,7,,221,16
Wasilla Creek,2000,7,,222,23
Wasilla Creek,2000,11,,223,34
Wasilla Creek,2000,6,,224,40
Wasilla Creek,2000,10,,225,50
Wasilla Creek,2000,13,,226,63
Wasilla Creek,2000,35,,227,98
Wasilla Creek,2000,13,,228,111
Wasilla Creek,2000,6,,229,117
Wasilla Creek,2000,4,,230,121
Wasilla Creek,2000,9,,231,130
Wasilla Creek,2000,9,,232,139
Wasilla Creek,2000,6,,233,145
Wasilla Creek,2000,0,,234,145
Wasilla Creek,2000,1,,235,146
Wasilla Creek,2000,0,,236,146
Wasilla Creek,2000,1,,237,147
Wasilla Creek,2000,1,,238,148
Wasilla Creek,2000,0,,239,148
Wasilla Creek,2000,0,,240,148
Wasilla Creek,2000,0,,241,148
Wasilla Creek,2000,1,,242,149
Wasilla Creek,2000,0,,243,149
Wasilla Creek,2000,0,,244,149
Wasilla Creek,2000,0,,245,149
Wasilla Creek,2000,0,,246,149
Wasilla Creek,2000,0,,247,149
Wasilla Creek,2000,0,,248,149
Wasilla Creek,2000,0,,249,149
Wasilla Creek,2000,0,,250,149
Wasilla Creek,2000,0,,251,149
Wasilla Creek,2000,0,,252,149
Wasilla Creek,2000,0,,253,149
Wasilla Creek,2000,0,,254,149
Wasilla Creek,2000,0,,255,149
Wasilla Creek,2000,0,,256,149
Wasilla Creek,2000,0,,257,149
Wasilla Creek,2000,0,,258,149
Wasilla Creek,2000,0,,259,149
Wasilla Creek,2000,0,,260,149
Wasilla Creek,2000,0,,261,149
Wasilla Creek,2000,0,,263,149
Wasilla Creek,2000,0,,264,149
Wasilla Creek,2000,0,,265,149
Wasilla Creek,2000,0,,266,149
Wasilla Creek,2000,0,,267,149
Wasilla Creek,2001,0,,203,0
Wasilla Creek,2001,0,,204,0
Wasilla Creek,2001,0,,205,0
Wasilla Creek,2001,0,,206,0
Wasilla Creek,2001,1,,207,1
Wasilla Creek,2001,0,,208,1
Wasilla Creek,2001,0,,209,1
Wasilla Creek,2001,0,,210,1
Wasilla Creek,2001,0,,211,1
Wasilla Creek,2001,0,,212,1
Wasilla Creek,2001,0,,213,1
Wasilla Creek,2001,0,,214,1
Wasilla Creek,2001,0,,215,1
Wasilla Creek,2001,0,,216,1
Wasilla Creek,2001,0,,217,1
Wasilla Creek,2001,0,,218,1
Wasilla Creek,2001,1,,219,2
Wasilla Creek,2001,0,,220,2
Wasilla Creek,2001,0,,221,2
Wasilla Creek,2001,0,,222,2
Wasilla Creek,2001,1,,223,3
Wasilla Creek,2001,0,,224,3
Wasilla Creek,2001,0,,225,3
Wasilla Creek,2001,0,,226,3
Wasilla Creek,2001,0,,227,3
Wasilla Creek,2001,3,,228,6
Wasilla Creek,2001,1,,229,7
Wasilla Creek,2001,6,,230,13
Wasilla Creek,2001,3,,231,16
Wasilla Creek,2001,1,,232,17
Wasilla Creek,2001,1,,233,18
Wasilla Creek,2001,1,,234,19
Wasilla Creek,2001,2,,235,21
Wasilla Creek,2001,1,,236,22
Wasilla Creek,2001,1,,237,23
Wasilla Creek,2001,3,,238,26
Wasilla Creek,2001,0,,239,26
Wasilla Creek,2001,0,,240,26
Wasilla Creek,2001,0,,241,26
Wasilla Creek,2001,0,,242,26
Wasilla Creek,2001,0,,243,26
Wasilla Creek,2001,1,,244,27
Wasilla Creek,2001,0,,245,27
Wasilla Creek,2001,0,,246,27
Wasilla Creek,2001,0,,247,27
Wasilla Creek,2001,0,,248,27
Wasilla Creek,2001,0,,249,27
Wasilla Creek,2001,0,,250,27
Wasilla Creek,2001,0,,251,27
Wasilla Creek,2001,1,,252,28
Wasilla Creek,2001,1,,253,29
Wasilla Creek,2001,0,,255,29
Wasilla Creek,2001,0,,256,29
Wasilla Creek,2001,0,,257,29
Wasilla Creek,2001,0,,258,29
Wasilla Creek,2001,0,,259,29
Wasilla Creek,2001,0,,260,29
Wasilla Creek,2001,0,,261,29
Wasilla Creek,2001,0,,262,29
Wasilla Creek,2001,0,,263,29
Wasilla Creek,2001,0,,264,29
Wasilla Creek,2001,0,,265,29
Wasilla Creek,2001,0,,266,29
Wasilla Creek,2001,0,,267,29
Willow Creek ,2000,1,,194,1
Willow Creek ,2000,2,,196,3
Willow Creek ,2000,2,,197,5
Willow Creek ,2000,12,,198,17
Willow Creek ,2000,2,,210,19
Willow Creek ,2000,157,,211,176
Willow Creek ,2000,15,,212,191
Willow Creek ,2001,1,,192,1
Willow Creek ,2001,0,,193,1
Willow Creek ,2001,0,,194,1
Willow Creek ,2001,0,,195,1
Willow Creek ,2001,0,,196,1
Willow Creek ,2001,0,,197,1
Willow Creek ,2001,0,,198,1
Willow Creek ,2001,6,,199,7
Willow Creek ,2001,0,,200,7
Willow Creek ,2001,2,,201,9
Willow Creek ,2001,0,,202,9
Willow Creek ,2001,7,,203,16
Willow Creek ,2001,1,,204,17
Willow Creek ,2001,2,,205,19
Willow Creek ,2001,4,,206,23
Willow Creek ,2001,2,,207,25
Willow Creek ,2001,26,,208,51
Willow Creek ,2001,3,,209,54
Willow Creek ,2001,17,,210,71
Willow Creek ,2001,0,,212,71
Willow Creek ,2002,1,,192,1
Willow Creek ,2002,1809,,206,1810
Willow Creek ,2002,428,,207,2238
Willow Creek ,2002,7713,,208,9951
Willow Creek ,2002,332,,209,10283
Willow Creek ,2002,158,last day,210,10441
Yukon River Pilot Station,2007,264,,183,264
Yukon River Pilot Station,2007,199,,184,463
Yukon River Pilot Station,2007,0,,185,463
Yukon River Pilot Station,2007,0,,186,463
Yukon River Pilot Station,2007,317,,187,780
Yukon River Pilot Station,2007,261,,188,1041
Yukon River Pilot Station,2007,213,,189,1254
Yukon River Pilot Station,2007,0,,190,1254
Yukon River Pilot Station,2007,0,,191,1254
Yukon River Pilot Station,2007,428,,192,1682
Yukon River Pilot Station,2007,284,,193,1966
Yukon River Pilot Station,2007,309,,194,2275
Yukon River Pilot Station,2007,2098,,195,4373
Yukon River Pilot Station,2007,0,,196,4373
Yukon River Pilot Station,2007,1970,,197,6343
Yukon River Pilot Station,2007,2075,,198,8418
Yukon River Pilot Station,2007,6580,,199,14998
Yukon River Pilot Station,2007,7084,,200,22082
Yukon River Pilot Station,2007,5154,,201,27236
Yukon River Pilot Station,2007,2084,,202,29320
Yukon River Pilot Station,2007,4194,,203,33514
Yukon River Pilot Station,2007,5700,,204,39214
Yukon River Pilot Station,2007,6761,,205,45975
Yukon River Pilot Station,2007,3567,,206,49542
Yukon River Pilot Station,2007,1878,,207,51420
Yukon River Pilot Station,2007,2964,,208,54384
Yukon River Pilot Station,2007,3298,,209,57682
Yukon River Pilot Station,2007,306,,210,57988
Yukon River Pilot Station,2007,777,,211,58765
Yukon River Pilot Station,2007,553,,212,59318
Yukon River Pilot Station,2007,1790,,213,61108
Yukon River Pilot Station,2007,513,,214,61621
Yukon River Pilot Station,2007,359,,215,61980
Yukon River Pilot Station,2007,898,,216,62878
Yukon River Pilot Station,2007,468,,217,63346
Yukon River Pilot Station,2007,1548,,218,64894
Yukon River Pilot Station,2007,338,,219,65232
Yukon River Pilot Station,2007,1819,,220,67051
Yukon River Pilot Station,2007,420,,221,67471
Yukon River Pilot Station,2007,1486,,222,68957
Yukon River Pilot Station,2007,0,,223,68957
Yukon River Pilot Station,2007,0,,224,68957
Yukon River Pilot Station,2007,648,,225,69605
Yukon River Pilot Station,2007,262,,226,69867
Yukon River Pilot Station,2007,283,,227,70150
Yukon River Pilot Station,2007,264,,228,70414
Yukon River Pilot Station,2007,569,,229,70983
Yukon River Pilot Station,2007,0,,230,70983
Yukon River Pilot Station,2007,0,,231,70983
Yukon River Pilot Station,2007,0,,232,70983
Yukon River Pilot Station,2007,0,,233,70983
Yukon River Pilot Station,2007,362,,234,71345
Yukon River Pilot Station,2007,305,,235,71650
Yukon River Pilot Station,2007,49,,236,71699
Yukon River Pilot Station,2008,1750,,171,1750
Yukon River Pilot Station,2008,0,,172,1750
Yukon River Pilot Station,2008,0,,173,1750
Yukon River Pilot Station,2008,0,,174,1750
Yukon River Pilot Station,2008,434,,175,2184
Yukon River Pilot Station,2008,583,,176,2767
Yukon River Pilot Station,2008,969,,177,3736
Yukon River Pilot Station,2008,1715,,178,5451
Yukon River Pilot Station,2008,1873,,179,7324
Yukon River Pilot Station,2008,2403,,180,9727
Yukon River Pilot Station,2008,4206,,181,13933
Yukon River Pilot Station,2008,60771,,182,74704
Yukon River Pilot Station,2008,65557,,183,140261
Yukon River Pilot Station,2008,54650,,184,194911
Yukon River Pilot Station,2008,64228,,185,259139
Yukon River Pilot Station,2008,44197,,186,303336
Yukon River Pilot Station,2008,15083,,187,318419
Yukon River Pilot Station,2008,17272,,188,335691
Yukon River Pilot Station,2008,7183,,189,342874
Yukon River Pilot Station,2008,13848,,190,356722
Yukon River Pilot Station,2008,9595,,191,366317
Yukon River Pilot Station,2008,6008,,192,372325
Yukon River Pilot Station,2008,9420,,193,381745
Yukon River Pilot Station,2008,12379,,194,394124
Yukon River Pilot Station,2008,12496,,195,406620
Yukon River Pilot Station,2008,4584,,196,411204
Yukon River Pilot Station,2008,5609,,197,416813
Yukon River Pilot Station,2008,13793,,198,430606
Yukon River Pilot Station,2008,10373,,199,440979
Yukon River Pilot Station,2008,10666,,200,451645
Yukon River Pilot Station,2008,8628,,201,460273
Yukon River Pilot Station,2008,8311,,202,468584
Yukon River Pilot Station,2008,10270,,203,478854
Yukon River Pilot Station,2008,4600,,204,483454
Yukon River Pilot Station,2008,4869,,205,488323
Yukon River Pilot Station,2008,6400,,206,494723
Yukon River Pilot Station,2008,13963,,207,508686
Yukon River Pilot Station,2008,3412,,208,512098
Yukon River Pilot Station,2008,5961,,209,518059
Yukon River Pilot Station,2008,6496,,210,524555
Yukon River Pilot Station,2008,9689,,211,534244
Yukon River Pilot Station,2008,2830,,212,537074
Yukon River Pilot Station,2008,1637,,213,538711
Yukon River Pilot Station,2008,3069,,214,541780
Yukon River Pilot Station,2008,4250,,215,546030
Yukon River Pilot Station,2008,2434,,216,548464
Yukon River Pilot Station,2008,1930,,217,550394
Yukon River Pilot Station,2008,622,,218,551016
Yukon River Pilot Station,2008,771,,219,551787
Yukon River Pilot Station,2008,906,,220,552693
Yukon River Pilot Station,2008,587,,221,553280
Yukon River Pilot Station,2008,524,,222,553804
Yukon River Pilot Station,2008,86,,223,553890
Yukon River Pilot Station,2008,819,,224,554709
Yukon River Pilot Station,2008,462,,225,555171
Yukon River Pilot Station,2008,210,,226,555381
Yukon River Pilot Station,2008,361,,227,555742
Yukon River Pilot Station,2008,81,,228,555823
Yukon River Pilot Station,2008,143,,229,555966
Yukon River Pilot Station,2008,0,,230,555966
Yukon River Pilot Station,2008,0,,231,555966
Yukon River Pilot Station,2008,1447,,232,557413
Yukon River Pilot Station,2008,0,,233,557413
Yukon River Pilot Station,2008,0,,234,557413
Yukon River Pilot Station,2008,110,,235,557523
Yukon River Pilot Station,2008,0,,236,557523
Yukon River Pilot Station,2008,0,,237,557523
Yukon River Pilot Station,2008,0,,238,557523
Yukon River Pilot Station,2008,0,,239,557523
Yukon River Pilot Station,2008,295,,240,557818
Yukon River Pilot Station,2008,0,,241,557818
Yukon River Pilot Station,2008,0,,242,557818
Yukon River Pilot Station,2008,0,,243,557818
Yukon River Pilot Station,2008,0,,244,557818
Yukon River Pilot Station,2008,0,,245,557818
Yukon River Pilot Station,2008,232,,246,558050
Yukon River Pilot Station,2009,0,,152,0
Yukon River Pilot Station,2009,0,,153,0
Yukon River Pilot Station,2009,0,,154,0
Yukon River Pilot Station,2009,0,,155,0
Yukon River Pilot Station,2009,0,,156,0
Yukon River Pilot Station,2009,0,,157,0
Yukon River Pilot Station,2009,0,,158,0
Yukon River Pilot Station,2009,0,,159,0
Yukon River Pilot Station,2009,0,,160,0
Yukon River Pilot Station,2009,0,,161,0
Yukon River Pilot Station,2009,0,,162,0
Yukon River Pilot Station,2009,0,,163,0
Yukon River Pilot Station,2009,0,,164,0
Yukon River Pilot Station,2009,0,,165,0
Yukon River Pilot Station,2009,0,,166,0
Yukon River Pilot Station,2009,0,,167,0
Yukon River Pilot Station,2009,0,,168,0
Yukon River Pilot Station,2009,0,,169,0
Yukon River Pilot Station,2009,0,,170,0
Yukon River Pilot Station,2009,0,,171,0
Yukon River Pilot Station,2009,0,,172,0
Yukon River Pilot Station,2009,0,,173,0
Yukon River Pilot Station,2009,0,,174,0
Yukon River Pilot Station,2009,0,,175,0
Yukon River Pilot Station,2009,0,,176,0
Yukon River Pilot Station,2009,0,,177,0
Yukon River Pilot Station,2009,0,,178,0
Yukon River Pilot Station,2009,0,,179,0
Yukon River Pilot Station,2009,0,,180,0
Yukon River Pilot Station,2009,0,,181,0
Yukon River Pilot Station,2009,0,,182,0
Yukon River Pilot Station,2009,0,,183,0
Yukon River Pilot Station,2009,0,,184,0
Yukon River Pilot Station,2009,0,,185,0
Yukon River Pilot Station,2009,0,,186,0
Yukon River Pilot Station,2009,299,,187,299
Yukon River Pilot Station,2009,201,,188,500
Yukon River Pilot Station,2009,569,,189,1069
Yukon River Pilot Station,2009,347,,190,1416
Yukon River Pilot Station,2009,0,,191,1416
Yukon River Pilot Station,2009,573,,192,1989
Yukon River Pilot Station,2009,256,,193,2245
Yukon River Pilot Station,2009,611,,194,2856
Yukon River Pilot Station,2009,321,,195,3177
Yukon River Pilot Station,2009,0,,196,3177
Yukon River Pilot Station,2009,507,,197,3684
Yukon River Pilot Station,2009,500,,198,4184
Yukon River Pilot Station,2009,0,,199,4184
Yukon River Pilot Station,2009,1001,,200,5185
Yukon River Pilot Station,2009,765,,201,5950
Yukon River Pilot Station,2009,585,,202,6535
Yukon River Pilot Station,2009,111,,203,6646
Yukon River Pilot Station,2009,2511,,204,9157
Yukon River Pilot Station,2009,206,,205,9363
Yukon River Pilot Station,2009,505,,206,9868
Yukon River Pilot Station,2009,952,,207,10820
Yukon River Pilot Station,2009,902,,208,11722
Yukon River Pilot Station,2009,3755,,209,15477
Yukon River Pilot Station,2009,1050,,210,16527
Yukon River Pilot Station,2009,0,,211,16527
Yukon River Pilot Station,2009,101,,212,16628
Yukon River Pilot Station,2009,730,,213,17358
Yukon River Pilot Station,2009,276,,214,17634
Yukon River Pilot Station,2009,259,,215,17893
Yukon River Pilot Station,2009,98,,216,17991
Yukon River Pilot Station,2009,0,,217,17991
Yukon River Pilot Station,2009,0,,218,17991
Yukon River Pilot Station,2009,0,,219,17991
Yukon River Pilot Station,2009,1814,,220,19805
Yukon River Pilot Station,2009,94,,221,19899
Yukon River Pilot Station,2009,0,,222,19899
Yukon River Pilot Station,2009,1762,,223,21661
Yukon River Pilot Station,2009,0,,224,21661
Yukon River Pilot Station,2009,0,,225,21661
Yukon River Pilot Station,2009,1858,,226,23519
Yukon River Pilot Station,2009,0,,227,23519
Yukon River Pilot Station,2009,0,,228,23519
Yukon River Pilot Station,2009,160,,229,23679
Yukon River Pilot Station,2009,0,,230,23679
Yukon River Pilot Station,2009,0,,231,23679
Yukon River Pilot Station,2009,0,,232,23679
Yukon River Pilot Station,2009,0,,233,23679
Yukon River Pilot Station,2009,0,,234,23679
Yukon River Pilot Station,2009,0,,235,23679
Yukon River Pilot Station,2009,0,,236,23679
Yukon River Pilot Station,2009,0,,237,23679
Yukon River Pilot Station,2009,0,,238,23679
Yukon River Pilot Station,2009,0,,239,23679
Yukon River Pilot Station,2009,0,,240,23679
Yukon River Pilot Station,2009,0,,241,23679
Yukon River Pilot Station,2009,0,,242,23679
Yukon River Pilot Station,2009,0,,243,23679
Yukon River Pilot Station,2009,0,,244,23679
Yukon River Pilot Station,2009,0,,245,23679
Yukon River Pilot Station,2009,0,,246,23679
Yukon River Pilot Station,2009,0,,247,23679
Yukon River Pilot Station,2009,0,,248,23679
Yukon River Pilot Station,2009,0,,249,23679
Yukon River Pilot Station,2009,0,,250,23679
Yukon River Pilot Station,2010,0,,152,0
Yukon River Pilot Station,2010,0,,153,0
Yukon River Pilot Station,2010,0,,154,0
Yukon River Pilot Station,2010,0,,155,0
Yukon River Pilot Station,2010,0,,156,0
Yukon River Pilot Station,2010,0,,157,0
Yukon River Pilot Station,2010,0,,158,0
Yukon River Pilot Station,2010,0,,159,0
Yukon River Pilot Station,2010,0,,160,0
Yukon River Pilot Station,2010,0,,161,0
Yukon River Pilot Station,2010,0,,162,0
Yukon River Pilot Station,2010,0,,163,0
Yukon River Pilot Station,2010,0,,164,0
Yukon River Pilot Station,2010,0,,165,0
Yukon River Pilot Station,2010,0,,166,0
Yukon River Pilot Station,2010,0,,167,0
Yukon River Pilot Station,2010,0,,168,0
Yukon River Pilot Station,2010,0,,169,0
Yukon River Pilot Station,2010,0,,170,0
Yukon River Pilot Station,2010,0,,171,0
Yukon River Pilot Station,2010,389,,172,389
Yukon River Pilot Station,2010,746,,173,1135
Yukon River Pilot Station,2010,806,,174,1941
Yukon River Pilot Station,2010,329,,175,2270
Yukon River Pilot Station,2010,4077,,176,6347
Yukon River Pilot Station,2010,6565,,177,12912
Yukon River Pilot Station,2010,7716,,178,20628
Yukon River Pilot Station,2010,3103,,179,23731
Yukon River Pilot Station,2010,14194,,180,37925
Yukon River Pilot Station,2010,9720,,181,47645
Yukon River Pilot Station,2010,5273,,182,52918
Yukon River Pilot Station,2010,16899,,183,69817
Yukon River Pilot Station,2010,11683,,184,81500
Yukon River Pilot Station,2010,17111,,185,98611
Yukon River Pilot Station,2010,11046,,186,109657
Yukon River Pilot Station,2010,16328,,187,125985
Yukon River Pilot Station,2010,17193,,188,143178
Yukon River Pilot Station,2010,23735,,189,166913
Yukon River Pilot Station,2010,20427,,190,187340
Yukon River Pilot Station,2010,11111,,191,198451
Yukon River Pilot Station,2010,11903,,192,210354
Yukon River Pilot Station,2010,12530,,193,222884
Yukon River Pilot Station,2010,20049,,194,242933
Yukon River Pilot Station,2010,26193,,195,269126
Yukon River Pilot Station,2010,52818,,196,321944
Yukon River Pilot Station,2010,55516,,197,377460
Yukon River Pilot Station,2010,53180,,198,430640
Yukon River Pilot Station,2010,45447,,199,476087
Yukon River Pilot Station,2010,26924,,200,503011
Yukon River Pilot Station,2010,45079,,201,548090
Yukon River Pilot Station,2010,43940,,202,592030
Yukon River Pilot Station,2010,18835,,203,610865
Yukon River Pilot Station,2010,20345,,204,631210
Yukon River Pilot Station,2010,23246,,205,654456
Yukon River Pilot Station,2010,23325,,206,677781
Yukon River Pilot Station,2010,8274,,207,686055
Yukon River Pilot Station,2010,10738,,208,696793
Yukon River Pilot Station,2010,9655,,209,706448
Yukon River Pilot Station,2010,9091,,210,715539
Yukon River Pilot Station,2010,8173,,211,723712
Yukon River Pilot Station,2010,6449,,212,730161
Yukon River Pilot Station,2010,4459,,213,734620
Yukon River Pilot Station,2010,2689,,214,737309
Yukon River Pilot Station,2010,2220,,215,739529
Yukon River Pilot Station,2010,2255,,216,741784
Yukon River Pilot Station,2010,1854,,217,743638
Yukon River Pilot Station,2010,1069,,218,744707
Yukon River Pilot Station,2010,78,,219,744785
Yukon River Pilot Station,2010,905,,220,745690
Yukon River Pilot Station,2010,176,,221,745866
Yukon River Pilot Station,2010,0,,222,745866
Yukon River Pilot Station,2010,0,,223,745866
Yukon River Pilot Station,2010,412,,224,746278
Yukon River Pilot Station,2010,0,,225,746278
Yukon River Pilot Station,2010,30,,226,746308
Yukon River Pilot Station,2010,30,,227,746338
Yukon River Pilot Station,2010,0,,228,746338
Yukon River Pilot Station,2010,0,,229,746338
Yukon River Pilot Station,2010,0,,230,746338
Yukon River Pilot Station,2010,0,,231,746338
Yukon River Pilot Station,2010,0,,232,746338
Yukon River Pilot Station,2010,0,,233,746338
Yukon River Pilot Station,2010,0,,234,746338
Yukon River Pilot Station,2010,0,,235,746338
Yukon River Pilot Station,2010,0,,236,746338
Yukon River Pilot Station,2010,0,,237,746338
Yukon River Pilot Station,2010,0,,238,746338
Yukon River Pilot Station,2010,0,,239,746338
Yukon River Pilot Station,2010,0,,240,746338
Yukon River Pilot Station,2010,0,,241,746338
Yukon River Pilot Station,2010,0,,242,746338
Yukon River Pilot Station,2010,0,,243,746338
Yukon River Pilot Station,2010,557,,244,746895
Yukon River Pilot Station,2010,402,,245,747297
Yukon River Pilot Station,2010,0,,246,747297
Yukon River Pilot Station,2010,0,,247,747297
Yukon River Pilot Station,2010,0,,248,747297
Yukon River Pilot Station,2010,0,,249,747297
Yukon River Pilot Station,2010,0,,250,747297
Yukon River Pilot Station,2011,0,,152,0
Yukon River Pilot Station,2011,0,,153,0
Yukon River Pilot Station,2011,0,,154,0
Yukon River Pilot Station,2011,0,,155,0
Yukon River Pilot Station,2011,0,,156,0
Yukon River Pilot Station,2011,0,,157,0
Yukon River Pilot Station,2011,0,,158,0
Yukon River Pilot Station,2011,0,,159,0
Yukon River Pilot Station,2011,0,,160,0
Yukon River Pilot Station,2011,0,,161,0
Yukon River Pilot Station,2011,0,,162,0
Yukon River Pilot Station,2011,0,,163,0
Yukon River Pilot Station,2011,0,,164,0
Yukon River Pilot Station,2011,0,,165,0
Yukon River Pilot Station,2011,0,,166,0
Yukon River Pilot Station,2011,0,,167,0
Yukon River Pilot Station,2011,0,,168,0
Yukon River Pilot Station,2011,0,,169,0
Yukon River Pilot Station,2011,0,,170,0
Yukon River Pilot Station,2011,0,,171,0
Yukon River Pilot Station,2011,0,,172,0
Yukon River Pilot Station,2011,0,,173,0
Yukon River Pilot Station,2011,0,,174,0
Yukon River Pilot Station,2011,0,,175,0
Yukon River Pilot Station,2011,0,,176,0
Yukon River Pilot Station,2011,0,,177,0
Yukon River Pilot Station,2011,0,,178,0
Yukon River Pilot Station,2011,0,,179,0
Yukon River Pilot Station,2011,0,,180,0
Yukon River Pilot Station,2011,0,,181,0
Yukon River Pilot Station,2011,0,,182,0
Yukon River Pilot Station,2011,0,,183,0
Yukon River Pilot Station,2011,0,,184,0
Yukon River Pilot Station,2011,0,,185,0
Yukon River Pilot Station,2011,0,,186,0
Yukon River Pilot Station,2011,0,,187,0
Yukon River Pilot Station,2011,0,,188,0
Yukon River Pilot Station,2011,0,,189,0
Yukon River Pilot Station,2011,0,,190,0
Yukon River Pilot Station,2011,189,,191,189
Yukon River Pilot Station,2011,138,,192,327
Yukon River Pilot Station,2011,192,,193,519
Yukon River Pilot Station,2011,121,,194,640
Yukon River Pilot Station,2011,0,,195,640
Yukon River Pilot Station,2011,0,,196,640
Yukon River Pilot Station,2011,0,,197,640
Yukon River Pilot Station,2011,0,,198,640
Yukon River Pilot Station,2011,0,,199,640
Yukon River Pilot Station,2011,438,,200,1078
Yukon River Pilot Station,2011,0,,201,1078
Yukon River Pilot Station,2011,0,,202,1078
Yukon River Pilot Station,2011,122,,203,1200
Yukon River Pilot Station,2011,473,,204,1673
Yukon River Pilot Station,2011,411,,205,2084
Yukon River Pilot Station,2011,403,,206,2487
Yukon River Pilot Station,2011,371,,207,2858
Yukon River Pilot Station,2011,0,,208,2858
Yukon River Pilot Station,2011,392,,209,3250
Yukon River Pilot Station,2011,0,,210,3250
Yukon River Pilot Station,2011,0,,211,3250
Yukon River Pilot Station,2011,292,,212,3542
Yukon River Pilot Station,2011,645,,213,4187
Yukon River Pilot Station,2011,810,,214,4997
Yukon River Pilot Station,2011,323,,215,5320
Yukon River Pilot Station,2011,0,,216,5320
Yukon River Pilot Station,2011,539,,217,5859
Yukon River Pilot Station,2011,79,,218,5938
Yukon River Pilot Station,2011,105,,219,6043
Yukon River Pilot Station,2011,0,,220,6043
Yukon River Pilot Station,2011,0,,221,6043
Yukon River Pilot Station,2011,0,,222,6043
Yukon River Pilot Station,2011,0,,223,6043
Yukon River Pilot Station,2011,190,,224,6233
Yukon River Pilot Station,2011,0,,225,6233
Yukon River Pilot Station,2011,0,,226,6233
Yukon River Pilot Station,2011,0,,227,6233
Yukon River Pilot Station,2011,0,,228,6233
Yukon River Pilot Station,2011,0,,229,6233
Yukon River Pilot Station,2011,0,,230,6233
Yukon River Pilot Station,2011,58,,231,6291
Yukon River Pilot Station,2011,0,,232,6291
Yukon River Pilot Station,2011,0,,233,6291
Yukon River Pilot Station,2011,0,,234,6291
Yukon River Pilot Station,2011,117,,235,6408
Yukon River Pilot Station,2011,118,,236,6526
Yukon River Pilot Station,2011,0,,237,6526
Yukon River Pilot Station,2011,0,,238,6526
Yukon River Pilot Station,2011,0,,239,6526
Yukon River Pilot Station,2011,0,,240,6526
Yukon River Pilot Station,2011,0,,241,6526
Yukon River Pilot Station,2011,0,,242,6526
Yukon River Pilot Station,2011,0,,243,6526
Yukon River Pilot Station,2011,0,,244,6526
Yukon River Pilot Station,2011,0,,245,6526
Yukon River Pilot Station,2011,0,,246,6526
Yukon River Pilot Station,2011,0,,247,6526
Yukon River Pilot Station,2011,0,,248,6526
Yukon River Pilot Station,2011,0,,249,6526
Yukon River Pilot Station,2011,0,,250,6526
Yukon River Pilot Station,2012,378,,173,378
Yukon River Pilot Station,2012,0,,174,378
Yukon River Pilot Station,2012,0,,175,378
Yukon River Pilot Station,2012,0,,176,378
Yukon River Pilot Station,2012,1928,,177,2306
Yukon River Pilot Station,2012,979,,178,3285
Yukon River Pilot Station,2012,2422,,179,5707
Yukon River Pilot Station,2012,3808,,180,9515
Yukon River Pilot Station,2012,4225,,181,13740
Yukon River Pilot Station,2012,3320,,182,17060
Yukon River Pilot Station,2012,4049,,183,21109
Yukon River Pilot Station,2012,5944,,184,27053
Yukon River Pilot Station,2012,26284,,185,53337
Yukon River Pilot Station,2012,9065,,186,62402
Yukon River Pilot Station,2012,26781,,187,89183
Yukon River Pilot Station,2012,11883,,188,101066
Yukon River Pilot Station,2012,31973,,189,133039
Yukon River Pilot Station,2012,14142,,190,147181
Yukon River Pilot Station,2012,5685,,191,152866
Yukon River Pilot Station,2012,9184,,192,162050
Yukon River Pilot Station,2012,19442,,193,181492
Yukon River Pilot Station,2012,8721,,194,190213
Yukon River Pilot Station,2012,10038,,195,200251
Yukon River Pilot Station,2012,9718,,196,209969
Yukon River Pilot Station,2012,7845,,197,217814
Yukon River Pilot Station,2012,9698,,198,227512
Yukon River Pilot Station,2012,9977,,199,237489
Yukon River Pilot Station,2012,7724,,200,245213
Yukon River Pilot Station,2012,5428,,201,250641
Yukon River Pilot Station,2012,11969,,202,262610
Yukon River Pilot Station,2012,9539,,203,272149
Yukon River Pilot Station,2012,6709,,204,278858
Yukon River Pilot Station,2012,7615,,205,286473
Yukon River Pilot Station,2012,3893,,206,290366
Yukon River Pilot Station,2012,3221,,207,293587
Yukon River Pilot Station,2012,4240,,208,297827
Yukon River Pilot Station,2012,5726,,209,303553
Yukon River Pilot Station,2012,9061,,210,312614
Yukon River Pilot Station,2012,11889,,211,324503
Yukon River Pilot Station,2012,6584,,212,331087
Yukon River Pilot Station,2012,5180,,213,336267
Yukon River Pilot Station,2012,4046,,214,340313
Yukon River Pilot Station,2012,4312,,215,344625
Yukon River Pilot Station,2012,1817,,216,346442
Yukon River Pilot Station,2012,2078,,217,348520
Yukon River Pilot Station,2012,1402,,218,349922
Yukon River Pilot Station,2012,426,,219,350348
Yukon River Pilot Station,2012,559,,220,350907
Yukon River Pilot Station,2012,201,,221,351108
Yukon River Pilot Station,2012,416,,222,351524
Yukon River Pilot Station,2012,290,,223,351814
Yukon River Pilot Station,2012,0,,224,351814
Yukon River Pilot Station,2012,414,,225,352228
Yukon River Pilot Station,2012,32,,226,352260
Yukon River Pilot Station,2012,50,,227,352310
Yukon River Pilot Station,2012,0,,228,352310
Yukon River Pilot Station,2012,0,,229,352310
Yukon River Pilot Station,2012,0,,230,352310
Yukon River Pilot Station,2012,0,,231,352310
Yukon River Pilot Station,2012,0,,232,352310
Yukon River Pilot Station,2012,0,,233,352310
Yukon River Pilot Station,2012,0,,234,352310
Yukon River Pilot Station,2012,0,,235,352310
Yukon River Pilot Station,2012,0,,236,352310
Yukon River Pilot Station,2012,0,,237,352310
Yukon River Pilot Station,2012,0,,238,352310
Yukon River Pilot Station,2012,0,,239,352310
Yukon River Pilot Station,2012,0,,240,352310
Yukon River Pilot Station,2012,0,,241,352310
Yukon River Pilot Station,2012,0,,242,352310
Yukon River Pilot Station,2012,0,,243,352310
Yukon River Pilot Station,2012,0,,247,352310
Afognak River (Litnik),2014,1,,197,1
Afognak River (Litnik),2014,16,,198,17
Afognak River (Litnik),2014,4,,199,21
Afognak River (Litnik),2014,1,,200,22
Afognak River (Litnik),2014,3,,201,25
Afognak River (Litnik),2014,0,,202,25
Afognak River (Litnik),2014,0,,203,25
Afognak River (Litnik),2014,2,,204,27
Afognak River (Litnik),2014,1,,205,28
Afognak River (Litnik),2014,13,,206,41
Afognak River (Litnik),2014,35,,207,76
Afognak River (Litnik),2014,9,,208,85
Afognak River (Litnik),2014,2,,209,87
Afognak River (Litnik),2014,8,,210,95
Afognak River (Litnik),2014,23,,211,118
Afognak River (Litnik),2014,7,,212,125
Afognak River (Litnik),2014,5,,213,130
Afognak River (Litnik),2014,5,,214,135
Afognak River (Litnik),2014,14,,215,149
Afognak River (Litnik),2014,118,,216,267
Afognak River (Litnik),2014,263,,217,530
Afognak River (Litnik),2014,8680,,218,9210
Afognak River (Litnik),2014,2800,,219,12010
Afognak River (Litnik),2014,1259,,220,13269
Afognak River (Litnik),2014,768,,221,14037
Afognak River (Litnik),2014,557,,222,14594
Afognak River (Litnik),2014,1051,,223,15645
Afognak River (Litnik),2014,105,,224,15750
Afognak River (Litnik),2014,187,,225,15937
Afognak River (Litnik),2014,213,,226,16150
Afognak River (Litnik),2014,76,,227,16226
Afognak River (Litnik),2014,46,,228,16272
Afognak River (Litnik),2014,172,,229,16444
Afognak River (Litnik),2014,555,,230,16999
Afognak River (Litnik),2014,561,,231,17560
Afognak River (Litnik),2014,139,,232,17699
Afognak River (Litnik),2014,216,,233,17915
Afognak River (Litnik),2014,580,,234,18495
Afognak River (Litnik),2013,1,,184,1
Afognak River (Litnik),2013,0,,185,1
Afognak River (Litnik),2013,0,,186,1
Afognak River (Litnik),2013,0,,187,1
Afognak River (Litnik),2013,0,,188,1
Afognak River (Litnik),2013,0,,190,1
Afognak River (Litnik),2013,0,,191,1
Afognak River (Litnik),2013,0,,192,1
Afognak River (Litnik),2013,0,,193,1
Afognak River (Litnik),2013,0,,194,1
Afognak River (Litnik),2013,0,,195,1
Afognak River (Litnik),2013,0,,196,1
Afognak River (Litnik),2013,0,,197,1
Afognak River (Litnik),2013,0,,198,1
Afognak River (Litnik),2013,0,,199,1
Afognak River (Litnik),2013,0,,200,1
Afognak River (Litnik),2013,0,,201,1
Afognak River (Litnik),2013,0,,202,1
Afognak River (Litnik),2013,0,,203,1
Afognak River (Litnik),2013,0,,205,1
Afognak River (Litnik),2013,0,,206,1
Afognak River (Litnik),2013,0,,207,1
Afognak River (Litnik),2013,0,,208,1
Afognak River (Litnik),2013,0,,209,1
Afognak River (Litnik),2013,0,,210,1
Afognak River (Litnik),2013,0,,211,1
Afognak River (Litnik),2013,0,,212,1
Afognak River (Litnik),2013,0,,213,1
Afognak River (Litnik),2013,2,,214,3
Afognak River (Litnik),2013,71,,215,74
Afognak River (Litnik),2013,19,,217,93
Afognak River (Litnik),2013,2808,,218,2901
Afognak River (Litnik),2013,1870,,219,4771
Afognak River (Litnik),2013,236,,220,5007
Afognak River (Litnik),2013,699,,221,5706
Afognak River (Litnik),2013,700,,222,6406
Afognak River (Litnik),2013,557,,223,6963
Afognak River (Litnik),2013,309,,224,7272
Afognak River (Litnik),2013,217,,225,7489
Afognak River (Litnik),2013,197,,226,7686
Afognak River (Litnik),2013,290,,227,7976
Afognak River (Litnik),2013,447,,228,8423
Afognak River (Litnik),2013,1077,,229,9500
Afognak River (Litnik),2013,1173,,230,10673
Afognak River (Litnik),2013,878,,231,11551
Afognak River (Litnik),2013,239,,232,11790
Afognak River (Litnik),2013,196,,233,11986
Afognak River (Litnik),2013,523,,234,12509
Afognak River (Litnik),2013,323,,235,12832
Afognak River (Litnik),2013,131,,236,12963
Afognak River (Litnik),2013,267,,237,13230
Afognak River (Litnik),2013,168,,238,13398
Ayakulik River,2014,5,,182,5
Ayakulik River,2014,4,,183,9
Ayakulik River,2014,6,,184,15
Ayakulik River,2014,20,,185,35
Ayakulik River,2014,13,,186,48
Ayakulik River,2014,117,,187,165
Ayakulik River,2014,58,,188,223
Ayakulik River,2014,351,,189,574
Ayakulik River,2014,1611,,190,2185
Ayakulik River,2014,2325,,191,4510
Ayakulik River,2014,466,,192,4976
Ayakulik River,2014,2001,,193,6977
Ayakulik River,2014,302,,194,7279
Ayakulik River,2014,2199,,195,9478
Ayakulik River,2014,1054,,196,10532
Ayakulik River,2014,152,,197,10684
Ayakulik River,2014,1961,,198,12645
Ayakulik River,2014,5582,,199,18227
Ayakulik River,2014,3472,,200,21699
Ayakulik River,2014,978,,201,22677
Ayakulik River,2014,2982,,202,25659
Ayakulik River,2014,16465,,203,42124
Ayakulik River,2014,9175,,204,51299
Ayakulik River,2014,28303,,205,79602
Ayakulik River,2014,8299,,206,87901
Ayakulik River,2014,20162,,207,108063
Ayakulik River,2014,25550,,208,133613
Ayakulik River,2014,53976,,209,187589
Ayakulik River,2014,9719,,210,197308
Ayakulik River,2014,15835,,211,213143
Ayakulik River,2014,9869,,212,223012
Ayakulik River,2014,18542,,213,241554
Ayakulik River,2014,18454,,214,260008
Ayakulik River,2014,27245,,215,287253
Ayakulik River,2014,27512,,216,314765
Ayakulik River,2014,17032,,217,331797
Ayakulik River,2014,21612,,218,353409
Ayakulik River,2014,18693,,219,372102
Ayakulik River,2014,12042,,220,384144
Ayakulik River,2014,18754,,221,402898
Ayakulik River,2014,20684,,222,423582
Ayakulik River,2014,9078,,223,432660
Ayakulik River,2014,8349,,224,441009
Ayakulik River,2014,2288,,225,443297
Ayakulik River,2014,2842,,226,446139
Ayakulik River,2014,31808,,227,477947
Ayakulik River,2014,5586,,228,483533
Ayakulik River,2014,4728,,229,488261
Ayakulik River,2014,6657,,230,494918
Ayakulik River,2014,8469,,231,503387
Ayakulik River,2014,3685,,232,507072
Ayakulik River,2014,4315,,233,511387
Ayakulik River,2014,2160,,234,513547
Ayakulik River,2014,4267,,235,517814
Ayakulik River,2014,4310,,236,522124
Ayakulik River,2014,1546,,237,523670
Ayakulik River,2014,1097,,238,524767
Ayakulik River,2014,972,,239,525739
Ayakulik River,2014,1164,,240,526903
Ayakulik River,2014,646,,241,527549
Ayakulik River,2014,479,,242,528028
Ayakulik River,2014,332,,243,528360
Ayakulik River,2014,369,,244,528729
Ayakulik River,2014,429,,245,529158
Ayakulik River,2014,394,,246,529552
Ayakulik River,2013,1,,175,1
Ayakulik River,2013,0,,176,1
Ayakulik River,2013,7,,177,8
Ayakulik River,2013,2,,178,10
Ayakulik River,2013,1,,179,11
Ayakulik River,2013,1,,180,12
Ayakulik River,2013,0,,181,12
Ayakulik River,2013,14,,182,26
Ayakulik River,2013,2,,183,28
Ayakulik River,2013,0,,184,28
Ayakulik River,2013,4,,185,32
Ayakulik River,2013,14,,186,46
Ayakulik River,2013,0,,187,46
Ayakulik River,2013,28,,188,74
Ayakulik River,2013,80,,189,154
Ayakulik River,2013,77,,190,231
Ayakulik River,2013,600,,191,831
Ayakulik River,2013,1566,,192,2397
Ayakulik River,2013,196,,193,2593
Ayakulik River,2013,422,,194,3015
Ayakulik River,2013,390,,195,3405
Ayakulik River,2013,69,,196,3474
Ayakulik River,2013,134,,197,3608
Ayakulik River,2013,0,,199,3608
Ayakulik River,2013,112,,200,3720
Ayakulik River,2013,570,,201,4290
Ayakulik River,2013,62,,202,4352
Ayakulik River,2013,48,,203,4400
Ayakulik River,2013,131,,204,4531
Ayakulik River,2013,371,,206,4902
Ayakulik River,2013,785,,207,5687
Ayakulik River,2013,362,,208,6049
Ayakulik River,2013,616,,209,6665
Ayakulik River,2013,836,,210,7501
Ayakulik River,2013,997,,211,8498
Ayakulik River,2013,465,,212,8963
Ayakulik River,2013,370,,213,9333
Ayakulik River,2013,64,,214,9397
Ayakulik River,2013,21,,215,9418
Ayakulik River,2013,513,,216,9931
Ayakulik River,2013,45,,217,9976
Ayakulik River,2013,905,,218,10881
Ayakulik River,2013,1500,estimates high water,219,12381
Ayakulik River,2013,0,no count high water,220,12381
Ayakulik River,2013,0,high water no count,221,12381
Ayakulik River,2013,222,no count high water,222,12603
Ayakulik River,2013,483,,223,13086
Ayakulik River,2013,436,sonar count,224,13522
Ayakulik River,2013,699,,225,14221
Ayakulik River,2013,183,,226,14404
Ayakulik River,2013,633,,227,15037
Ayakulik River,2013,407,,228,15444
Ayakulik River,2013,946,,229,16390
Ayakulik River,2013,2099,,230,18489
Ayakulik River,2013,431,,231,18920
Ayakulik River,2013,1351,,232,20271
Ayakulik River,2013,1601,,233,21872
Ayakulik River,2013,1421,,234,23293
Ayakulik River,2013,1539,,235,24832
Ayakulik River,2013,621,,236,25453
Ayakulik River,2013,1298,,237,26751
Ayakulik River,2013,1196,,238,27947
Ayakulik River,2013,1951,,239,29898
Ayakulik River,2013,1120,,240,31018
Ayakulik River,2013,1638,,241,32656
Ayakulik River,2013,1715,,242,34371
Ayakulik River,2013,929,,243,35300
Ayakulik River,2013,1182,,244,36482
Ayakulik River,2013,400,post weir estimates weir out,245,36882
Bear River,2014,2,,175,2
Bear River,2014,2,,176,4
Bear River,2014,2,,177,6
Bear River,2014,5,,178,11
Bear River,2014,4,,179,15
Bear River,2014,5,,180,20
Bear River,2014,17,,181,37
Bear River,2014,18,,182,55
Bear River,2014,19,,183,74
Bear River,2014,31,,184,105
Bear River,2014,33,,185,138
Bear River,2014,25,,186,163
Bear River,2014,27,,187,190
Bear River,2014,24,,188,214
Bear River,2014,49,,189,263
Bear River,2014,29,,190,292
Bear River,2014,26,,191,318
Bear River,2014,61,,192,379
Bear River,2014,71,,193,450
Bear River,2014,28,,194,478
Bear River,2014,24,,195,502
Bear River,2014,18,,196,520
Bear River,2014,16,,197,536
Bear River,2014,17,,198,553
Bear River,2014,14,,199,567
Bear River,2014,8,,200,575
Bear River,2014,18,,201,593
Bear River,2014,19,,202,612
Bear River,2014,16,,203,628
Bear River,2014,14,,204,642
Bear River,2014,7,,205,649
Bear River,2014,5,,206,654
Bear River,2014,22,,207,676
Bear River,2014,12,,208,688
Bear River,2014,21,,209,709
Bear River,2014,11,,210,720
Bear River,2014,1,,211,721
Bear River,2014,3,,212,724
Bear River,2014,11,,213,735
Bear River,2014,34,,214,769
Bear River,2014,36,,215,805
Bear River,2014,44,,216,849
Bear River,2014,43,,217,892
Bear River,2014,59,,218,951
Bear River,2014,38,,219,989
Bear River,2014,69,,220,1058
Bear River,2014,59,,221,1117
Bear River,2014,40,,222,1157
Bear River,2014,89,,223,1246
Bear River,2014,54,,224,1300
Bear River,2014,35,,225,1335
Bear River,2014,56,,226,1391
Bear River,2014,46,,227,1437
Bear River,2014,118,,228,1555
Bear River,2014,33,,229,1588
Bear River,2014,104,,230,1692
Bear River,2014,47,,231,1739
Bear River,2014,62,,232,1801
Bear River,2014,109,,233,1910
Bear River,2014,201,,234,2111
Bear River,2014,266,,235,2377
Bear River,2013,1,,185,1
Bear River,2013,4,,186,5
Bear River,2013,0,,187,5
Bear River,2013,0,,188,5
Bear River,2013,1,,189,6
Bear River,2013,1,,190,7
Bear River,2013,1,,191,8
Bear River,2013,2,,192,10
Bear River,2013,4,,193,14
Bear River,2013,8,,194,22
Bear River,2013,7,,195,29
Bear River,2013,16,,196,45
Bear River,2013,18,,197,63
Bear River,2013,4,,198,67
Bear River,2013,6,,199,73
Bear River,2013,10,,200,83
Bear River,2013,15,,201,98
Bear River,2013,9,,202,107
Bear River,2013,17,,203,124
Bear River,2013,13,,204,137
Bear River,2013,18,,205,155
Bear River,2013,41,,206,196
Bear River,2013,17,,207,213
Bear River,2013,35,,208,248
Bear River,2013,42,,209,290
Bear River,2013,42,,210,332
Bear River,2013,44,,211,376
Bear River,2013,36,,212,412
Bear River,2013,42,,213,454
Bear River,2013,71,,214,525
Bear River,2013,48,,215,573
Bear River,2013,62,,216,635
Bear River,2013,77,,217,712
Bear River,2013,33,,218,745
Bear River,2013,6,,219,751
Bear River,2013,8,,220,759
Bear River,2013,21,,221,780
Bear River,2013,12,,222,792
Bear River,2013,9,,223,801
Bear River,2013,6,,224,807
Bear River,2013,7,,225,814
Bear River,2013,10,,226,824
Bear River,2013,13,,227,837
Bear River,2013,10,,228,847
Bear River,2013,9,,229,856
Bear River,2013,7,,230,863
Bear River,2013,25,,231,888
Bear River,2013,14,,232,902
Bear River,2013,6,,233,908
Bear River,2013,3,,234,911
Bear River,2013,7,weir pulled,235,918
Buskin River,2014,8,,189,8
Buskin River,2014,5,,190,13
Buskin River,2014,5,,191,18
Buskin River,2014,6,,192,24
Buskin River,2014,7,,193,31
Buskin River,2014,1,,194,32
Buskin River,2014,24,,195,56
Buskin River,2014,19,,196,75
Buskin River,2014,178,,197,253
Buskin River,2014,71,,198,324
Buskin River,2014,32,,199,356
Buskin River,2014,31,,200,387
Buskin River,2014,137,,201,524
Buskin River,2014,7,,202,531
Buskin River,2014,30,,203,561
Buskin River,2014,10,,204,571
Buskin River,2014,15,,205,586
Buskin River,2014,6,,206,592
Buskin River,2014,7,,207,599
Buskin River,2014,123,,208,722
Buskin River,2014,2,,209,724
Buskin River,2014,5,,210,729
Buskin River,2014,49,,211,778
Buskin River,2014,8,,212,786
Buskin River,2014,8,,213,794
Buskin River,2014,14,,214,808
Buskin River,2014,1506,,215,2314
Buskin River,2014,438,,216,2752
Buskin River,2014,175,,217,2927
Buskin River,2014,116,,218,3043
Buskin River,2014,42,,219,3085
Buskin River,2014,59,,220,3144
Buskin River,2014,813,,221,3957
Buskin River,2014,391,,222,4348
Buskin River,2014,617,,223,4965
Buskin River,2014,579,,224,5544
Buskin River,2014,261,,225,5805
Buskin River,2014,42178,,226,47983
Buskin River,2014,5,,227,47988
Buskin River,2014,93,,228,48081
Buskin River,2014,38,,229,48119
Buskin River,2014,15,,230,48134
Buskin River,2014,16,,231,48150
Buskin River,2014,28,,232,48178
Buskin River,2014,3,,233,48181
Buskin River,2014,1,,234,48182
Buskin River,2014,7,,235,48189
Buskin River,2014,55,,236,48244
Buskin River,2014,21,,237,48265
Buskin River,2014,51,,238,48316
Buskin River,2014,109,,239,48425
Buskin River,2014,13,,240,48438
Buskin River,2014,17,,241,48455
Buskin River,2014,33,,242,48488
Buskin River,2014,22,,243,48510
Buskin River,2014,37,,244,48547
Buskin River,2014,19,,245,48566
Buskin River,2014,70,,246,48636
Buskin River,2014,203,,247,48839
Buskin River,2014,20,,248,48859
Buskin River,2014,18,,249,48877
Buskin River,2014,9,,250,48886
Buskin River,2014,13,,251,48899
Buskin River,2014,6,,252,48905
Buskin River,2014,3,,253,48908
Buskin River,2014,8,,254,48916
Buskin River,2014,1,,255,48917
Buskin River,2014,0,,256,48917
Buskin River,2014,0,,257,48917
Buskin River,2014,0,,258,48917
Buskin River,2014,0,,259,48917
Buskin River,2014,0,,260,48917
Buskin River,2014,0,,261,48917
Buskin River,2014,0,,262,48917
Buskin River,2014,0,,263,48917
Buskin River,2014,0,,264,48917
Buskin River,2014,0,,265,48917
Buskin River,2014,0,,266,48917
Buskin River,2014,0,,267,48917
Buskin River,2014,0,,268,48917
Buskin River,2014,0,,269,48917
Buskin River,2014,0,,270,48917
Buskin River,2014,0,,271,48917
Buskin River,2013,1,,188,1
Buskin River,2013,0,,189,1
Buskin River,2013,0,,190,1
Buskin River,2013,0,,191,1
Buskin River,2013,1,,192,2
Buskin River,2013,0,,193,2
Buskin River,2013,2,,194,4
Buskin River,2013,3,,195,7
Buskin River,2013,4,,196,11
Buskin River,2013,1,,197,12
Buskin River,2013,7,,198,19
Buskin River,2013,0,,199,19
Buskin River,2013,4,,200,23
Buskin River,2013,3,,201,26
Buskin River,2013,37,,202,63
Buskin River,2013,6,,203,69
Buskin River,2013,11,,204,80
Buskin River,2013,4,,205,84
Buskin River,2013,1,,206,85
Buskin River,2013,13,,207,98
Buskin River,2013,1,,208,99
Buskin River,2013,1,,209,100
Buskin River,2013,15,,210,115
Buskin River,2013,79,,211,194
Buskin River,2013,103,,212,297
Buskin River,2013,1498,,213,1795
Buskin River,2013,1239,,214,3034
Buskin River,2013,3897,,215,6931
Buskin River,2013,2428,,216,9359
Buskin River,2013,2651,,217,12010
Buskin River,2013,3304,,218,15314
Buskin River,2013,0,,219,15314
Buskin River,2013,491,,221,15805
Buskin River,2013,2193,,222,17998
Buskin River,2013,393,,223,18391
Buskin River,2013,2840,,224,21231
Buskin River,2013,68531,,225,89762
Buskin River,2013,895,,226,90657
Buskin River,2013,413,,227,91070
Buskin River,2013,385,,228,91455
Buskin River,2013,1001,,229,92456
Buskin River,2013,1507,,230,93963
Buskin River,2013,217,,231,94180
Buskin River,2013,390,,232,94570
Buskin River,2013,262,,233,94832
Buskin River,2013,494,,234,95326
Buskin River,2013,880,,235,96206
Buskin River,2013,708,,236,96914
Buskin River,2013,510,,237,97424
Buskin River,2013,573,,238,97997
Buskin River,2013,1278,,239,99275
Buskin River,2013,931,,240,100206
Buskin River,2013,1287,,241,101493
Buskin River,2013,0,no count high water,242,101493
Buskin River,2013,0,no count high water,243,101493
Buskin River,2013,429,,244,101922
Buskin River,2013,558,,245,102480
Buskin River,2013,184,,246,102664
Buskin River,2013,296,,247,102960
Buskin River,2013,359,,248,103319
Buskin River,2013,0,no count high water,249,103319
Buskin River,2013,0,no count high water,250,103319
Buskin River,2013,28,"estimate, high water",251,103347
Buskin River,2013,0,no count high water,252,103347
Buskin River,2013,0,no count high water,253,103347
Buskin River,2013,134,,254,103481
Buskin River,2013,142,,255,103623
Buskin River,2013,130,,256,103753
Buskin River,2013,66,,257,103819
Buskin River,2013,32,,258,103851
Buskin River,2013,12,,259,103863
Buskin River,2013,6,,260,103869
Buskin River,2013,7,,261,103876
Buskin River,2013,10,,262,103886
Buskin River,2013,9,,263,103895
Buskin River,2013,5,,264,103900
Buskin River,2013,7,,265,103907
Buskin River,2013,3,,266,103910
Buskin River,2013,1,,267,103911
Buskin River,2013,3,,268,103914
Buskin River,2013,2,,269,103916
Buskin River,2013,9,,270,103925
Buskin River,2013,0,,271,103925
Chignik River,2014,7,,181,7
Chignik River,2014,0,,182,7
Chignik River,2014,0,,183,7
Chignik River,2014,0,,184,7
Chignik River,2014,0,,185,7
Chignik River,2014,0,,186,7
Chignik River,2014,0,,187,7
Chignik River,2014,18,,188,25
Chignik River,2014,0,,189,25
Chignik River,2014,6,,190,31
Chignik River,2014,34,,191,65
Chignik River,2014,12,,192,77
Chignik River,2014,0,,193,77
Chignik River,2014,0,,194,77
Chignik River,2014,6,,195,83
Chignik River,2014,0,,196,83
Chignik River,2014,0,,197,83
Chignik River,2014,0,,198,83
Chignik River,2014,1,,199,84
Chignik River,2014,12,,200,96
Chignik River,2014,0,,201,96
Chignik River,2014,0,,202,96
Chignik River,2014,18,,203,114
Chignik River,2014,8,,204,122
Chignik River,2014,6,,205,128
Chignik River,2014,12,,206,140
Chignik River,2014,31,,207,171
Chignik River,2014,42,,208,213
Chignik River,2014,25,,209,238
Chignik River,2014,36,,210,274
Chignik River,2014,9,,211,283
Chignik River,2014,12,,212,295
Chignik River,2014,0,,213,295
Chignik River,2014,8,,214,303
Chignik River,2014,18,,215,321
Chignik River,2014,10,,216,331
Chignik River,2014,165,,217,496
Chignik River,2014,49,,218,545
Chignik River,2014,7,,219,552
Chignik River,2014,72,,220,624
Chignik River,2014,14,,221,638
Chignik River,2014,62,,222,700
Chignik River,2014,138,,223,838
Chignik River,2014,43,,224,881
Chignik River,2014,187,,225,1068
Chignik River,2014,204,,226,1272
Chignik River,2014,181,,227,1453
Chignik River,2014,214,,228,1667
Chignik River,2014,242,,229,1909
Chignik River,2014,103,,230,2012
Chignik River,2014,162,,231,2174
Chignik River,2014,278,,232,2452
Chignik River,2014,121,,233,2573
Chignik River,2014,94,,234,2667
Chignik River,2014,90,,235,2757
Chignik River,2014,56,,236,2813
Chignik River,2014,56,,237,2869
Chignik River,2014,67,,238,2936
Chignik River,2014,63,,239,2999
Chignik River,2014,45,,240,3044
Chignik River,2014,38,,241,3082
Chignik River,2014,18,,242,3100
Chignik River,2014,13,,243,3113
Chignik River,2014,24,,244,3137
Chignik River,2014,32,,245,3169
Chignik River,2014,2,,246,3171
Chignik River,2013,6,,187,6
Chignik River,2013,12,,188,18
Chignik River,2013,0,,189,18
Chignik River,2013,6,,190,24
Chignik River,2013,0,,191,24
Chignik River,2013,0,,192,24
Chignik River,2013,0,,193,24
Chignik River,2013,6,,194,30
Chignik River,2013,7,,195,37
Chignik River,2013,42,,196,79
Chignik River,2013,6,,197,85
Chignik River,2013,0,,198,85
Chignik River,2013,24,,199,109
Chignik River,2013,96,,200,205
Chignik River,2013,54,,201,259
Chignik River,2013,44,,202,303
Chignik River,2013,36,,203,339
Chignik River,2013,12,,204,351
Chignik River,2013,0,,205,351
Chignik River,2013,0,,206,351
Chignik River,2013,20,,207,371
Chignik River,2013,54,,208,425
Chignik River,2013,42,,209,467
Chignik River,2013,24,,210,491
Chignik River,2013,192,,211,683
Chignik River,2013,373,,212,1056
Chignik River,2013,426,,213,1482
Chignik River,2013,112,,214,1594
Chignik River,2013,247,,215,1841
Chignik River,2013,173,,216,2014
Chignik River,2013,172,,217,2186
Chignik River,2013,831,,218,3017
Chignik River,2013,433,,219,3450
Chignik River,2013,168,,220,3618
Chignik River,2013,162,,221,3780
Chignik River,2013,111,,222,3891
Chignik River,2013,162,,223,4053
Chignik River,2013,162,,224,4215
Chignik River,2013,204,,225,4419
Chignik River,2013,228,,226,4647
Chignik River,2013,192,,227,4839
Chignik River,2013,176,,228,5015
Chignik River,2013,211,,230,5226
Chignik River,2013,289,,231,5515
Chignik River,2013,122,,232,5637
Chignik River,2013,123,,233,5760
Chignik River,2013,57,,234,5817
Chignik River,2013,61,,235,5878
Chignik River,2013,48,,236,5926
Chignik River,2013,50,,237,5976
Chignik River,2013,90,,238,6066
Chignik River,2013,45,,239,6111
Chignik River,2013,126,,240,6237
Chignik River,2013,100,,241,6337
Chignik River,2013,150,,242,6487
Chignik River,2013,144,,243,6631
Chignik River,2013,156,,244,6787
Chignik River,2013,311,weir pulled,245,7098
Coghill River,2014,1,Began ASL sample #2. Passage is slowed during sampling.,182,1
Coghill River,2014,4,Continued ASL sample,183,5
Coghill River,2014,5,,184,10
Coghill River,2014,3,,185,13
Coghill River,2014,1,,186,14
Coghill River,2014,4,,187,18
Coghill River,2014,5,,189,23
Coghill River,2014,2,,190,25
Coghill River,2014,55,,191,80
Coghill River,2014,24,"2 jacks, 7 chum",192,104
Coghill River,2014,91,,195,195
Coghill River,2014,87,,196,282
Coghill River,2014,326,,197,608
Coghill River,2014,541,,198,1149
Coghill River,2014,473,,199,1622
Coghill River,2014,359,,200,1981
Coghill River,2014,111,,201,2092
Coghill River,2014,154,,202,2246
Coghill River,2014,170,,203,2416
Coghill River,2014,371,,204,2787
Coghill River,2014,430,,205,3217
Coghill River,2014,903,Last day of weir counts will be tomorrow,206,4120
Coghill River,2014,666,last day of counts for season,207,4786
Coghill River,2013,1,,178,1
Coghill River,2013,2,,179,3
Coghill River,2013,8,,180,11
Coghill River,2013,43,,181,54
Coghill River,2013,63,,182,117
Coghill River,2013,22,,183,139
Coghill River,2013,26,,184,165
Coghill River,2013,458,,185,623
Coghill River,2013,55,,186,678
Coghill River,2013,384,,187,1062
Coghill River,2013,2400,Weir pulled due to high water. Counts are estimated.,188,3462
Coghill River,2013,2244,Weir was pulled due to high water. These counts are estimated.,189,5706
Coghill River,2013,1251,,190,6957
Coghill River,2013,1923,,191,8880
Coghill River,2013,4616,,192,13496
Coghill River,2013,18046,,193,31542
Coghill River,2013,22984,,194,54526
Coghill River,2013,20118,,195,74644
Coghill River,2013,25253,,196,99897
Coghill River,2013,18434,,197,118331
Coghill River,2013,21530,,198,139861
Coghill River,2013,23472,,199,163333
Coghill River,2013,16398,,200,179731
Coghill River,2013,21353,,201,201084
Coghill River,2013,19219,Water level is very low in river,202,220303
Coghill River,2013,21900,,203,242203
Coghill River,2013,27496,,204,269699
Coghill River,2013,27270,,205,296969
Coghill River,2013,37975,,206,334944
Coghill River,2013,24894,,207,359838
Deshka,2014,0,,184,0
Deshka,2014,1,,185,1
Deshka,2014,0,,186,1
Deshka,2014,9,,187,10
Deshka,2014,21,,188,31
Deshka,2014,12,,189,43
Deshka,2014,6,,190,49
Deshka,2014,26,,191,75
Deshka,2014,68,,192,143
Deshka,2014,207,,193,350
Deshka,2014,156,,194,506
Deshka,2014,172,,195,678
Deshka,2014,564,,196,1242
Deshka,2014,3012,,197,4254
Deshka,2014,3100,,198,7354
Deshka,2014,6466,,199,13820
Deshka,2014,10630,,200,24450
Deshka,2014,4350,,201,28800
Deshka,2014,11144,,202,39944
Deshka,2014,3351,,203,43295
Deshka,2014,10275,,204,53570
Deshka,2014,7837,,205,61407
Deshka,2014,3686,,206,65093
Deshka,2014,3367,,207,68460
Deshka,2014,2976,,208,71436
Deshka,2014,1610,,209,73046
Deshka,2014,731,,210,73777
Deshka,2014,1650,,211,75427
Deshka,2014,642,,212,76069
Deshka,2014,107,,213,76176
Deshka,2014,482,,214,76658
Deshka,2014,240,,215,76898
Deshka,2014,144,,216,77042
Deshka,2014,194,,217,77236
Deshka,2014,192,,218,77428
Deshka,2014,152,,219,77580
Deshka,2014,134,,220,77714
Deshka,2014,79,,221,77793
Deshka,2014,73,,222,77866
Deshka,2014,31,,223,77897
Deshka,2014,15,,224,77912
Deshka,2014,14,,225,77926
Deshka,2014,41,,226,77967
Deshka,2014,19,,227,77986
Deshka,2014,17,,228,78003
Deshka,2014,34,,229,78037
Deshka,2014,11,,230,78048
Deshka,2014,19,,231,78067
Deshka,2014,12,,232,78079
Deshka,2014,3,,233,78082
Deshka,2014,2,,234,78084
Deshka,2014,3,,235,78087
Deshka,2014,1,,236,78088
Deshka,2014,2,,237,78090
Deshka,2014,1,,238,78091
Deshka,2014,3,,239,78094
Deshka,2014,8,,240,78102
Deshka,2014,9,,241,78111
Deshka,2014,0,,242,78111
Deshka,2014,0,,243,78111
Deshka,2014,0,,244,78111
Deshka,2014,0,,245,78111
Deshka,2013,12,,185,12
Deshka,2013,16,,186,28
Deshka,2013,10,,187,38
Deshka,2013,3,,188,41
Deshka,2013,0,,189,41
Deshka,2013,4,,190,45
Deshka,2013,8,,191,53
Deshka,2013,7,,192,60
Deshka,2013,10,,193,70
Deshka,2013,3,,194,73
Deshka,2013,9,,195,82
Deshka,2013,5,,196,87
Deshka,2013,13,,197,100
Deshka,2013,45,,198,145
Deshka,2013,553,,199,698
Deshka,2013,584,,200,1282
Deshka,2013,266,,201,1548
Deshka,2013,353,,202,1901
Deshka,2013,1842,,203,3743
Deshka,2013,1407,,204,5150
Deshka,2013,964,,205,6114
Deshka,2013,281,,206,6395
Deshka,2013,1537,,207,7932
Deshka,2013,1439,,208,9371
Deshka,2013,593,,209,9964
Deshka,2013,260,,210,10224
Deshka,2013,167,,211,10391
Deshka,2013,211,,212,10602
Deshka,2013,676,,213,11278
Deshka,2013,2017,,214,13295
Deshka,2013,4676,,215,17971
Deshka,2013,2792,,216,20763
Deshka,2013,1603,,217,22366
Deshka,2013,749,,218,23115
Deshka,2013,1384,,219,24499
Deshka,2013,320,,220,24819
Deshka,2013,446,,221,25265
Deshka,2013,155,,222,25420
Deshka,2013,393,,223,25813
Deshka,2013,1173,,224,26986
Deshka,2013,198,,225,27184
Deshka,2013,154,,226,27338
Deshka,2013,109,,227,27447
Deshka,2013,89,,228,27536
Deshka,2013,111,,229,27647
Deshka,2013,79,,230,27726
Deshka,2013,31,,231,27757
Deshka,2013,21,,232,27778
Deshka,2013,23,,233,27801
Deshka,2013,83,,234,27884
Deshka,2013,11,,235,27895
Deshka,2013,3,,236,27898
Deshka,2013,4,,237,27902
Deshka,2013,10,,238,27912
Deshka,2013,5,,239,27917
Deshka,2013,7,,240,27924
Deshka,2013,1,,241,27925
Deshka,2013,1,,242,27926
Deshka,2013,0,am temp 17.5,243,27926
Dog Salmon River,2014,4,,183,4
Dog Salmon River,2014,6,,184,10
Dog Salmon River,2014,1,,185,11
Dog Salmon River,2014,5,,186,16
Dog Salmon River,2014,9,,187,25
Dog Salmon River,2014,16,,188,41
Dog Salmon River,2014,24,,189,65
Dog Salmon River,2014,25,,190,90
Dog Salmon River,2014,17,,191,107
Dog Salmon River,2014,21,,192,128
Dog Salmon River,2014,30,,193,158
Dog Salmon River,2014,8,,194,166
Dog Salmon River,2014,57,,195,223
Dog Salmon River,2014,37,,196,260
Dog Salmon River,2014,37,,197,297
Dog Salmon River,2014,6,,198,303
Dog Salmon River,2014,21,,199,324
Dog Salmon River,2014,39,,200,363
Dog Salmon River,2014,108,,201,471
Dog Salmon River,2014,189,,202,660
Dog Salmon River,2014,128,,203,788
Dog Salmon River,2014,43,,204,831
Dog Salmon River,2014,22,,205,853
Dog Salmon River,2014,19,,206,872
Dog Salmon River,2014,52,,207,924
Dog Salmon River,2014,175,,208,1099
Dog Salmon River,2014,143,,209,1242
Dog Salmon River,2014,27,,210,1269
Dog Salmon River,2014,60,,211,1329
Dog Salmon River,2014,76,,212,1405
Dog Salmon River,2014,946,,213,2351
Dog Salmon River,2014,5944,,214,8295
Dog Salmon River,2014,2117,,215,10412
Dog Salmon River,2014,8721,,216,19133
Dog Salmon River,2014,7714,,217,26847
Dog Salmon River,2014,6096,,218,32943
Dog Salmon River,2014,14948,,219,47891
Dog Salmon River,2014,4123,,220,52014
Dog Salmon River,2014,1889,,221,53903
Dog Salmon River,2014,1928,,222,55831
Dog Salmon River,2014,1268,,223,57099
Dog Salmon River,2014,3990,,224,61089
Dog Salmon River,2014,3201,,225,64290
Dog Salmon River,2014,3558,,226,67848
Dog Salmon River,2014,3878,,227,71726
Dog Salmon River,2014,4125,,228,75851
Dog Salmon River,2014,6733,,229,82584
Dog Salmon River,2014,2768,,230,85352
Dog Salmon River,2013,7,,173,7
Dog Salmon River,2013,8,,174,15
Dog Salmon River,2013,24,,175,39
Dog Salmon River,2013,7,,176,46
Dog Salmon River,2013,5,,177,51
Dog Salmon River,2013,0,,178,51
Dog Salmon River,2013,12,,179,63
Dog Salmon River,2013,9,,180,72
Dog Salmon River,2013,0,,181,72
Dog Salmon River,2013,14,,182,86
Dog Salmon River,2013,1,,183,87
Dog Salmon River,2013,1,,184,88
Dog Salmon River,2013,3,,185,91
Dog Salmon River,2013,16,,186,107
Dog Salmon River,2013,130,,187,237
Dog Salmon River,2013,69,,188,306
Dog Salmon River,2013,401,,189,707
Dog Salmon River,2013,231,,190,938
Dog Salmon River,2013,723,,191,1661
Dog Salmon River,2013,561,,192,2222
Dog Salmon River,2013,821,,193,3043
Dog Salmon River,2013,244,,194,3287
Dog Salmon River,2013,1073,,195,4360
Dog Salmon River,2013,107,,196,4467
Dog Salmon River,2013,264,,197,4731
Dog Salmon River,2013,134,,199,4865
Dog Salmon River,2013,501,,200,5366
Dog Salmon River,2013,1299,,201,6665
Dog Salmon River,2013,1408,,202,8073
Dog Salmon River,2013,313,,203,8386
Dog Salmon River,2013,509,,204,8895
Dog Salmon River,2013,320,,205,9215
Dog Salmon River,2013,835,,207,10050
Dog Salmon River,2013,1725,,208,11775
Dog Salmon River,2013,1732,,209,13507
Dog Salmon River,2013,414,,210,13921
Dog Salmon River,2013,1322,,211,15243
Dog Salmon River,2013,789,,212,16032
Dog Salmon River,2013,1010,,213,17042
Dog Salmon River,2013,1231,,214,18273
Dog Salmon River,2013,1185,,215,19458
Dog Salmon River,2013,359,,216,19817
Dog Salmon River,2013,173,,217,19990
Dog Salmon River,2013,4530,,218,24520
Dog Salmon River,2013,116,,219,24636
Dog Salmon River,2013,5,,220,24641
Dog Salmon River,2013,632,,221,25273
Dog Salmon River,2013,512,,222,25785
Dog Salmon River,2013,329,,223,26114
Dog Salmon River,2013,139,,224,26253
Dog Salmon River,2013,168,,225,26421
Dog Salmon River,2013,40,,226,26461
Dog Salmon River,2013,162,,227,26623
Fish Creek,2014,12,,199,12
Fish Creek,2014,59,,200,71
Fish Creek,2014,202,,201,273
Fish Creek,2014,167,,202,440
Fish Creek,2014,381,,203,821
Fish Creek,2014,770,,204,1591
Fish Creek,2014,705,,205,2296
Fish Creek,2014,350,,206,2646
Fish Creek,2014,26,,207,2672
Fish Creek,2014,471,,208,3143
Fish Creek,2014,364,,209,3507
Fish Creek,2014,350,,210,3857
Fish Creek,2014,423,,211,4280
Fish Creek,2014,530,,212,4810
Fish Creek,2014,1197,,213,6007
Fish Creek,2014,321,,214,6328
Fish Creek,2014,888,,215,7216
Fish Creek,2014,368,,216,7584
Fish Creek,2014,138,,217,7722
Fish Creek,2014,172,,218,7894
Fish Creek,2014,150,,219,8044
Fish Creek,2014,72,,220,8116
Fish Creek,2014,66,,221,8182
Fish Creek,2014,135,,222,8317
Fish Creek,2014,134,,223,8451
Fish Creek,2014,75,,224,8526
Fish Creek,2014,114,,225,8640
Fish Creek,2014,98,,226,8738
Fish Creek,2014,118,,227,8856
Fish Creek,2014,82,,228,8938
Fish Creek,2014,20,,229,8958
Fish Creek,2014,96,,230,9054
Fish Creek,2014,36,,231,9090
Fish Creek,2014,33,,232,9123
Fish Creek,2014,18,,233,9141
Fish Creek,2014,21,,234,9162
Fish Creek,2014,6,,235,9168
Fish Creek,2014,1,,236,9169
Fish Creek,2014,13,,237,9182
Fish Creek,2014,4,,238,9186
Fish Creek,2014,7,,239,9193
Fish Creek,2014,2,,240,9195
Fish Creek,2014,2,,241,9197
Fish Creek,2014,0,,242,9197
Fish Creek,2014,0,,243,9197
Fish Creek,2014,1,,244,9198
Fish Creek,2014,0,,245,9198
Fish Creek,2014,0,,246,9198
Fish Creek,2014,0,,247,9198
Fish Creek,2014,0,,248,9198
Fish Creek,2014,0,,249,9198
Fish Creek,2014,0,,250,9198
Fish Creek,2014,0,,251,9198
Fish Creek,2014,0,,252,9198
Fish Creek,2014,0,,253,9198
Fish Creek,2014,0,,255,9198
Fish Creek,2014,0,,256,9198
Fish Creek,2014,0,,257,9198
Fish Creek,2014,0,,258,9198
Fish Creek,2014,0,,261,9198
Ilnik River,2014,3,,171,3
Ilnik River,2014,4,,172,7
Ilnik River,2014,3,,173,10
Ilnik River,2014,42,,174,52
Ilnik River,2014,17,,175,69
Ilnik River,2014,62,,176,131
Ilnik River,2014,2,,177,133
Ilnik River,2014,4,,178,137
Ilnik River,2014,2,,179,139
Ilnik River,2014,1,,180,140
Ilnik River,2014,18,,181,158
Ilnik River,2014,13,,182,171
Ilnik River,2014,8,,183,179
Ilnik River,2014,0,,184,179
Ilnik River,2014,1,,185,180
Ilnik River,2014,0,,186,180
Ilnik River,2014,4,,187,184
Ilnik River,2014,2,,188,186
Ilnik River,2014,1,,189,187
Ilnik River,2014,0,,190,187
Ilnik River,2014,4,,191,191
Ilnik River,2014,0,,192,191
Ilnik River,2013,5,,184,5
Ilnik River,2013,5,,185,10
Ilnik River,2013,25,,186,35
Ilnik River,2013,1,,187,36
Ilnik River,2013,0,,188,36
Ilnik River,2013,0,,189,36
Ilnik River,2013,2,,190,38
Ilnik River,2013,4,,191,42
Ilnik River,2013,4,,192,46
Ilnik River,2013,2,,193,48
Ilnik River,2013,0,,194,48
Ilnik River,2013,0,,195,48
Ilnik River,2013,0,weir pulled for season,196,48
Karluk River,2014,1,,174,1
Karluk River,2014,2,,175,3
Karluk River,2014,2,,176,5
Karluk River,2014,1,,177,6
Karluk River,2014,1,,178,7
Karluk River,2014,0,,179,7
Karluk River,2014,0,,180,7
Karluk River,2014,0,,181,7
Karluk River,2014,0,,182,7
Karluk River,2014,0,,183,7
Karluk River,2014,14,,188,21
Karluk River,2014,1,,189,22
Karluk River,2014,7,,190,29
Karluk River,2014,27,,191,56
Karluk River,2014,4,,192,60
Karluk River,2014,4,,193,64
Karluk River,2014,182,,194,246
Karluk River,2014,301,,195,547
Karluk River,2014,65,,196,612
Karluk River,2014,214,,197,826
Karluk River,2014,4,,198,830
Karluk River,2014,180,,199,1010
Karluk River,2014,12,,200,1022
Karluk River,2014,446,,201,1468
Karluk River,2014,262,,202,1730
Karluk River,2014,39,,203,1769
Karluk River,2014,97,,204,1866
Karluk River,2014,190,,205,2056
Karluk River,2014,555,,206,2611
Karluk River,2014,675,,207,3286
Karluk River,2014,3053,,208,6339
Karluk River,2014,16501,,209,22840
Karluk River,2014,22263,,210,45103
Karluk River,2014,4548,,211,49651
Karluk River,2014,10825,,212,60476
Karluk River,2014,17136,,213,77612
Karluk River,2014,20041,,214,97653
Karluk River,2014,16085,,215,113738
Karluk River,2014,37475,,216,151213
Karluk River,2014,54401,,217,205614
Karluk River,2014,37364,,218,242978
Karluk River,2014,30935,,219,273913
Karluk River,2014,113608,,220,387521
Karluk River,2014,56733,,221,444254
Karluk River,2014,17306,,222,461560
Karluk River,2014,16045,,223,477605
Karluk River,2014,9558,,224,487163
Karluk River,2014,8942,,225,496105
Karluk River,2014,8838,,226,504943
Karluk River,2014,12016,,227,516959
Karluk River,2014,7027,,228,523986
Karluk River,2014,6530,,229,530516
Karluk River,2014,2472,,230,532988
Karluk River,2014,2596,,231,535584
Karluk River,2014,978,,232,536562
Karluk River,2014,702,,233,537264
Karluk River,2014,1157,,234,538421
Karluk River,2014,1890,,235,540311
Karluk River,2014,11088,,236,551399
Karluk River,2014,4165,,237,555564
Karluk River,2014,3852,,238,559416
Karluk River,2014,5087,,239,564503
Karluk River,2014,9943,,240,574446
Karluk River,2014,2124,,241,576570
Karluk River,2014,764,,242,577334
Karluk River,2014,524,,243,577858
Karluk River,2014,1916,,244,579774
Karluk River,2014,4231,,245,584005
Karluk River,2014,466,,246,584471
Karluk River,2014,500,,247,584971
Karluk River,2014,249,,248,585220
Karluk River,2014,64,,249,585284
Karluk River,2014,74,,250,585358
Karluk River,2013,3,,186,3
Karluk River,2013,0,,187,3
Karluk River,2013,0,,188,3
Karluk River,2013,9,,189,12
Karluk River,2013,1,,190,13
Karluk River,2013,3,,191,16
Karluk River,2013,513,,192,529
Karluk River,2013,17,,193,546
Karluk River,2013,14,,194,560
Karluk River,2013,5,,195,565
Karluk River,2013,4,,196,569
Karluk River,2013,1,,197,570
Karluk River,2013,17,,198,587
Karluk River,2013,7,,199,594
Karluk River,2013,1,,200,595
Karluk River,2013,5,,201,600
Karluk River,2013,0,,202,600
Karluk River,2013,0,,203,600
Karluk River,2013,9,,204,609
Karluk River,2013,0,,205,609
Karluk River,2013,2,,206,611
Karluk River,2013,3,,207,614
Karluk River,2013,7,,208,621
Karluk River,2013,3,,209,624
Karluk River,2013,70,,210,694
Karluk River,2013,71,,211,765
Karluk River,2013,14,,212,779
Karluk River,2013,802,,213,1581
Karluk River,2013,674,,214,2255
Karluk River,2013,1290,,215,3545
Karluk River,2013,2091,,216,5636
Karluk River,2013,1633,,217,7269
Karluk River,2013,4484,,218,11753
Karluk River,2013,1399,,219,13152
Karluk River,2013,1313,,220,14465
Karluk River,2013,2915,,221,17380
Karluk River,2013,1327,,222,18707
Karluk River,2013,1225,,223,19932
Karluk River,2013,1806,,224,21738
Karluk River,2013,1405,,225,23143
Karluk River,2013,1216,,226,24359
Karluk River,2013,1580,,227,25939
Karluk River,2013,1911,,228,27850
Karluk River,2013,1631,,229,29481
Karluk River,2013,5415,,230,34896
Karluk River,2013,1938,,231,36834
Karluk River,2013,2160,,232,38994
Karluk River,2013,2135,,233,41129
Karluk River,2013,1950,,234,43079
Karluk River,2013,1644,,235,44723
Karluk River,2013,2130,,236,46853
Karluk River,2013,1205,,237,48058
Karluk River,2013,1171,,238,49229
Karluk River,2013,2125,,239,51354
Karluk River,2013,226,,240,51580
Karluk River,2013,1608,,241,53188
Karluk River,2013,1827,,242,55015
Karluk River,2013,869,,243,55884
Karluk River,2013,1727,,244,57611
Karluk River,2013,9793,,245,67404
Karluk River,2013,11542,,246,78946
Karluk River,2013,7243,,247,86189
Karluk River,2013,4106,,248,90295
Karluk River,2013,1997,,249,92292
Karluk River,2013,4910,,250,97202
Karluk River,2013,1572,,251,98774
Karluk River,2013,5303,,252,104077
Karluk River,2013,2020,,253,106097
Karluk River,2013,436,,254,106533
Karluk River,2013,96,,255,106629
Karluk River,2013,256,,256,106885
Karluk River,2013,0,"weir pulled, post weir estimate",257,106885
Little Susitna,2014,2,,184,2
Little Susitna,2014,0,,185,2
Little Susitna,2014,0,,186,2
Little Susitna,2014,0,,187,2
Little Susitna,2014,0,,188,2
Little Susitna,2014,0,,189,2
Little Susitna,2014,1,,190,3
Little Susitna,2014,0,,191,3
Little Susitna,2014,0,,192,3
Little Susitna,2014,0,,193,3
Little Susitna,2014,1,,194,4
Little Susitna,2014,15,,195,19
Little Susitna,2014,20,,196,39
Little Susitna,2014,51,,197,90
Little Susitna,2014,23,,198,113
Little Susitna,2014,42,,199,155
Little Susitna,2014,139,,200,294
Little Susitna,2014,666,,201,960
Little Susitna,2014,668,,202,1628
Little Susitna,2014,82,,203,1710
Little Susitna,2014,151,,204,1861
Little Susitna,2014,302,,205,2163
Little Susitna,2014,628,,206,2791
Little Susitna,2014,2317,,207,5108
Little Susitna,2014,1452,,208,6560
Little Susitna,2014,72,,209,6632
Little Susitna,2014,184,,210,6816
Little Susitna,2014,634,,211,7450
Little Susitna,2014,1697,,212,9147
Little Susitna,2014,1757,,213,10904
Little Susitna,2014,899,,214,11803
Little Susitna,2014,759,,215,12562
Little Susitna,2014,393,,216,12955
Little Susitna,2014,466,,217,13421
Little Susitna,2014,814,,218,14235
Little Susitna,2014,247,,219,14482
Little Susitna,2014,294,,220,14776
Little Susitna,2014,456,,221,15232
Little Susitna,2014,348,,222,15580
Little Susitna,2014,64,,223,15644
Little Susitna,2014,55,,224,15699
Little Susitna,2014,44,,225,15743
Little Susitna,2014,13,,226,15756
Little Susitna,2014,35,,227,15791
Little Susitna,2014,42,,228,15833
Little Susitna,2014,12,,229,15845
Little Susitna,2014,10,,230,15855
Little Susitna,2014,16,,231,15871
Little Susitna,2014,29,,232,15900
Little Susitna,2014,14,,233,15914
Little Susitna,2014,15,,234,15929
Little Susitna,2014,10,,235,15939
Little Susitna,2014,6,,236,15945
Little Susitna,2014,4,,237,15949
Little Susitna,2014,4,,238,15953
Little Susitna,2014,13,,239,15966
Little Susitna,2014,2,,240,15968
Little Susitna,2014,4,,241,15972
Little Susitna,2014,4,,242,15976
Little Susitna,2014,2,,243,15978
Little Susitna,2014,1,,244,15979
Little Susitna,2014,4,,245,15983
Little Susitna,2014,4,,246,15987
Little Susitna,2014,4,,247,15991
Little Susitna,2014,4,,248,15995
Little Susitna,2014,2,,249,15997
Little Susitna,2014,5,,250,16002
Little Susitna,2014,0,,251,16002
Little Susitna,2014,0,,252,16002
Little Susitna,2013,1,,183,1
Little Susitna,2013,0,,184,1
Little Susitna,2013,0,,185,1
Little Susitna,2013,0,,186,1
Little Susitna,2013,2,,187,3
Little Susitna,2013,1,,188,4
Little Susitna,2013,0,,189,4
Little Susitna,2013,0,,190,4
Little Susitna,2013,0,,191,4
Little Susitna,2013,8,,193,12
Little Susitna,2013,5,,194,17
Little Susitna,2013,5,,195,22
Little Susitna,2013,2,,196,24
Little Susitna,2013,0,,197,24
Little Susitna,2013,8,,198,32
Little Susitna,2013,5,,199,37
Little Susitna,2013,4,,200,41
Little Susitna,2013,9,,201,50
Little Susitna,2013,18,,202,68
Little Susitna,2013,31,,203,99
Little Susitna,2013,13,,204,112
Little Susitna,2013,50,,205,162
Little Susitna,2013,83,,206,245
Little Susitna,2013,48,,207,293
Little Susitna,2013,126,,208,419
Little Susitna,2013,33,,209,452
Little Susitna,2013,32,,210,484
Little Susitna,2013,41,,211,525
Little Susitna,2013,59,,212,584
Little Susitna,2013,167,,213,751
Little Susitna,2013,47,,214,798
Little Susitna,2013,41,,215,839
Little Susitna,2013,13,,216,852
Little Susitna,2013,13,,217,865
Little Susitna,2013,25,,218,890
Little Susitna,2013,57,,219,947
Little Susitna,2013,11,,220,958
Little Susitna,2013,27,,221,985
Little Susitna,2013,19,,222,1004
Little Susitna,2013,65,,223,1069
Little Susitna,2013,27,,224,1096
Little Susitna,2013,16,,225,1112
Little Susitna,2013,6,,226,1118
Little Susitna,2013,12,,227,1130
Little Susitna,2013,7,,228,1137
Little Susitna,2013,4,,229,1141
Little Susitna,2013,3,,230,1144
Little Susitna,2013,0,,231,1144
Little Susitna,2013,3,,232,1147
Little Susitna,2013,3,,233,1150
Little Susitna,2013,0,,234,1150
Little Susitna,2013,2,,235,1152
Little Susitna,2013,0,,236,1152
Little Susitna,2013,0,,237,1152
Little Susitna,2013,0,,238,1152
Little Susitna,2013,1,,239,1153
Little Susitna,2013,2,,240,1155
Little Susitna,2013,0,,241,1155
Little Susitna,2013,0,,242,1155
Nelson River (Sapsuk),2014,2,,171,2
Nelson River (Sapsuk),2014,0,,172,2
Nelson River (Sapsuk),2014,0,,173,2
Nelson River (Sapsuk),2014,0,,174,2
Nelson River (Sapsuk),2014,0,,175,2
Nelson River (Sapsuk),2014,0,,176,2
Nelson River (Sapsuk),2014,0,,178,2
Nelson River (Sapsuk),2014,0,,179,2
Nelson River (Sapsuk),2014,0,,180,2
Nelson River (Sapsuk),2014,0,,181,2
Nelson River (Sapsuk),2014,0,,182,2
Nelson River (Sapsuk),2014,0,,183,2
Nelson River (Sapsuk),2014,0,,184,2
Nelson River (Sapsuk),2014,0,,185,2
Nelson River (Sapsuk),2014,0,,186,2
Nelson River (Sapsuk),2014,0,,187,2
Nelson River (Sapsuk),2014,0,,188,2
Nelson River (Sapsuk),2014,0,,189,2
Nelson River (Sapsuk),2014,0,,190,2
Nelson River (Sapsuk),2014,0,,191,2
Nelson River (Sapsuk),2014,0,,195,2
Nelson River (Sapsuk),2014,4,,196,6
Nelson River (Sapsuk),2014,10,,197,16
Nelson River (Sapsuk),2014,18,,198,34
Nelson River (Sapsuk),2014,6,,199,40
Nelson River (Sapsuk),2014,24,,200,64
Nelson River (Sapsuk),2014,22,,201,86
Nelson River (Sapsuk),2014,33,,202,119
Nelson River (Sapsuk),2014,15,,203,134
Nelson River (Sapsuk),2014,0,,204,134
Nelson River (Sapsuk),2013,1,,179,1
Nelson River (Sapsuk),2013,0,,180,1
Nelson River (Sapsuk),2013,1,,181,2
Nelson River (Sapsuk),2013,0,,182,2
Nelson River (Sapsuk),2013,1,,183,3
Nelson River (Sapsuk),2013,0,,184,3
Nelson River (Sapsuk),2013,3,,185,6
Nelson River (Sapsuk),2013,0,,186,6
Nelson River (Sapsuk),2013,1,,187,7
Nelson River (Sapsuk),2013,1,,188,8
Nelson River (Sapsuk),2013,0,,189,8
Nelson River (Sapsuk),2013,0,,190,8
Nelson River (Sapsuk),2013,5,,191,13
Nelson River (Sapsuk),2013,4,,192,17
Nelson River (Sapsuk),2013,5,,193,22
Nelson River (Sapsuk),2013,1,,194,23
Nelson River (Sapsuk),2013,1,,195,24
Nelson River (Sapsuk),2013,1,,196,25
Nelson River (Sapsuk),2013,10,,197,35
Nelson River (Sapsuk),2013,10,,198,45
Nelson River (Sapsuk),2013,14,,199,59
Nelson River (Sapsuk),2013,2,,200,61
Nelson River (Sapsuk),2013,2,,201,63
Nelson River (Sapsuk),2013,5,,202,68
Nushagak River,2014,0,,199,0
Nushagak River,2014,0,,200,0
Nushagak River,2014,1165,,201,1165
Nushagak River,2014,6694,,202,7859
Nushagak River,2014,19469,,203,27328
Nushagak River,2014,67739,,204,95067
Nushagak River,2014,62923,,205,157990
Nushagak River,2014,62225,,206,220215
Nushagak River,2014,72475,,207,292690
Nushagak River,2014,153913,,208,446603
Nushagak River,2014,160138,,209,606741
Nushagak River,2014,205549,,210,812290
Nushagak River,2014,181192,,211,993482
Nushagak River,2014,255244,,212,1248726
Nushagak River,2014,181695,,213,1430421
Nushagak River,2014,165510,,214,1595931
Nushagak River,2014,163441,,215,1759372
Nushagak River,2014,114515,,216,1873887
Nushagak River,2014,101506,,217,1975393
Nushagak River,2014,52361,,218,2027754
Nushagak River,2014,68545,,219,2096299
Nushagak River,2014,12074,,220,2108373
Nushagak River,2014,31064,,221,2139437
Nushagak River,2014,40421,,222,2179858
Nushagak River,2014,22562,,223,2202420
Nushagak River,2014,25971,,224,2228391
Nushagak River,2014,17558,,225,2245949
Nushagak River,2014,13844,,226,2259793
Nushagak River,2014,13723,,227,2273516
Nushagak River,2014,8315,,228,2281831
Olga Creek (Upper Station),2014,1,,198,1
Olga Creek (Upper Station),2014,0,,199,1
Olga Creek (Upper Station),2014,0,,200,1
Olga Creek (Upper Station),2014,1,,201,2
Olga Creek (Upper Station),2014,0,,202,2
Olga Creek (Upper Station),2014,2,,203,4
Olga Creek (Upper Station),2014,2,,204,6
Olga Creek (Upper Station),2014,0,,205,6
Olga Creek (Upper Station),2014,2,,206,8
Olga Creek (Upper Station),2014,1,,207,9
Olga Creek (Upper Station),2014,0,,208,9
Olga Creek (Upper Station),2014,0,,209,9
Olga Creek (Upper Station),2014,0,,210,9
Olga Creek (Upper Station),2014,0,,211,9
Olga Creek (Upper Station),2014,0,,212,9
Olga Creek (Upper Station),2014,0,,213,9
Olga Creek (Upper Station),2014,0,,214,9
Olga Creek (Upper Station),2014,0,,215,9
Olga Creek (Upper Station),2014,4,,216,13
Olga Creek (Upper Station),2014,103,,217,116
Olga Creek (Upper Station),2014,87,,218,203
Olga Creek (Upper Station),2014,130,,219,333
Olga Creek (Upper Station),2014,368,,220,701
Olga Creek (Upper Station),2014,577,,221,1278
Olga Creek (Upper Station),2014,411,,222,1689
Olga Creek (Upper Station),2014,518,,223,2207
Olga Creek (Upper Station),2014,265,,224,2472
Olga Creek (Upper Station),2014,132,,225,2604
Olga Creek (Upper Station),2014,203,,226,2807
Olga Creek (Upper Station),2014,295,,227,3102
Olga Creek (Upper Station),2014,182,,228,3284
Olga Creek (Upper Station),2014,157,,229,3441
Olga Creek (Upper Station),2014,106,,230,3547
Olga Creek (Upper Station),2014,166,,231,3713
Olga Creek (Upper Station),2014,87,,232,3800
Olga Creek (Upper Station),2014,68,,233,3868
Olga Creek (Upper Station),2014,39,,234,3907
Olga Creek (Upper Station),2014,56,,235,3963
Olga Creek (Upper Station),2014,52,,236,4015
Olga Creek (Upper Station),2014,37,,237,4052
Olga Creek (Upper Station),2014,54,,238,4106
Olga Creek (Upper Station),2014,28,,239,4134
Olga Creek (Upper Station),2014,17,,240,4151
Olga Creek (Upper Station),2014,30,,241,4181
Olga Creek (Upper Station),2014,7,,242,4188
Olga Creek (Upper Station),2014,4,,243,4192
Olga Creek (Upper Station),2014,26,,244,4218
Olga Creek (Upper Station),2014,15,,245,4233
Olga Creek (Upper Station),2014,4,,246,4237
Olga Creek (Upper Station),2014,2,,247,4239
Olga Creek (Upper Station),2014,29,,248,4268
Olga Creek (Upper Station),2014,3,,249,4271
Olga Creek (Upper Station),2014,1,,250,4272
Olga Creek (Upper Station),2014,0,,251,4272
Olga Creek (Upper Station),2014,0,,252,4272
Olga Creek (Upper Station),2014,1,,253,4273
Olga Creek (Upper Station),2014,1,,254,4274
Olga Creek (Upper Station),2014,1,,255,4275
Olga Creek (Upper Station),2014,0,,256,4275
Olga Creek (Upper Station),2014,1,,257,4276
Olga Creek (Upper Station),2014,3,,258,4279
Olga Creek (Upper Station),2014,0,,259,4279
Olga Creek (Upper Station),2013,3,,183,3
Olga Creek (Upper Station),2013,1,,186,4
Olga Creek (Upper Station),2013,1,,187,5
Olga Creek (Upper Station),2013,0,,189,5
Olga Creek (Upper Station),2013,0,,190,5
Olga Creek (Upper Station),2013,1,,191,6
Olga Creek (Upper Station),2013,0,,192,6
Olga Creek (Upper Station),2013,1,,193,7
Olga Creek (Upper Station),2013,4,,194,11
Olga Creek (Upper Station),2013,0,,195,11
Olga Creek (Upper Station),2013,0,,196,11
Olga Creek (Upper Station),2013,1,,197,12
Olga Creek (Upper Station),2013,0,,198,12
Olga Creek (Upper Station),2013,2,,199,14
Olga Creek (Upper Station),2013,0,,200,14
Olga Creek (Upper Station),2013,0,,201,14
Olga Creek (Upper Station),2013,0,,202,14
Olga Creek (Upper Station),2013,2,,203,16
Olga Creek (Upper Station),2013,2,,204,18
Olga Creek (Upper Station),2013,1,,205,19
Olga Creek (Upper Station),2013,1,,206,20
Olga Creek (Upper Station),2013,5,,207,25
Olga Creek (Upper Station),2013,2,,208,27
Olga Creek (Upper Station),2013,12,,209,39
Olga Creek (Upper Station),2013,7,,210,46
Olga Creek (Upper Station),2013,6,,211,52
Olga Creek (Upper Station),2013,14,,212,66
Olga Creek (Upper Station),2013,6,,213,72
Olga Creek (Upper Station),2013,5,,214,77
Olga Creek (Upper Station),2013,5,,215,82
Olga Creek (Upper Station),2013,15,,216,97
Olga Creek (Upper Station),2013,20,,217,117
Olga Creek (Upper Station),2013,0,,218,117
Olga Creek (Upper Station),2013,2,,219,119
Olga Creek (Upper Station),2013,18,,220,137
Olga Creek (Upper Station),2013,503,,221,640
Olga Creek (Upper Station),2013,540,,222,1180
Olga Creek (Upper Station),2013,910,,223,2090
Olga Creek (Upper Station),2013,655,,224,2745
Olga Creek (Upper Station),2013,701,,225,3446
Olga Creek (Upper Station),2013,1146,,226,4592
Olga Creek (Upper Station),2013,809,,227,5401
Olga Creek (Upper Station),2013,1789,,228,7190
Olga Creek (Upper Station),2013,4915,,229,12105
Olga Creek (Upper Station),2013,3690,,230,15795
Olga Creek (Upper Station),2013,5338,,231,21133
Olga Creek (Upper Station),2013,5157,,232,26290
Olga Creek (Upper Station),2013,5401,,233,31691
Olga Creek (Upper Station),2013,6053,,234,37744
Olga Creek (Upper Station),2013,5508,,235,43252
Olga Creek (Upper Station),2013,3353,,236,46605
Olga Creek (Upper Station),2013,1483,,237,48088
Olga Creek (Upper Station),2013,4229,,238,52317
Olga Creek (Upper Station),2013,1529,,239,53846
Olga Creek (Upper Station),2013,2177,,240,56023
Olga Creek (Upper Station),2013,2348,,241,58371
Olga Creek (Upper Station),2013,2631,,242,61002
Olga Creek (Upper Station),2013,225,,243,61227
Olga Creek (Upper Station),2013,754,,244,61981
Olga Creek (Upper Station),2013,2724,,245,64705
Olga Creek (Upper Station),2013,863,,246,65568
Olga Creek (Upper Station),2013,868,,247,66436
Olga Creek (Upper Station),2013,491,,248,66927
Olga Creek (Upper Station),2013,532,,249,67459
Olga Creek (Upper Station),2013,384,,250,67843
Olga Creek (Upper Station),2013,281,,251,68124
Olga Creek (Upper Station),2013,401,,252,68525
Olga Creek (Upper Station),2013,399,,253,68924
Olga Creek (Upper Station),2013,238,,254,69162
Olga Creek (Upper Station),2013,250,"estimate, high water",255,69412
Olga Creek (Upper Station),2013,150,"weir pulled 9/13, post weir estimate",256,69562
Olga Creek (Upper Station),2013,150,post weir estimate,257,69712
Orzinski Lake,2014,1,,191,1
Orzinski Lake,2014,4,,192,5
Orzinski Lake,2014,0,,193,5
Orzinski Lake,2014,17,,194,22
Orzinski Lake,2014,23,,195,45
Orzinski Lake,2014,5,,196,50
Orzinski Lake,2014,26,,197,76
Orzinski Lake,2014,4,,198,80
Orzinski Lake,2014,2,,199,82
Orzinski Lake,2014,2,,200,84
Orzinski Lake,2014,5,,201,89
Orzinski Lake,2014,0,,202,89
Orzinski Lake,2014,1,,203,90
Orzinski Lake,2014,28,,204,118
Orzinski Lake,2014,32,,205,150
Orzinski Lake,2014,129,,206,279
Orzinski Lake,2014,67,,207,346
Orzinski Lake,2014,104,,208,450
Orzinski Lake,2014,428,,209,878
Orzinski Lake,2014,26,,210,904
Orzinski Lake,2014,3,,211,907
Orzinski Lake,2014,12,,212,919
Orzinski Lake,2014,2,,213,921
Orzinski Lake,2014,10,,214,931
Orzinski Lake,2014,17,,215,948
Orzinski Lake,2014,5,,216,953
Orzinski Lake,2014,321,,217,1274
Orzinski Lake,2014,67,,218,1341
Orzinski Lake,2014,4273,,219,5614
Orzinski Lake,2014,5601,,220,11215
Orzinski Lake,2014,1326,,221,12541
Orzinski Lake,2013,1,,187,1
Orzinski Lake,2013,0,,188,1
Orzinski Lake,2013,0,,189,1
Orzinski Lake,2013,0,,190,1
Orzinski Lake,2013,0,,191,1
Orzinski Lake,2013,0,,192,1
Orzinski Lake,2013,0,,193,1
Orzinski Lake,2013,0,,194,1
Orzinski Lake,2013,0,,195,1
Orzinski Lake,2013,0,,196,1
Orzinski Lake,2013,0,,197,1
Orzinski Lake,2013,0,,198,1
Orzinski Lake,2013,62,,199,63
Orzinski Lake,2013,4,,200,67
Orzinski Lake,2013,20,,201,87
Orzinski Lake,2013,2,,202,89
Orzinski Lake,2013,5,,203,94
Orzinski Lake,2013,0,,204,94
Orzinski Lake,2013,27,,205,121
Orzinski Lake,2013,2,,206,123
Orzinski Lake,2013,2,,207,125
Orzinski Lake,2013,1,,208,126
Orzinski Lake,2013,3,,209,129
Orzinski Lake,2013,0,,210,129
Orzinski Lake,2013,0,,211,129
Orzinski Lake,2013,651,,212,780
Orzinski Lake,2013,163,,213,943
Orzinski Lake,2013,228,,214,1171
Orzinski Lake,2013,1657,,215,2828
Orzinski Lake,2013,1668,,216,4496
Pasagshak,2014,5,,212,5
Pasagshak,2014,0,,213,5
Pasagshak,2014,0,,214,5
Pasagshak,2014,0,,215,5
Pasagshak,2014,0,,216,5
Pasagshak,2014,0,,217,5
Pasagshak,2014,1,,218,6
Pasagshak,2014,0,,219,6
Pasagshak,2014,8,,220,14
Pasagshak,2014,0,,221,14
Pasagshak,2014,0,,222,14
Pasagshak,2014,0,,223,14
Pasagshak,2014,0,,224,14
Pasagshak,2013,3,,188,3
Pasagshak,2013,3,,190,6
Pasagshak,2013,0,,191,6
Pasagshak,2013,5,,192,11
Pasagshak,2013,6,,193,17
Pasagshak,2013,6,,194,23
Pasagshak,2013,0,,195,23
Pasagshak,2013,0,,196,23
Pasagshak,2013,48,,197,71
Pasagshak,2013,0,,198,71
Pasagshak,2013,3,,199,74
Pasagshak,2013,0,,200,74
Pasagshak,2013,1,,201,75
Pasagshak,2013,6,,202,81
Pasagshak,2013,0,,203,81
Pasagshak,2013,2,,204,83
Pasagshak,2013,5,,205,88
Pasagshak,2013,2,,206,90
Pasagshak,2013,0,,207,90
Pasagshak,2013,2,,208,92
Pasagshak,2013,1,,209,93
Pasagshak,2013,2,,210,95
Pasagshak,2013,0,,211,95
Pasagshak,2013,0,,212,95
Pasagshak,2013,0,,213,95
Pasagshak,2013,0,,214,95
Pasagshak,2013,9,,215,104
Pasagshak,2013,0,,216,104
Pasagshak,2013,0,,217,104
Pasagshak,2013,0,"estimate, weir out",218,104
Pasagshak,2013,0,no count high water,221,104
Pasagshak,2013,0,no count high water,222,104
Pauls Bay River,2014,1,,192,1
Pauls Bay River,2014,0,,193,1
Pauls Bay River,2014,0,,194,1
Pauls Bay River,2014,0,,195,1
Pauls Bay River,2014,0,,196,1
Pauls Bay River,2014,0,,197,1
Pauls Bay River,2014,1,,198,2
Pauls Bay River,2014,0,,199,2
Pauls Bay River,2014,7,,200,9
Pauls Bay River,2014,5,,201,14
Pauls Bay River,2014,0,,202,14
Pauls Bay River,2014,1,,203,15
Pauls Bay River,2014,0,,204,15
Pauls Bay River,2014,12,,205,27
Pauls Bay River,2014,0,,206,27
Pauls Bay River,2014,0,,207,27
Pauls Bay River,2014,27,,208,54
Pauls Bay River,2014,1,,209,55
Pauls Bay River,2014,0,,210,55
Pauls Bay River,2014,0,,211,55
Pauls Bay River,2014,0,,212,55
Pauls Bay River,2014,0,,213,55
Pauls Bay River,2014,0,,214,55
Pauls Bay River,2014,0,,215,55
Pauls Bay River,2014,0,,216,55
Pauls Bay River,2014,13,,217,68
Pauls Bay River,2014,47,,218,115
Pauls Bay River,2014,0,,219,115
Pauls Bay River,2014,262,,220,377
Saltery Creek,2014,1,,185,1
Saltery Creek,2014,2,,186,3
Saltery Creek,2014,0,,187,3
Saltery Creek,2014,5,,188,8
Saltery Creek,2014,0,,189,8
Saltery Creek,2014,3,,190,11
Saltery Creek,2014,7,,191,18
Saltery Creek,2014,1,,192,19
Saltery Creek,2014,3,,193,22
Saltery Creek,2014,8,,194,30
Saltery Creek,2014,19,,195,49
Saltery Creek,2014,27,,196,76
Saltery Creek,2014,26,,197,102
Saltery Creek,2014,111,,198,213
Saltery Creek,2014,83,,199,296
Saltery Creek,2014,9,,200,305
Saltery Creek,2014,94,,201,399
Saltery Creek,2014,5,,202,404
Saltery Creek,2014,4,,203,408
Saltery Creek,2014,53,,204,461
Saltery Creek,2014,66,,205,527
Saltery Creek,2014,107,,206,634
Saltery Creek,2014,10,,207,644
Saltery Creek,2014,74,,208,718
Saltery Creek,2014,11,,209,729
Saltery Creek,2014,334,,210,1063
Saltery Creek,2014,139,,211,1202
Saltery Creek,2014,42,,212,1244
Saltery Creek,2014,33,,213,1277
Saltery Creek,2014,371,,214,1648
Saltery Creek,2014,97,,215,1745
Saltery Creek,2014,501,,216,2246
Saltery Creek,2014,1073,,217,3319
Saltery Creek,2014,1597,,218,4916
Saltery Creek,2014,316,,219,5232
Saltery Creek,2014,2119,,220,7351
Saltery Creek,2014,974,,221,8325
Saltery Creek,2013,1,,183,1
Saltery Creek,2013,0,,184,1
Saltery Creek,2013,0,,185,1
Saltery Creek,2013,3,,186,4
Saltery Creek,2013,3,,187,7
Saltery Creek,2013,3,,188,10
Saltery Creek,2013,5,,189,15
Saltery Creek,2013,6,,190,21
Saltery Creek,2013,6,,191,27
Saltery Creek,2013,8,,192,35
Saltery Creek,2013,13,,193,48
Saltery Creek,2013,31,,194,79
Saltery Creek,2013,30,,195,109
Saltery Creek,2013,38,,196,147
Saltery Creek,2013,61,,197,208
Saltery Creek,2013,52,,198,260
Saltery Creek,2013,91,,199,351
Saltery Creek,2013,119,,200,470
Saltery Creek,2013,59,,201,529
Saltery Creek,2013,71,,202,600
Saltery Creek,2013,79,,203,679
Saltery Creek,2013,86,,204,765
Saltery Creek,2013,199,,205,964
Saltery Creek,2013,199,,206,1163
Saltery Creek,2013,581,,207,1744
Saltery Creek,2013,581,,208,2325
Saltery Creek,2013,305,,209,2630
Saltery Creek,2013,573,,210,3203
Saltery Creek,2013,291,,211,3494
Saltery Creek,2013,245,,212,3739
Saltery Creek,2013,255,,213,3994
Saltery Creek,2013,1153,,214,5147
Saltery Creek,2013,2728,,215,7875
Saltery Creek,2013,906,,216,8781
Saltery Creek,2013,295,,217,9076
Saltery Creek,2013,0,weir closed for season,218,9076
Sandy River,2014,1,,176,1
Sandy River,2014,0,,177,1
Sandy River,2014,0,,178,1
Sandy River,2014,0,,179,1
Sandy River,2014,0,,180,1
Sandy River,2014,0,,181,1
Sandy River,2014,0,,182,1
Sandy River,2014,0,,183,1
Sandy River,2014,4,,184,5
Sandy River,2014,3,,185,8
Sandy River,2014,7,,186,15
Sandy River,2014,10,,187,25
Sandy River,2014,6,,188,31
Sandy River,2014,6,,189,37
Sandy River,2014,7,,190,44
Sandy River,2014,8,,191,52
Sandy River,2014,11,,192,63
Sandy River,2014,25,,193,88
Sandy River,2014,16,,194,104
Sandy River,2014,6,,195,110
Sandy River,2014,10,,196,120
Sandy River,2014,6,,197,126
Sandy River,2014,23,,198,149
Sandy River,2014,12,,199,161
Sandy River,2014,8,,200,169
Sandy River,2014,10,,201,179
Sandy River,2013,1,,188,1
Sandy River,2013,0,,189,1
Sandy River,2013,0,,190,1
Sandy River,2013,2,,191,3
Sandy River,2013,1,,192,4
Sandy River,2013,4,,193,8
Sandy River,2013,6,,194,14
Sandy River,2013,2,,195,16
Sandy River,2013,0,,196,16
Sandy River,2013,1,,197,17
Sandy River,2013,1,,198,18
Sandy River,2013,6,,199,24
Sandy River,2013,11,,200,35
Sandy River,2013,13,,201,48
Yukon River (Anvik River),2014,462,,177,462
Yukon River (Anvik River),2014,429,,178,891
Yukon River (Anvik River),2014,590,,179,1481
Yukon River (Anvik River),2014,1451,,180,2932
Yukon River (Anvik River),2014,1701,,181,4633
Yukon River (Anvik River),2014,3899,,182,8532
Yukon River (Anvik River),2014,2321,,183,10853
Yukon River (Anvik River),2014,5825,,184,16678
Yukon River (Anvik River),2014,12280,,185,28958
Yukon River (Anvik River),2014,11973,,186,40931
Yukon River (Anvik River),2014,21244,,187,62175
Yukon River (Anvik River),2014,16956,,188,79131
Yukon River (Anvik River),2014,17870,,189,97001
Yukon River (Anvik River),2014,26726,,190,123727
Yukon River (Anvik River),2014,30151,,191,153878
Yukon River (Anvik River),2014,53812,,192,207690
Yukon River (Anvik River),2014,64167,,193,271857
Yukon River (Anvik River),2014,73938,,194,345795
Yukon River (Anvik River),2014,75383,,195,421178
Yukon River (Anvik River),2014,54185,,196,475363
Yukon River (Anvik River),2014,42106,,197,517469
Yukon River (Anvik River),2014,51997,,198,569466
Yukon River (Anvik River),2014,45289,,199,614755
Yukon River (Anvik River),2014,48441,,200,663196
Yukon River (Anvik River),2014,39406,,201,702602
Yukon River (Anvik River),2014,52358,,202,754960
Yukon River (Anvik River),2014,71023,,203,825983
Yukon River (Anvik River),2014,46396,,204,872379
Yukon River (Anvik River),1976,0,,182,0
Yukon River (Anvik River),1976,0,,183,0
Yukon River (Anvik River),1976,0,,184,0
Yukon River (Anvik River),1976,0,,185,0
Yukon River (Anvik River),1976,0,,186,0
Yukon River (Anvik River),1976,5,,187,5
Yukon River (Anvik River),1976,5,,188,10
Yukon River (Anvik River),1976,22,,189,32
Yukon River (Anvik River),1976,13,,190,45
Yukon River (Anvik River),1976,18,,191,63
Yukon River (Anvik River),1976,33,,192,96
Yukon River (Anvik River),1976,35,,193,131
Yukon River (Anvik River),1976,23,,194,154
Yukon River (Anvik River),1976,100,,195,254
Yukon River (Anvik River),1976,39,,196,293
Yukon River (Anvik River),1976,22,,197,315
Yukon River (Anvik River),1976,28,,198,343
Yukon River (Anvik River),1976,44,,199,387
Yukon River (Anvik River),1976,18,,200,405
Yukon River (Anvik River),1976,16,,201,421
Yukon River (Anvik River),1976,33,,202,454
Yukon River (Anvik River),1976,12,,203,466
Yukon River (Anvik River),1976,23,,204,489
Yukon River (Anvik River),1976,11,,205,500
Yukon River (Anvik River),1976,3,,206,503
Yukon River (Anvik River),1976,4,,207,507
Yukon River (Anvik River),1976,9,,208,516
Yukon River (Anvik River),1976,3,,209,519
Yukon River (Anvik River),1976,0,,210,519
Yukon River (Anvik River),1975,0,,187,0
Yukon River (Anvik River),1975,0,,188,0
Yukon River (Anvik River),1975,0,,189,0
Yukon River (Anvik River),1975,0,,190,0
Yukon River (Anvik River),1975,0,,191,0
Yukon River (Anvik River),1975,5,,192,5
Yukon River (Anvik River),1975,36,,193,41
Yukon River (Anvik River),1975,117,,194,158
Yukon River (Anvik River),1975,136,,195,294
Yukon River (Anvik River),1975,119,,196,413
Yukon River (Anvik River),1975,119,,197,532
Yukon River (Anvik River),1975,101,,198,633
Yukon River (Anvik River),1975,103,,199,736
Yukon River (Anvik River),1975,177,,200,913
Yukon River (Anvik River),1975,133,,201,1046
Yukon River (Anvik River),1975,62,,202,1108
Yukon River (Anvik River),1975,78,,203,1186
Yukon River (Anvik River),1975,57,,204,1243
Yukon River (Anvik River),1975,59,,205,1302
Yukon River (Anvik River),1975,19,,206,1321
Yukon River (Anvik River),1975,39,,207,1360
Yukon River (Anvik River),1975,6,,208,1366
Yukon River (Anvik River),1973,2,,184,2
Yukon River (Anvik River),1973,4,,185,6
Yukon River (Anvik River),1973,2,,186,8
Yukon River (Anvik River),1973,6,,187,14
Yukon River (Anvik River),1973,1,,188,15
Yukon River (Anvik River),1973,14,,189,29
Yukon River (Anvik River),1973,20,,190,49
Yukon River (Anvik River),1973,26,,191,75
Yukon River (Anvik River),1973,49,,192,124
Yukon River (Anvik River),1973,30,,193,154
Yukon River (Anvik River),1973,35,,194,189
Yukon River (Anvik River),1973,14,,195,203
Yukon River (Anvik River),1973,17,,196,220
Yukon River (Anvik River),1973,17,,197,237
Yukon River (Anvik River),1973,18,,198,255
Yukon River (Anvik River),1973,6,,199,261
Yukon River (Anvik River),1973,8,,200,269
Yukon River (Anvik River),1973,-1,,201,268
Yukon River (Anvik River),1973,10,,202,278
Yukon River (Anvik River),1973,0,,203,278
Yukon River (Anvik River),1973,6,,204,284
Yukon River (Anvik River),1973,-3,,205,281
Yukon River (Anvik River),1973,NA,,206,NA
Yukon River (Anvik River),1973,NA,,207,NA
Yukon River (Anvik River),1973,NA,,208,NA
Yukon River (Anvik River),1973,NA,,209,NA
Yukon River (Anvik River),1973,NA,,210,NA
Yukon River (Anvik River),1973,NA,,211,NA
Yukon River (Anvik River),1973,5,,212,NA
Yukon River (Pilot Station),2013,0,,179,0
Yukon River (Pilot Station),2013,758,,180,758
Yukon River (Pilot Station),2013,0,,181,758
Yukon River (Pilot Station),2013,0,,182,758
Yukon River (Pilot Station),2013,930,,183,1688
Yukon River (Pilot Station),2013,0,,184,1688
Yukon River (Pilot Station),2013,0,,185,1688
Yukon River (Pilot Station),2013,0,,186,1688
Yukon River (Pilot Station),2013,0,,187,1688
Yukon River (Pilot Station),2013,0,,188,1688
Yukon River (Pilot Station),2013,0,,189,1688
Yukon River (Pilot Station),2013,0,,190,1688
Yukon River (Pilot Station),2013,0,,191,1688
Yukon River (Pilot Station),2013,0,,192,1688
Yukon River (Pilot Station),2013,495,,193,2183
Yukon River (Pilot Station),2013,163,,194,2346
Yukon River (Pilot Station),2013,109,,195,2455
Yukon River (Pilot Station),2013,254,,196,2709
Yukon River (Pilot Station),2013,0,,197,2709
Yukon River (Pilot Station),2013,0,,198,2709
Yukon River (Pilot Station),2013,0,,199,2709
Yukon River (Pilot Station),2013,0,,200,2709
Yukon River (Pilot Station),2013,74,,201,2783
Yukon River (Pilot Station),2013,62,,202,2845
Yukon River (Pilot Station),2013,115,,203,2960
Yukon River (Pilot Station),2013,0,,204,2960
Yukon River (Pilot Station),2013,0,,205,2960
Yukon River (Pilot Station),2013,0,,206,2960
Yukon River (Pilot Station),2013,0,,207,2960
Yukon River (Pilot Station),2013,0,,208,2960
Yukon River (Pilot Station),2013,0,,209,2960
Yukon River (Pilot Station),2013,0,,210,2960
Yukon River (Pilot Station),2013,1184,,211,4144
Yukon River (Pilot Station),2013,0,,212,4144
Yukon River (Pilot Station),2013,291,,213,4435
Yukon River (Pilot Station),2013,189,,214,4624
Yukon River (Pilot Station),2013,0,,215,4624
Yukon River (Pilot Station),2013,0,,216,4624
Yukon River (Pilot Station),2006,594,,173,594
Yukon River (Pilot Station),2006,433,,174,1027
Yukon River (Pilot Station),2006,302,,175,1329
Yukon River (Pilot Station),2006,1496,,176,2825
Yukon River (Pilot Station),2006,902,,177,3727
Yukon River (Pilot Station),2006,1010,,178,4737
Yukon River (Pilot Station),2006,702,,179,5439
Yukon River (Pilot Station),2006,2845,,180,8284
Yukon River (Pilot Station),2006,2573,,181,10857
Yukon River (Pilot Station),2006,4578,,182,15435
Yukon River (Pilot Station),2006,3546,,183,18981
Yukon River (Pilot Station),2006,6640,,184,25621
Yukon River (Pilot Station),2006,6186,,185,31807
Yukon River (Pilot Station),2006,6907,,186,38714
Yukon River (Pilot Station),2006,2172,,187,40886
Yukon River (Pilot Station),2006,786,,188,41672
Yukon River (Pilot Station),2006,1562,,189,43234
Yukon River (Pilot Station),2006,5378,,190,48612
Yukon River (Pilot Station),2006,5683,,191,54295
Yukon River (Pilot Station),2006,1504,,192,55799
Yukon River (Pilot Station),2006,1938,,193,57737
Yukon River (Pilot Station),2006,2842,,194,60579
Yukon River (Pilot Station),2006,2134,,195,62713
Yukon River (Pilot Station),2006,1628,,196,64341
Yukon River (Pilot Station),2006,2609,,197,66950
Yukon River (Pilot Station),2006,2901,,198,69851
Yukon River (Pilot Station),2006,5613,,199,75464
Yukon River (Pilot Station),2006,2482,,200,77946
Yukon River (Pilot Station),2006,3272,,201,81218
Yukon River (Pilot Station),2006,3562,,202,84780
Yukon River (Pilot Station),2006,1516,,203,86296
Yukon River (Pilot Station),2006,4220,,204,90516
Yukon River (Pilot Station),2006,2392,,205,92908
Yukon River (Pilot Station),2006,2771,,206,95679
Yukon River (Pilot Station),2006,1986,,207,97665
Yukon River (Pilot Station),2006,908,,208,98573
Yukon River (Pilot Station),2006,544,,209,99117
Yukon River (Pilot Station),2006,1920,,210,101037
Yukon River (Pilot Station),2006,1031,,211,102068
Yukon River (Pilot Station),2006,2202,,212,104270
Yukon River (Pilot Station),2006,1998,,213,106268
Yukon River (Pilot Station),2006,1682,,214,107950
Yukon River (Pilot Station),2006,307,,215,108257
Yukon River (Pilot Station),2006,2977,,216,111234
Yukon River (Pilot Station),2006,1053,,217,112287
Yukon River (Pilot Station),2006,440,,218,112727
Yukon River (Pilot Station),2006,493,,219,113220
Yukon River (Pilot Station),2006,751,,220,113971
Yukon River (Pilot Station),2006,560,,221,114531
Yukon River (Pilot Station),2006,454,,222,114985
Yukon River (Pilot Station),2006,64,,223,115049
Yukon River (Pilot Station),2006,59,,224,115108
Yukon River (Pilot Station),2006,381,,225,115489
Yukon River (Pilot Station),2006,0,,226,115489
Yukon River (Pilot Station),2006,0,,227,115489
Yukon River (Pilot Station),2006,12,,228,115501
Yukon River (Pilot Station),2006,9,,229,115510
Yukon River (Pilot Station),2006,17,,230,115527
Yukon River (Pilot Station),2006,97,,231,115624
Yukon River (Pilot Station),2004,134,,173,134
Yukon River (Pilot Station),2004,0,,174,134
Yukon River (Pilot Station),2004,107,,175,241
Yukon River (Pilot Station),2004,0,,176,241
Yukon River (Pilot Station),2004,227,,177,468
Yukon River (Pilot Station),2004,1391,,178,1859
Yukon River (Pilot Station),2004,1518,,179,3377
Yukon River (Pilot Station),2004,1585,,180,4962
Yukon River (Pilot Station),2004,1129,,181,6091
Yukon River (Pilot Station),2004,999,,182,7090
Yukon River (Pilot Station),2004,3756,,183,10846
Yukon River (Pilot Station),2004,2885,,184,13731
Yukon River (Pilot Station),2004,4299,,185,18030
Yukon River (Pilot Station),2004,5282,,186,23312
Yukon River (Pilot Station),2004,11491,,187,34803
Yukon River (Pilot Station),2004,5544,,188,40347
Yukon River (Pilot Station),2004,4299,,189,44646
Yukon River (Pilot Station),2004,12853,,190,57499
Yukon River (Pilot Station),2004,7310,,191,64809
Yukon River (Pilot Station),2004,8366,,192,73175
Yukon River (Pilot Station),2004,11291,,193,84466
Yukon River (Pilot Station),2004,7982,,194,92448
Yukon River (Pilot Station),2004,15032,,195,107480
Yukon River (Pilot Station),2004,10017,,196,117497
Yukon River (Pilot Station),2004,10715,,197,128212
Yukon River (Pilot Station),2004,6963,,198,135175
Yukon River (Pilot Station),2004,15667,,199,150842
Yukon River (Pilot Station),2004,14244,,200,165086
Yukon River (Pilot Station),2004,8599,,201,173685
Yukon River (Pilot Station),2004,11899,,202,185584
Yukon River (Pilot Station),2004,11643,,203,197227
Yukon River (Pilot Station),2004,4452,,204,201679
Yukon River (Pilot Station),2004,7121,,205,208800
Yukon River (Pilot Station),2004,2098,,206,210898
Yukon River (Pilot Station),2004,6154,,207,217052
Yukon River (Pilot Station),2004,4618,,208,221670
Yukon River (Pilot Station),2004,2988,,209,224658
Yukon River (Pilot Station),2004,2012,,210,226670
Yukon River (Pilot Station),2004,3699,,211,230369
Yukon River (Pilot Station),2004,2805,,212,233174
Yukon River (Pilot Station),2004,2149,,213,235323
Yukon River (Pilot Station),2004,528,,214,235851
Yukon River (Pilot Station),2004,0,,215,235851
Yukon River (Pilot Station),2004,698,,216,236549
Yukon River (Pilot Station),2004,347,,217,236896
Yukon River (Pilot Station),2004,2024,,218,238920
Yukon River (Pilot Station),2004,292,,219,239212
Yukon River (Pilot Station),2004,590,,220,239802
Yukon River (Pilot Station),2004,553,,221,240355
Yukon River (Pilot Station),2004,210,,222,240565
Yukon River (Pilot Station),2004,1201,,223,241766
Yukon River (Pilot Station),2004,1072,,224,242838
Yukon River (Pilot Station),2004,60,,225,242898
Yukon River (Pilot Station),2004,0,,226,242898
Yukon River (Pilot Station),2004,45,,227,242943
Yukon River (Pilot Station),2004,0,,228,242943
Yukon River (Pilot Station),2004,0,,229,242943
Yukon River (Pilot Station),2004,281,,230,243224
Yukon River (Pilot Station),2004,0,,231,243224
Yukon River (Pilot Station),2004,21,,232,243245
Yukon River (Pilot Station),2004,0,,233,243245
Yukon River (Pilot Station),2004,25,,234,243270
Yukon River (Pilot Station),2004,0,,235,243270
Yukon River (Pilot Station),2004,0,,236,243270
Yukon River (Pilot Station),2004,0,,237,243270
Yukon River (Pilot Station),2004,0,,238,243270
Yukon River (Pilot Station),2004,0,,239,243270
Yukon River (Pilot Station),2004,0,,240,243270
Yukon River (Pilot Station),2004,0,,241,243270
Yukon River (Pilot Station),2004,105,,242,243375
Yukon River (Pilot Station),2004,0,,243,243375
Yukon River (Pilot Station),2004,0,,244,243375
Yukon River (Pilot Station),2005,0,,148,0
Yukon River (Pilot Station),2005,0,,149,0
Yukon River (Pilot Station),2005,0,,150,0
Yukon River (Pilot Station),2005,0,,151,0
Yukon River (Pilot Station),2005,0,,152,0
Yukon River (Pilot Station),2005,0,,153,0
Yukon River (Pilot Station),2005,0,,154,0
Yukon River (Pilot Station),2005,0,,155,0
Yukon River (Pilot Station),2005,0,,156,0
Yukon River (Pilot Station),2005,0,,157,0
Yukon River (Pilot Station),2005,0,,158,0
Yukon River (Pilot Station),2005,0,,159,0
Yukon River (Pilot Station),2005,0,,160,0
Yukon River (Pilot Station),2005,0,,161,0
Yukon River (Pilot Station),2005,0,,162,0
Yukon River (Pilot Station),2005,0,,163,0
Yukon River (Pilot Station),2005,0,,164,0
Yukon River (Pilot Station),2005,0,,165,0
Yukon River (Pilot Station),2005,0,,166,0
Yukon River (Pilot Station),2005,0,,167,0
Yukon River (Pilot Station),2005,0,,168,0
Yukon River (Pilot Station),2005,0,,169,0
Yukon River (Pilot Station),2005,0,,170,0
Yukon River (Pilot Station),2005,0,,171,0
Yukon River (Pilot Station),2005,0,,172,0
Yukon River (Pilot Station),2005,0,,173,0
Yukon River (Pilot Station),2005,0,,174,0
Yukon River (Pilot Station),2005,0,,175,0
Yukon River (Pilot Station),2005,65,,176,65
Yukon River (Pilot Station),2005,64,,177,129
Yukon River (Pilot Station),2005,0,,178,129
Yukon River (Pilot Station),2005,0,,179,129
Yukon River (Pilot Station),2005,0,,180,129
Yukon River (Pilot Station),2005,443,,181,572
Yukon River (Pilot Station),2005,304,,182,876
Yukon River (Pilot Station),2005,216,,183,1092
Yukon River (Pilot Station),2005,0,,184,1092
Yukon River (Pilot Station),2005,0,,185,1092
Yukon River (Pilot Station),2005,695,,186,1787
Yukon River (Pilot Station),2005,0,,187,1787
Yukon River (Pilot Station),2005,0,,188,1787
Yukon River (Pilot Station),2005,679,,189,2466
Yukon River (Pilot Station),2005,874,,190,3340
Yukon River (Pilot Station),2005,770,,191,4110
Yukon River (Pilot Station),2005,417,,192,4527
Yukon River (Pilot Station),2005,770,,193,5297
Yukon River (Pilot Station),2005,1760,,194,7057
Yukon River (Pilot Station),2005,200,,195,7257
Yukon River (Pilot Station),2005,0,,196,7257
Yukon River (Pilot Station),2005,719,,197,7976
Yukon River (Pilot Station),2005,698,,198,8674
Yukon River (Pilot Station),2005,896,,199,9570
Yukon River (Pilot Station),2005,4093,,200,13663
Yukon River (Pilot Station),2005,0,,201,13663
Yukon River (Pilot Station),2005,771,,202,14434
Yukon River (Pilot Station),2005,1711,,203,16145
Yukon River (Pilot Station),2005,2696,,204,18841
Yukon River (Pilot Station),2005,787,,205,19628
Yukon River (Pilot Station),2005,1768,,206,21396
Yukon River (Pilot Station),2005,813,,207,22209
Yukon River (Pilot Station),2005,2502,,208,24711
Yukon River (Pilot Station),2005,3556,,209,28267
Yukon River (Pilot Station),2005,566,,210,28833
Yukon River (Pilot Station),2005,1826,,211,30659
Yukon River (Pilot Station),2005,2537,,212,33196
Yukon River (Pilot Station),2005,633,,213,33829
Yukon River (Pilot Station),2005,986,,214,34815
Yukon River (Pilot Station),2005,288,,215,35103
Yukon River (Pilot Station),2005,274,,216,35377
Yukon River (Pilot Station),2005,248,,217,35625
Yukon River (Pilot Station),2005,200,,218,35825
Yukon River (Pilot Station),2005,564,,219,36389
Yukon River (Pilot Station),2005,0,,220,36389
Yukon River (Pilot Station),2005,0,,221,36389
Yukon River (Pilot Station),2005,0,,222,36389
Yukon River (Pilot Station),2005,597,,223,36986
Yukon River (Pilot Station),2005,0,,224,36986
Yukon River (Pilot Station),2005,297,,225,37283
Yukon River (Pilot Station),2005,0,,226,37283
Yukon River (Pilot Station),2005,0,,227,37283
Yukon River (Pilot Station),2005,0,,228,37283
Yukon River (Pilot Station),2005,0,,229,37283
Yukon River (Pilot Station),2005,222,,230,37505
Yukon River (Pilot Station),2005,0,,231,37505
Yukon River (Pilot Station),2005,0,,232,37505
Yukon River (Pilot Station),2005,0,,233,37505
Yukon River (Pilot Station),2005,413,,234,37918
Yukon River (Pilot Station),2005,0,,235,37918
Yukon River (Pilot Station),2005,0,,236,37918
Yukon River (Pilot Station),2005,0,,237,37918
Yukon River (Pilot Station),2005,0,,238,37918
Yukon River (Pilot Station),2005,0,,239,37918
Yukon River (Pilot Station),2005,0,,240,37918
Yukon River (Pilot Station),2005,0,,241,37918
Yukon River (Pilot Station),2005,0,,242,37918
Yukon River (Pilot Station),2005,0,,243,37918
Yukon River (Pilot Station),2003,0,,126,0
Yukon River (Pilot Station),2003,0,,157,0
Yukon River (Pilot Station),2003,0,,158,0
Yukon River (Pilot Station),2003,0,,159,0
Yukon River (Pilot Station),2003,0,,160,0
Yukon River (Pilot Station),2003,0,,161,0
Yukon River (Pilot Station),2003,0,,162,0
Yukon River (Pilot Station),2003,0,,163,0
Yukon River (Pilot Station),2003,0,,164,0
Yukon River (Pilot Station),2003,0,,165,0
Yukon River (Pilot Station),2003,0,,166,0
Yukon River (Pilot Station),2003,0,,167,0
Yukon River (Pilot Station),2003,0,,168,0
Yukon River (Pilot Station),2003,0,,169,0
Yukon River (Pilot Station),2003,0,,170,0
Yukon River (Pilot Station),2003,0,,171,0
Yukon River (Pilot Station),2003,0,,172,0
Yukon River (Pilot Station),2003,0,,173,0
Yukon River (Pilot Station),2003,0,,174,0
Yukon River (Pilot Station),2003,0,,175,0
Yukon River (Pilot Station),2003,0,,176,0
Yukon River (Pilot Station),2003,0,,177,0
Yukon River (Pilot Station),2003,0,,178,0
Yukon River (Pilot Station),2003,0,,179,0
Yukon River (Pilot Station),2003,100,,180,100
Yukon River (Pilot Station),2003,0,,181,100
Yukon River (Pilot Station),2003,0,,182,100
Yukon River (Pilot Station),2003,519,,183,619
Yukon River (Pilot Station),2003,0,,184,619
Yukon River (Pilot Station),2003,0,,185,619
Yukon River (Pilot Station),2003,0,,186,619
Yukon River (Pilot Station),2003,54,,187,673
Yukon River (Pilot Station),2003,153,,188,826
Yukon River (Pilot Station),2003,0,,189,826
Yukon River (Pilot Station),2003,154,,190,980
Yukon River (Pilot Station),2003,181,,191,1161
Yukon River (Pilot Station),2003,173,,192,1334
Yukon River (Pilot Station),2003,447,,193,1781
Yukon River (Pilot Station),2003,67,,194,1848
Yukon River (Pilot Station),2003,823,,195,2671
Yukon River (Pilot Station),2003,201,,196,2872
Yukon River (Pilot Station),2003,106,,197,2978
Yukon River (Pilot Station),2003,0,,198,2978
Yukon River (Pilot Station),2003,0,,199,2978
Yukon River (Pilot Station),2003,0,,200,2978
Yukon River (Pilot Station),2003,68,,201,3046
Yukon River (Pilot Station),2003,100,,202,3146
Yukon River (Pilot Station),2003,675,,203,3821
Yukon River (Pilot Station),2003,0,,204,3821
Yukon River (Pilot Station),2003,177,,205,3998
Yukon River (Pilot Station),2003,0,,206,3998
Yukon River (Pilot Station),2003,0,,207,3998
Yukon River (Pilot Station),2003,0,,208,3998
Yukon River (Pilot Station),2003,0,,209,3998
Yukon River (Pilot Station),2003,0,,210,3998
Yukon River (Pilot Station),2003,118,,211,4116
Yukon River (Pilot Station),2003,0,,212,4116
Yukon River (Pilot Station),2003,0,,213,4116
Yukon River (Pilot Station),2003,0,,214,4116
Yukon River (Pilot Station),2003,214,,215,4330
Yukon River (Pilot Station),2003,141,,216,4471
Yukon River (Pilot Station),2003,0,,217,4471
Yukon River (Pilot Station),2003,0,,218,4471
Yukon River (Pilot Station),2003,102,,219,4573
Yukon River (Pilot Station),2003,83,,220,4656
Yukon River (Pilot Station),2003,0,,221,4656
Yukon River (Pilot Station),2003,0,,222,4656
Yukon River (Pilot Station),2003,0,,223,4656
Yukon River (Pilot Station),2003,0,,224,4656
Yukon River (Pilot Station),2003,0,,225,4656
Yukon River (Pilot Station),2003,0,,226,4656
Yukon River (Pilot Station),2003,0,,227,4656
Yukon River (Pilot Station),2003,0,,228,4656
Yukon River (Pilot Station),2003,0,,229,4656
Yukon River (Pilot Station),2003,0,,230,4656
Yukon River (Pilot Station),2003,0,,231,4656
Yukon River (Pilot Station),2003,0,,232,4656
Yukon River (Pilot Station),2003,0,,233,4656
Yukon River (Pilot Station),2003,0,,234,4656
Yukon River (Pilot Station),2003,0,,235,4656
Yukon River (Pilot Station),2003,0,,236,4656
Yukon River (Pilot Station),2003,0,,237,4656
Yukon River (Pilot Station),2003,0,,238,4656
Yukon River (Pilot Station),2003,0,,239,4656
Yukon River (Pilot Station),2003,0,,240,4656
Yukon River (Pilot Station),2003,0,,241,4656
Yukon River (Pilot Station),2003,0,,242,4656
Yukon River (Pilot Station),2003,0,,243,4656
Yukon River (Pilot Station),2002,0,,157,0
Yukon River (Pilot Station),2002,0,,158,0
Yukon River (Pilot Station),2002,0,,159,0
Yukon River (Pilot Station),2002,0,,160,0
Yukon River (Pilot Station),2002,0,,161,0
Yukon River (Pilot Station),2002,0,,162,0
Yukon River (Pilot Station),2002,0,,163,0
Yukon River (Pilot Station),2002,0,,164,0
Yukon River (Pilot Station),2002,0,,165,0
Yukon River (Pilot Station),2002,0,,166,0
Yukon River (Pilot Station),2002,0,,167,0
Yukon River (Pilot Station),2002,0,,168,0
Yukon River (Pilot Station),2002,0,,169,0
Yukon River (Pilot Station),2002,0,,170,0
Yukon River (Pilot Station),2002,285,,171,285
Yukon River (Pilot Station),2002,803,,172,1088
Yukon River (Pilot Station),2002,147,,173,1235
Yukon River (Pilot Station),2002,683,,174,1918
Yukon River (Pilot Station),2002,898,,175,2816
Yukon River (Pilot Station),2002,2778,,176,5594
Yukon River (Pilot Station),2002,3831,,177,9425
Yukon River (Pilot Station),2002,3889,,178,13314
Yukon River (Pilot Station),2002,1892,,179,15206
Yukon River (Pilot Station),2002,3304,,180,18510
Yukon River (Pilot Station),2002,1908,,181,20418
Yukon River (Pilot Station),2002,842,,182,21260
Yukon River (Pilot Station),2002,1256,,183,22516
Yukon River (Pilot Station),2002,710,,184,23226
Yukon River (Pilot Station),2002,4174,,185,27400
Yukon River (Pilot Station),2002,657,,186,28057
Yukon River (Pilot Station),2002,1488,,187,29545
Yukon River (Pilot Station),2002,2895,,188,32440
Yukon River (Pilot Station),2002,1415,,189,33855
Yukon River (Pilot Station),2002,3260,,190,37115
Yukon River (Pilot Station),2002,3669,,191,40784
Yukon River (Pilot Station),2002,1517,,192,42301
Yukon River (Pilot Station),2002,1525,,193,43826
Yukon River (Pilot Station),2002,3385,,194,47211
Yukon River (Pilot Station),2002,1785,,195,48996
Yukon River (Pilot Station),2002,1753,,196,50749
Yukon River (Pilot Station),2002,1648,,197,52397
Yukon River (Pilot Station),2002,1790,,198,54187
Yukon River (Pilot Station),2002,2137,,199,56324
Yukon River (Pilot Station),2002,2387,,200,58711
Yukon River (Pilot Station),2002,560,,201,59271
Yukon River (Pilot Station),2002,1216,,202,60487
Yukon River (Pilot Station),2002,320,,203,60807
Yukon River (Pilot Station),2002,153,,204,60960
Yukon River (Pilot Station),2002,326,,205,61286
Yukon River (Pilot Station),2002,132,,206,61418
Yukon River (Pilot Station),2002,808,,207,62226
Yukon River (Pilot Station),2002,368,,208,62594
Yukon River (Pilot Station),2002,90,,209,62684
Yukon River (Pilot Station),2002,1073,,210,63757
Yukon River (Pilot Station),2002,0,,211,63757
Yukon River (Pilot Station),2002,0,,212,63757
Yukon River (Pilot Station),2002,695,,213,64452
Yukon River (Pilot Station),2002,26,,214,64478
Yukon River (Pilot Station),2002,0,,215,64478
Yukon River (Pilot Station),2002,33,,216,64511
Yukon River (Pilot Station),2002,0,,217,64511
Yukon River (Pilot Station),2002,18,,218,64529
Yukon River (Pilot Station),2002,49,,219,64578
Yukon River (Pilot Station),2002,104,,220,64682
Yukon River (Pilot Station),2002,0,,221,64682
Yukon River (Pilot Station),2002,48,,222,64730
Yukon River (Pilot Station),2002,0,,223,64730
Yukon River (Pilot Station),2002,0,,224,64730
Yukon River (Pilot Station),2002,101,,225,64831
Yukon River (Pilot Station),2002,0,,226,64831
Yukon River (Pilot Station),2002,60,,227,64891
Yukon River (Pilot Station),2002,0,,228,64891
Yukon River (Pilot Station),2002,0,,229,64891
Yukon River (Pilot Station),2002,0,,230,64891
Yukon River (Pilot Station),2002,0,,231,64891
Yukon River (Pilot Station),2002,0,,232,64891
Yukon River (Pilot Station),2002,0,,233,64891
Yukon River (Pilot Station),2002,0,,234,64891
Yukon River (Pilot Station),2002,0,,235,64891
Yukon River (Pilot Station),2002,0,,236,64891
Yukon River (Pilot Station),2002,0,,237,64891
Yukon River (Pilot Station),2002,0,,238,64891
Yukon River (Pilot Station),2002,0,,239,64891
Yukon River (Pilot Station),2002,0,,240,64891
Yukon River (Pilot Station),2002,0,,241,64891
Yukon River (Pilot Station),2002,0,,242,64891
Yukon River (Pilot Station),2002,0,,243,64891
Yukon River (Pilot Station),2001,0,,162,0
Yukon River (Pilot Station),2001,0,,163,0
Yukon River (Pilot Station),2001,0,,164,0
Yukon River (Pilot Station),2001,0,,165,0
Yukon River (Pilot Station),2001,0,,166,0
Yukon River (Pilot Station),2001,0,,167,0
Yukon River (Pilot Station),2001,0,,168,0
Yukon River (Pilot Station),2001,0,,169,0
Yukon River (Pilot Station),2001,0,,170,0
Yukon River (Pilot Station),2001,0,,171,0
Yukon River (Pilot Station),2001,0,,172,0
Yukon River (Pilot Station),2001,0,,173,0
Yukon River (Pilot Station),2001,0,,174,0
Yukon River (Pilot Station),2001,0,,175,0
Yukon River (Pilot Station),2001,0,,176,0
Yukon River (Pilot Station),2001,0,,177,0
Yukon River (Pilot Station),2001,0,,178,0
Yukon River (Pilot Station),2001,0,,179,0
Yukon River (Pilot Station),2001,0,,180,0
Yukon River (Pilot Station),2001,0,,181,0
Yukon River (Pilot Station),2001,0,,182,0
Yukon River (Pilot Station),2001,0,,183,0
Yukon River (Pilot Station),2001,0,,184,0
Yukon River (Pilot Station),2001,0,,185,0
Yukon River (Pilot Station),2001,0,,186,0
Yukon River (Pilot Station),2001,0,,187,0
Yukon River (Pilot Station),2001,0,,188,0
Yukon River (Pilot Station),2001,0,,189,0
Yukon River (Pilot Station),2001,0,,190,0
Yukon River (Pilot Station),2001,0,,191,0
Yukon River (Pilot Station),2001,0,,192,0
Yukon River (Pilot Station),2001,0,,193,0
Yukon River (Pilot Station),2001,0,,194,0
Yukon River (Pilot Station),2001,0,,195,0
Yukon River (Pilot Station),2001,0,,196,0
Yukon River (Pilot Station),2001,0,,197,0
Yukon River (Pilot Station),2001,29,,198,29
Yukon River (Pilot Station),2001,0,,199,29
Yukon River (Pilot Station),2001,0,,200,29
Yukon River (Pilot Station),2001,0,,201,29
Yukon River (Pilot Station),2001,0,,202,29
Yukon River (Pilot Station),2001,115,,203,144
Yukon River (Pilot Station),2001,194,,204,338
Yukon River (Pilot Station),2001,59,,205,397
Yukon River (Pilot Station),2001,0,,206,397
Yukon River (Pilot Station),2001,0,,207,397
Yukon River (Pilot Station),2001,105,,208,502
Yukon River (Pilot Station),2001,108,,209,610
Yukon River (Pilot Station),2001,0,,210,610
Yukon River (Pilot Station),2001,0,,211,610
Yukon River (Pilot Station),2001,0,,212,610
Yukon River (Pilot Station),2001,0,,213,610
Yukon River (Pilot Station),2001,55,,214,665
Yukon River (Pilot Station),2001,0,,215,665
Yukon River (Pilot Station),2001,0,,216,665
Yukon River (Pilot Station),2001,0,,217,665
Yukon River (Pilot Station),2001,0,,218,665
Yukon River (Pilot Station),2001,0,,219,665
Yukon River (Pilot Station),2001,0,,220,665
Yukon River (Pilot Station),2001,0,,221,665
Yukon River (Pilot Station),2001,0,,222,665
Yukon River (Pilot Station),2001,0,,223,665
Yukon River (Pilot Station),2001,0,,224,665
Yukon River (Pilot Station),2001,0,,225,665
Yukon River (Pilot Station),2001,0,,226,665
Yukon River (Pilot Station),2001,0,,227,665
Yukon River (Pilot Station),2001,0,,228,665
Yukon River (Pilot Station),2001,0,,229,665
Yukon River (Pilot Station),2001,0,,230,665
Yukon River (Pilot Station),2001,0,,231,665
Yukon River (Pilot Station),2001,0,,232,665
Yukon River (Pilot Station),2001,0,,233,665
Yukon River (Pilot Station),2001,0,,234,665
Yukon River (Pilot Station),2001,0,,235,665
Yukon River (Pilot Station),2001,0,,236,665
Yukon River (Pilot Station),2001,0,,237,665
Yukon River (Pilot Station),2001,0,,238,665
Yukon River (Pilot Station),2001,0,,239,665
Yukon River (Pilot Station),2001,0,,240,665
Yukon River (Pilot Station),2001,0,,241,665
Yukon River (Pilot Station),2001,0,,242,665
Yukon River (Pilot Station),2001,0,,243,665
Yukon River (Pilot Station),2000,0,,161,0
Yukon River (Pilot Station),2000,0,,162,0
Yukon River (Pilot Station),2000,0,,163,0
Yukon River (Pilot Station),2000,0,,164,0
Yukon River (Pilot Station),2000,0,,165,0
Yukon River (Pilot Station),2000,0,,166,0
Yukon River (Pilot Station),2000,0,,167,0
Yukon River (Pilot Station),2000,0,,168,0
Yukon River (Pilot Station),2000,0,,169,0
Yukon River (Pilot Station),2000,0,,170,0
Yukon River (Pilot Station),2000,0,,171,0
Yukon River (Pilot Station),2000,0,,172,0
Yukon River (Pilot Station),2000,0,,173,0
Yukon River (Pilot Station),2000,0,,174,0
Yukon River (Pilot Station),2000,0,,175,0
Yukon River (Pilot Station),2000,79,,176,79
Yukon River (Pilot Station),2000,0,,177,79
Yukon River (Pilot Station),2000,0,,178,79
Yukon River (Pilot Station),2000,0,,179,79
Yukon River (Pilot Station),2000,0,,180,79
Yukon River (Pilot Station),2000,0,,181,79
Yukon River (Pilot Station),2000,278,,182,357
Yukon River (Pilot Station),2000,163,,183,520
Yukon River (Pilot Station),2000,491,,184,1011
Yukon River (Pilot Station),2000,1102,,185,2113
Yukon River (Pilot Station),2000,741,,186,2854
Yukon River (Pilot Station),2000,698,,187,3552
Yukon River (Pilot Station),2000,564,,188,4116
Yukon River (Pilot Station),2000,847,,189,4963
Yukon River (Pilot Station),2000,1888,,190,6851
Yukon River (Pilot Station),2000,763,,191,7614
Yukon River (Pilot Station),2000,1198,,192,8812
Yukon River (Pilot Station),2000,1671,,193,10483
Yukon River (Pilot Station),2000,2569,,194,13052
Yukon River (Pilot Station),2000,2635,,195,15687
Yukon River (Pilot Station),2000,2069,,196,17756
Yukon River (Pilot Station),2000,1795,,197,19551
Yukon River (Pilot Station),2000,2944,,198,22495
Yukon River (Pilot Station),2000,2186,,199,24681
Yukon River (Pilot Station),2000,886,,200,25567
Yukon River (Pilot Station),2000,1716,,201,27283
Yukon River (Pilot Station),2000,1182,,202,28465
Yukon River (Pilot Station),2000,913,,203,29378
Yukon River (Pilot Station),2000,1050,,204,30428
Yukon River (Pilot Station),2000,1507,,205,31935
Yukon River (Pilot Station),2000,1049,,206,32984
Yukon River (Pilot Station),2000,1215,,207,34199
Yukon River (Pilot Station),2000,242,,208,34441
Yukon River (Pilot Station),2000,402,,209,34843
Yukon River (Pilot Station),2000,210,,210,35053
Yukon River (Pilot Station),2000,20,,211,35073
Yukon River (Pilot Station),2000,114,,212,35187
Yukon River (Pilot Station),2000,47,,213,35234
Yukon River (Pilot Station),2000,45,,214,35279
Yukon River (Pilot Station),2000,91,,215,35370
Yukon River (Pilot Station),2000,0,,216,35370
Yukon River (Pilot Station),2000,0,,217,35370
Yukon River (Pilot Station),2000,12,,218,35382
Yukon River (Pilot Station),2000,0,,219,35382
Yukon River (Pilot Station),2000,9,,220,35391
Yukon River (Pilot Station),2000,0,,221,35391
Yukon River (Pilot Station),2000,0,,222,35391
Yukon River (Pilot Station),2000,0,,223,35391
Yukon River (Pilot Station),2000,88,,224,35479
Yukon River (Pilot Station),2000,0,,225,35479
Yukon River (Pilot Station),2000,14,,226,35493
Yukon River (Pilot Station),2000,8,,227,35501
Yukon River (Pilot Station),2000,0,,228,35501
Yukon River (Pilot Station),2000,0,,229,35501
Yukon River (Pilot Station),2000,0,,230,35501
Yukon River (Pilot Station),2000,0,,231,35501
Yukon River (Pilot Station),2000,0,,232,35501
Yukon River (Pilot Station),2000,0,,233,35501
Yukon River (Pilot Station),2000,0,,234,35501
Yukon River (Pilot Station),2000,0,,235,35501
Yukon River (Pilot Station),2000,0,,236,35501
Yukon River (Pilot Station),2000,0,,237,35501
Yukon River (Pilot Station),2000,0,,238,35501
Yukon River (Pilot Station),2000,0,,239,35501
Yukon River (Pilot Station),2000,0,,240,35501
Yukon River (Pilot Station),2000,0,,241,35501
Yukon River (Pilot Station),2000,0,,242,35501
Yukon River (Pilot Station),2000,0,,243,35501
Yukon River (Pilot Station),2000,0,,244,35501
Yukon River (Pilot Station),2000,0,,245,35501
Yukon River (Pilot Station),2000,0,,246,35501
Yukon River (Pilot Station),2000,0,,247,35501
Yukon River (Pilot Station),2000,0,,248,35501
Yukon River (Pilot Station),2000,0,,249,35501
Yukon River (Pilot Station),2000,0,,250,35501
Yukon River (Pilot Station),2000,0,,251,35501
Yukon River (Pilot Station),2000,0,,252,35501
Yukon River (Pilot Station),2000,0,,253,35501
Yukon River (Pilot Station),2000,0,,254,35501
Yukon River (Pilot Station),2000,0,,255,35501
Yukon River (Pilot Station),2000,0,,256,35501
Yukon River (Pilot Station),2000,0,,257,35501
Yukon River (Pilot Station),2000,0,,258,35501
Yukon River (Pilot Station),1999,0,,163,0
Yukon River (Pilot Station),1999,0,,164,0
Yukon River (Pilot Station),1999,0,,165,0
Yukon River (Pilot Station),1999,0,,166,0
Yukon River (Pilot Station),1999,0,,167,0
Yukon River (Pilot Station),1999,0,,168,0
Yukon River (Pilot Station),1999,0,,169,0
Yukon River (Pilot Station),1999,0,,170,0
Yukon River (Pilot Station),1999,0,,171,0
Yukon River (Pilot Station),1999,0,,172,0
Yukon River (Pilot Station),1999,0,,173,0
Yukon River (Pilot Station),1999,0,,174,0
Yukon River (Pilot Station),1999,0,,175,0
Yukon River (Pilot Station),1999,0,,176,0
Yukon River (Pilot Station),1999,0,,177,0
Yukon River (Pilot Station),1999,0,,178,0
Yukon River (Pilot Station),1999,0,,179,0
Yukon River (Pilot Station),1999,0,,180,0
Yukon River (Pilot Station),1999,0,,181,0
Yukon River (Pilot Station),1999,0,,182,0
Yukon River (Pilot Station),1999,0,,183,0
Yukon River (Pilot Station),1999,0,,184,0
Yukon River (Pilot Station),1999,0,,185,0
Yukon River (Pilot Station),1999,0,,186,0
Yukon River (Pilot Station),1999,0,,187,0
Yukon River (Pilot Station),1999,0,,188,0
Yukon River (Pilot Station),1999,0,,189,0
Yukon River (Pilot Station),1999,0,,190,0
Yukon River (Pilot Station),1999,0,,191,0
Yukon River (Pilot Station),1999,0,,192,0
Yukon River (Pilot Station),1999,0,,193,0
Yukon River (Pilot Station),1999,0,,194,0
Yukon River (Pilot Station),1999,0,,195,0
Yukon River (Pilot Station),1999,0,,196,0
Yukon River (Pilot Station),1999,0,,197,0
Yukon River (Pilot Station),1999,0,,198,0
Yukon River (Pilot Station),1999,0,,199,0
Yukon River (Pilot Station),1999,0,,200,0
Yukon River (Pilot Station),1999,0,,201,0
Yukon River (Pilot Station),1999,0,,202,0
Yukon River (Pilot Station),1999,109,,203,109
Yukon River (Pilot Station),1999,928,,204,1037
Yukon River (Pilot Station),1999,0,,205,1037
Yukon River (Pilot Station),1999,0,,206,1037
Yukon River (Pilot Station),1999,134,,207,1171
Yukon River (Pilot Station),1999,193,,208,1364
Yukon River (Pilot Station),1999,0,,209,1364
Yukon River (Pilot Station),1999,0,,210,1364
Yukon River (Pilot Station),1999,293,,211,1657
Yukon River (Pilot Station),1999,0,,212,1657
Yukon River (Pilot Station),1999,0,,213,1657
Yukon River (Pilot Station),1999,0,,214,1657
Yukon River (Pilot Station),1999,0,,215,1657
Yukon River (Pilot Station),1999,0,,216,1657
Yukon River (Pilot Station),1999,0,,217,1657
Yukon River (Pilot Station),1999,0,,218,1657
Yukon River (Pilot Station),1999,0,,219,1657
Yukon River (Pilot Station),1999,0,,220,1657
Yukon River (Pilot Station),1999,0,,221,1657
Yukon River (Pilot Station),1999,0,,222,1657
Yukon River (Pilot Station),1999,0,,223,1657
Yukon River (Pilot Station),1999,72,,224,1729
Yukon River (Pilot Station),1999,0,,225,1729
Yukon River (Pilot Station),1999,0,,226,1729
Yukon River (Pilot Station),1999,0,,227,1729
Yukon River (Pilot Station),1999,0,,228,1729
Yukon River (Pilot Station),1999,0,,229,1729
Yukon River (Pilot Station),1999,0,,230,1729
Yukon River (Pilot Station),1999,0,,231,1729
Yukon River (Pilot Station),1999,0,,232,1729
Yukon River (Pilot Station),1999,0,,233,1729
Yukon River (Pilot Station),1999,0,,234,1729
Yukon River (Pilot Station),1999,0,,235,1729
Yukon River (Pilot Station),1999,0,,236,1729
Yukon River (Pilot Station),1999,0,,237,1729
Yukon River (Pilot Station),1999,0,,238,1729
Yukon River (Pilot Station),1999,0,,239,1729
Yukon River (Pilot Station),1999,0,,240,1729
Yukon River (Pilot Station),1999,0,,241,1729
Yukon River (Pilot Station),1999,72,,242,1801
Yukon River (Pilot Station),1999,0,,243,1801
Yukon River (Pilot Station),1998,0,,157,0
Yukon River (Pilot Station),1998,0,,158,0
Yukon River (Pilot Station),1998,0,,159,0
Yukon River (Pilot Station),1998,0,,160,0
Yukon River (Pilot Station),1998,0,,161,0
Yukon River (Pilot Station),1998,0,,162,0
Yukon River (Pilot Station),1998,0,,163,0
Yukon River (Pilot Station),1998,0,,164,0
Yukon River (Pilot Station),1998,0,,165,0
Yukon River (Pilot Station),1998,0,,166,0
Yukon River (Pilot Station),1998,0,,167,0
Yukon River (Pilot Station),1998,0,,168,0
Yukon River (Pilot Station),1998,0,,169,0
Yukon River (Pilot Station),1998,0,,170,0
Yukon River (Pilot Station),1998,0,,171,0
Yukon River (Pilot Station),1998,0,,172,0
Yukon River (Pilot Station),1998,0,,173,0
Yukon River (Pilot Station),1998,0,,174,0
Yukon River (Pilot Station),1998,0,,175,0
Yukon River (Pilot Station),1998,0,,176,0
Yukon River (Pilot Station),1998,0,,177,0
Yukon River (Pilot Station),1998,0,,178,0
Yukon River (Pilot Station),1998,0,,179,0
Yukon River (Pilot Station),1998,0,,180,0
Yukon River (Pilot Station),1998,0,,181,0
Yukon River (Pilot Station),1998,1815,,182,1815
Yukon River (Pilot Station),1998,1748,,183,3563
Yukon River (Pilot Station),1998,1704,,184,5267
Yukon River (Pilot Station),1998,1544,,185,6811
Yukon River (Pilot Station),1998,1655,,186,8466
Yukon River (Pilot Station),1998,389,,187,8855
Yukon River (Pilot Station),1998,913,,188,9768
Yukon River (Pilot Station),1998,2582,,189,12350
Yukon River (Pilot Station),1998,4177,,190,16527
Yukon River (Pilot Station),1998,3994,,191,20521
Yukon River (Pilot Station),1998,4028,,192,24549
Yukon River (Pilot Station),1998,3601,,193,28150
Yukon River (Pilot Station),1998,1706,,194,29856
Yukon River (Pilot Station),1998,2107,,195,31963
Yukon River (Pilot Station),1998,2266,,196,34229
Yukon River (Pilot Station),1998,2411,,197,36640
Yukon River (Pilot Station),1998,826,,198,37466
Yukon River (Pilot Station),1998,1463,,199,38929
Yukon River (Pilot Station),1998,1695,,200,40624
Yukon River (Pilot Station),1998,1710,,201,42334
Yukon River (Pilot Station),1998,1215,,202,43549
Yukon River (Pilot Station),1998,973,,203,44522
Yukon River (Pilot Station),1998,1047,,204,45569
Yukon River (Pilot Station),1998,2453,,205,48022
Yukon River (Pilot Station),1998,941,,206,48963
Yukon River (Pilot Station),1998,2473,,207,51436
Yukon River (Pilot Station),1998,3910,,208,55346
Yukon River (Pilot Station),1998,1504,,209,56850
Yukon River (Pilot Station),1998,1063,,210,57913
Yukon River (Pilot Station),1998,950,,211,58863
Yukon River (Pilot Station),1998,1063,,212,59926
Yukon River (Pilot Station),1998,1521,,213,61447
Yukon River (Pilot Station),1998,1324,,214,62771
Yukon River (Pilot Station),1998,26,,215,62797
Yukon River (Pilot Station),1998,370,,216,63167
Yukon River (Pilot Station),1998,538,,217,63705
Yukon River (Pilot Station),1998,402,,218,64107
Yukon River (Pilot Station),1998,47,,219,64154
Yukon River (Pilot Station),1998,1658,,220,65812
Yukon River (Pilot Station),1998,336,,221,66148
Yukon River (Pilot Station),1998,0,,222,66148
Yukon River (Pilot Station),1998,0,,223,66148
Yukon River (Pilot Station),1998,407,,224,66555
Yukon River (Pilot Station),1998,0,,225,66555
Yukon River (Pilot Station),1998,43,,226,66598
Yukon River (Pilot Station),1998,67,,227,66665
Yukon River (Pilot Station),1998,0,,228,66665
Yukon River (Pilot Station),1998,0,,229,66665
Yukon River (Pilot Station),1998,38,,230,66703
Yukon River (Pilot Station),1998,0,,231,66703
Yukon River (Pilot Station),1998,0,,232,66703
Yukon River (Pilot Station),1998,0,,233,66703
Yukon River (Pilot Station),1998,0,,234,66703
Yukon River (Pilot Station),1998,0,,235,66703
Yukon River (Pilot Station),1998,0,,236,66703
Yukon River (Pilot Station),1998,0,,237,66703
Yukon River (Pilot Station),1998,0,,238,66703
Yukon River (Pilot Station),1998,48,,239,66751
Yukon River (Pilot Station),1998,0,,240,66751
Yukon River (Pilot Station),1998,0,,241,66751
Yukon River (Pilot Station),1998,0,,242,66751
Yukon River (Pilot Station),1998,0,,243,66751
Yukon River (Pilot Station),1998,0,,244,66751
Yukon River (Pilot Station),1998,0,,245,66751
Yukon River (Pilot Station),1998,0,,246,66751
Yukon River (Pilot Station),1998,0,,247,66751
Yukon River (Pilot Station),1998,0,,248,66751
Yukon River (Pilot Station),1998,0,,249,66751
Yukon River (Pilot Station),1998,0,,250,66751
Yukon River (Pilot Station),1998,0,,251,66751
Yukon River (Pilot Station),1998,0,,252,66751
Yukon River (Pilot Station),1997,0,,157,0
Yukon River (Pilot Station),1997,0,,158,0
Yukon River (Pilot Station),1997,0,,159,0
Yukon River (Pilot Station),1997,0,,160,0
Yukon River (Pilot Station),1997,0,,161,0
Yukon River (Pilot Station),1997,0,,162,0
Yukon River (Pilot Station),1997,0,,163,0
Yukon River (Pilot Station),1997,0,,164,0
Yukon River (Pilot Station),1997,0,,165,0
Yukon River (Pilot Station),1997,0,,166,0
Yukon River (Pilot Station),1997,0,,167,0
Yukon River (Pilot Station),1997,0,,168,0
Yukon River (Pilot Station),1997,0,,169,0
Yukon River (Pilot Station),1997,0,,170,0
Yukon River (Pilot Station),1997,0,,171,0
Yukon River (Pilot Station),1997,0,,172,0
Yukon River (Pilot Station),1997,0,,173,0
Yukon River (Pilot Station),1997,130,,174,130
Yukon River (Pilot Station),1997,332,,175,462
Yukon River (Pilot Station),1997,111,,176,573
Yukon River (Pilot Station),1997,0,,177,573
Yukon River (Pilot Station),1997,0,,178,573
Yukon River (Pilot Station),1997,0,,179,573
Yukon River (Pilot Station),1997,NA,,180,NA
Yukon River (Pilot Station),1997,NA,,181,NA
Yukon River (Pilot Station),1997,0,,182,NA
Yukon River (Pilot Station),1997,0,,183,NA
Yukon River (Pilot Station),1997,0,,184,NA
Yukon River (Pilot Station),1997,0,,185,NA
Yukon River (Pilot Station),1997,0,,186,NA
Yukon River (Pilot Station),1997,14,,187,NA
Yukon River (Pilot Station),1997,33,,188,NA
Yukon River (Pilot Station),1997,36,,189,NA
Yukon River (Pilot Station),1997,249,,190,NA
Yukon River (Pilot Station),1997,0,,191,NA
Yukon River (Pilot Station),1997,0,,192,NA
Yukon River (Pilot Station),1997,0,,193,NA
Yukon River (Pilot Station),1997,0,,194,NA
Yukon River (Pilot Station),1997,0,,195,NA
Yukon River (Pilot Station),1997,0,,196,NA
Yukon River (Pilot Station),1997,0,,197,NA
Yukon River (Pilot Station),1997,0,,198,NA
Yukon River (Pilot Station),1997,0,,199,NA
Yukon River (Pilot Station),1997,99,,200,NA
Yukon River (Pilot Station),1997,43,,201,NA
Yukon River (Pilot Station),1997,0,,202,NA
Yukon River (Pilot Station),1997,0,,203,NA
Yukon River (Pilot Station),1997,0,,204,NA
Yukon River (Pilot Station),1997,51,,205,NA
Yukon River (Pilot Station),1997,0,,206,NA
Yukon River (Pilot Station),1997,45,,207,NA
Yukon River (Pilot Station),1997,0,,208,NA
Yukon River (Pilot Station),1997,0,,209,NA
Yukon River (Pilot Station),1997,0,,210,NA
Yukon River (Pilot Station),1997,447,,211,NA
Yukon River (Pilot Station),1997,0,,212,NA
Yukon River (Pilot Station),1997,0,,213,NA
Yukon River (Pilot Station),1997,0,,214,NA
Yukon River (Pilot Station),1997,0,,215,NA
Yukon River (Pilot Station),1997,0,,216,NA
Yukon River (Pilot Station),1997,0,,217,NA
Yukon River (Pilot Station),1997,0,,218,NA
Yukon River (Pilot Station),1997,0,,219,NA
Yukon River (Pilot Station),1997,0,,220,NA
Yukon River (Pilot Station),1997,0,,221,NA
Yukon River (Pilot Station),1997,0,,222,NA
Yukon River (Pilot Station),1997,0,,223,NA
Yukon River (Pilot Station),1997,0,,224,NA
Yukon River (Pilot Station),1997,953,,225,NA
Yukon River (Pilot Station),1997,0,,226,NA
Yukon River (Pilot Station),1997,0,,227,NA
Yukon River (Pilot Station),1997,0,,228,NA
Yukon River (Pilot Station),1997,0,,229,NA
Yukon River (Pilot Station),1997,872,,230,NA
Yukon River (Pilot Station),1997,0,,231,NA
Yukon River (Pilot Station),1997,0,,232,NA
Yukon River (Pilot Station),1997,0,,233,NA
Yukon River (Pilot Station),1997,0,,234,NA
Yukon River (Pilot Station),1997,0,,235,NA
Yukon River (Pilot Station),1997,0,,236,NA
Yukon River (Pilot Station),1997,0,,237,NA
Yukon River (Pilot Station),1997,0,,238,NA
Yukon River (Pilot Station),1997,0,,239,NA
Yukon River (Pilot Station),1997,269,,240,NA
Yukon River (Pilot Station),1997,0,,241,NA
Yukon River (Pilot Station),1997,0,,242,NA
Yukon River (Pilot Station),1997,189,,243,NA
Yukon River (Pilot Station),1995,0,,158,0
Yukon River (Pilot Station),1995,0,,159,0
Yukon River (Pilot Station),1995,0,,160,0
Yukon River (Pilot Station),1995,0,,161,0
Yukon River (Pilot Station),1995,0,,162,0
Yukon River (Pilot Station),1995,0,,163,0
Yukon River (Pilot Station),1995,0,,164,0
Yukon River (Pilot Station),1995,0,,165,0
Yukon River (Pilot Station),1995,0,,166,0
Yukon River (Pilot Station),1995,0,,167,0
Yukon River (Pilot Station),1995,0,,168,0
Yukon River (Pilot Station),1995,0,,169,0
Yukon River (Pilot Station),1995,0,,170,0
Yukon River (Pilot Station),1995,0,,171,0
Yukon River (Pilot Station),1995,0,,172,0
Yukon River (Pilot Station),1995,0,,173,0
Yukon River (Pilot Station),1995,0,,174,0
Yukon River (Pilot Station),1995,0,,175,0
Yukon River (Pilot Station),1995,0,,176,0
Yukon River (Pilot Station),1995,0,,177,0
Yukon River (Pilot Station),1995,1180,,178,1180
Yukon River (Pilot Station),1995,948,,179,2128
Yukon River (Pilot Station),1995,0,,180,2128
Yukon River (Pilot Station),1995,0,,181,2128
Yukon River (Pilot Station),1995,0,,182,2128
Yukon River (Pilot Station),1995,0,,183,2128
Yukon River (Pilot Station),1995,0,,184,2128
Yukon River (Pilot Station),1995,0,,185,2128
Yukon River (Pilot Station),1995,0,,186,2128
Yukon River (Pilot Station),1995,423,,187,2551
Yukon River (Pilot Station),1995,1090,,188,3641
Yukon River (Pilot Station),1995,180,,189,3821
Yukon River (Pilot Station),1995,334,,190,4155
Yukon River (Pilot Station),1995,334,,191,4489
Yukon River (Pilot Station),1995,1177,,192,5666
Yukon River (Pilot Station),1995,3092,,193,8758
Yukon River (Pilot Station),1995,1769,,194,10527
Yukon River (Pilot Station),1995,2044,,195,12571
Yukon River (Pilot Station),1995,2650,,196,15221
Yukon River (Pilot Station),1995,2710,,197,17931
Yukon River (Pilot Station),1995,0,,198,17931
Yukon River (Pilot Station),1995,0,,199,17931
Yukon River (Pilot Station),1995,302,,200,18233
Yukon River (Pilot Station),1995,0,,201,18233
Yukon River (Pilot Station),1995,786,,202,19019
Yukon River (Pilot Station),1995,4093,,203,23112
Yukon River (Pilot Station),1995,797,,204,23909
Yukon River (Pilot Station),1995,818,,205,24727
Yukon River (Pilot Station),1995,364,,206,25091
Yukon River (Pilot Station),1995,1630,,207,26721
Yukon River (Pilot Station),1995,9165,,208,35886
Yukon River (Pilot Station),1995,4635,,209,40521
Yukon River (Pilot Station),1995,2710,,210,43231
Yukon River (Pilot Station),1995,2562,,211,45793
Yukon River (Pilot Station),1995,257,,212,46050
Yukon River (Pilot Station),1995,176,,213,46226
Yukon River (Pilot Station),1995,1098,,214,47324
Yukon River (Pilot Station),1995,1007,,215,48331
Yukon River (Pilot Station),1995,137,,216,48468
Yukon River (Pilot Station),1995,87,,217,48555
Yukon River (Pilot Station),1995,290,,218,48845
Yukon River (Pilot Station),1995,0,,219,48845
Yukon River (Pilot Station),1995,1708,,220,50553
Yukon River (Pilot Station),1995,0,,221,50553
Yukon River (Pilot Station),1995,0,,222,50553
Yukon River (Pilot Station),1995,1904,,223,52457
Yukon River (Pilot Station),1995,0,,224,52457
Yukon River (Pilot Station),1995,0,,225,52457
Yukon River (Pilot Station),1995,0,,226,52457
Yukon River (Pilot Station),1995,0,,227,52457
Yukon River (Pilot Station),1995,0,,228,52457
Yukon River (Pilot Station),1995,0,,229,52457
Yukon River (Pilot Station),1995,0,,230,52457
Yukon River (Pilot Station),1995,665,,231,53122
Yukon River (Pilot Station),1995,0,,232,53122
Yukon River (Pilot Station),1995,0,,233,53122
Yukon River (Pilot Station),1995,0,,234,53122
Yukon River (Pilot Station),1995,0,,235,53122
Yukon River (Pilot Station),1995,0,,236,53122
Yukon River (Pilot Station),1995,0,,237,53122
Yukon River (Pilot Station),1995,0,,238,53122
Yukon River (Pilot Station),1995,0,,239,53122
Yukon River (Pilot Station),1995,0,,240,53122
Yukon River (Pilot Station),1995,70,,241,53192
Yukon River (Pilot Station),1995,0,,242,53192
Yukon River (Pilot Station),1995,0,,243,53192
Yukon River (Pilot Station),1995,0,,244,53192
Yukon River (Pilot Station),1995,0,,245,53192
Yukon River (Pilot Station),1995,0,,246,53192
Auke Creek,2009,0,,60,0
Auke Creek,2009,0,,61,0
Auke Creek,2009,0,,62,0
Auke Creek,2009,0,,63,0
Auke Creek,2009,0,,64,0
Auke Creek,2009,1,,65,1
Auke Creek,2009,2,,66,3
Auke Creek,2009,0,,67,3
Auke Creek,2009,0,,68,3
Auke Creek,2009,1,,69,4
Auke Creek,2009,1,,70,5
Auke Creek,2009,10,,71,15
Auke Creek,2009,12,,72,27
Auke Creek,2009,22,,73,49
Auke Creek,2009,21,,74,70
Auke Creek,2009,18,,75,88
Auke Creek,2009,7,,76,95
Auke Creek,2009,11,,77,106
Auke Creek,2009,5,,78,111
Auke Creek,2009,22,,79,133
Auke Creek,2009,8,,80,141
Auke Creek,2009,10,,81,151
Auke Creek,2009,8,,82,159
Auke Creek,2009,7,,83,166
Auke Creek,2009,22,,84,188
Auke Creek,2003,856,,63,856
Auke Creek,2003,1140,,64,1996
Auke Creek,2003,565,,65,2561
Auke Creek,2003,702,,66,3263
Auke Creek,2003,776,,67,4039
Auke Creek,2003,850,,68,4889
Auke Creek,2003,1013,,69,5902
Auke Creek,2003,670,,70,6572
Auke Creek,2003,848,,71,7420
Auke Creek,2003,493,,72,7913
Auke Creek,2003,649,,73,8562
Auke Creek,2003,762,,74,9324
Auke Creek,2003,2010,,75,11334
Auke Creek,2003,757,,76,12091
Auke Creek,2003,1238,,77,13329
Auke Creek,2003,1778,,78,15107
Auke Creek,2002,0,,182,0
Auke Creek,2002,0,,183,0
Auke Creek,2002,0,,184,0
Auke Creek,2002,0,,185,0
Auke Creek,2002,0,,186,0
Auke Creek,2002,0,,187,0
Auke Creek,2002,0,,188,0
Auke Creek,2002,0,,189,0
Auke Creek,2002,0,,190,0
Auke Creek,2002,0,,191,0
Auke Creek,2002,0,,192,0
Auke Creek,2002,0,,193,0
Auke Creek,2002,0,,194,0
Auke Creek,2002,0,,195,0
Auke Creek,2002,0,,196,0
Auke Creek,2002,0,,197,0
Auke Creek,2002,0,,198,0
Auke Creek,2002,0,,199,0
Auke Creek,2002,0,,200,0
Auke Creek,2002,0,,201,0
Auke Creek,2002,0,,202,0
Auke Creek,2002,0,,203,0
Auke Creek,2002,0,,204,0
Auke Creek,2002,2,,205,2
Auke Creek,2002,8,,206,10
Auke Creek,2002,6,,207,16
Auke Creek,2002,4,,208,20
Auke Creek,2002,5,,209,25
Auke Creek,2002,7,,210,32
Auke Creek,2002,7,,211,39
Auke Creek,2002,4,,212,43
Auke Creek,2002,7,,213,50
Auke Creek,2002,1,,214,51
Auke Creek,2002,5,,215,56
Auke Creek,2002,3,,216,59
Auke Creek,2002,17,,217,76
Auke Creek,2002,1,,218,77
Auke Creek,2002,104,,219,181
Auke Creek,2002,411,,220,592
Auke Creek,2002,476,,221,1068
Auke Creek,2002,125,,222,1193
Auke Creek,2002,95,,223,1288
Auke Creek,2002,195,,224,1483
Auke Creek,2002,372,,225,1855
Auke Creek,2002,226,,226,2081
Auke Creek,2002,74,,227,2155
Auke Creek,2002,74,,228,2229
Auke Creek,2002,27,,229,2256
Auke Creek,2002,39,,230,2295
Auke Creek,2002,31,,231,2326
Auke Creek,2002,78,,232,2404
Auke Creek,2002,121,,233,2525
Auke Creek,2002,443,,234,2968
Auke Creek,2002,254,,235,3222
Auke Creek,2002,172,,236,3394
Auke Creek,2002,73,,237,3467
Auke Creek,2002,48,,238,3515
Auke Creek,2002,54,,239,3569
Auke Creek,2002,170,,240,3739
Auke Creek,2002,241,,241,3980
Auke Creek,2002,181,,242,4161
Auke Creek,2002,125,,243,4286
Auke Creek,2002,111,,244,4397
Auke Creek,2002,127,,245,4524
Auke Creek,2002,101,,246,4625
Auke Creek,2002,34,,247,4659
Auke Creek,2002,55,,248,4714
Auke Creek,2002,42,,249,4756
Auke Creek,2002,75,,250,4831
Auke Creek,2002,47,,251,4878
Auke Creek,2002,18,,252,4896
Auke Creek,2002,10,,253,4906
Auke Creek,2002,7,,254,4913
Auke Creek,2002,5,,255,4918
Auke Creek,2002,5,,256,4923
Auke Creek,2002,1,,257,4924
Auke Creek,2002,3,,258,4927
Auke Creek,2002,0,,259,4927
Auke Creek,2002,1,,260,4928
Auke Creek,2002,0,,261,4928
Auke Creek,2002,0,,262,4928
Auke Creek,2002,0,,263,4928
Auke Creek,2002,0,,264,4928
Auke Creek,2002,0,,265,4928
Auke Creek,2002,0,,266,4928
Auke Creek,2002,0,,267,4928
Auke Creek,2002,0,,268,4928
Auke Creek,2002,0,,269,4928
Auke Creek,2002,0,,270,4928
Auke Creek,2002,0,,271,4928
Auke Creek,2002,0,,272,4928
Auke Creek,2002,0,,273,4928
Auke Creek,2002,0,,274,4928
Auke Creek,2002,0,,275,4928
Auke Creek,2002,0,,276,4928
Auke Creek,2002,0,,277,4928
Auke Creek,2002,0,,278,4928
Auke Creek,2002,0,,279,4928
Auke Creek,2002,0,,280,4928
Auke Creek,2002,0,,281,4928
Auke Creek,2002,0,,282,4928
Auke Creek,2002,0,,283,4928
Auke Creek,2002,0,,284,4928
Auke Creek,2002,0,,285,4928
Auke Creek,2002,0,,286,4928
Auke Creek,2002,0,,287,4928
Auke Creek,2002,0,,288,4928
Auke Creek,2002,0,,289,4928
Auke Creek,2002,0,,290,4928
Auke Creek,2002,0,,291,4928
Auke Creek,2002,0,,292,4928
Auke Creek,2002,0,,293,4928
Auke Creek,2002,0,,294,4928
Auke Creek,2002,0,,295,4928
Auke Creek,2002,0,,296,4928
Auke Creek,2002,0,,297,4928
Auke Creek,2002,0,,298,4928
Auke Creek,2002,0,,299,4928
Auke Creek,2002,0,,300,4928
Auke Creek,2002,0,,301,4928
Auke Creek,2002,0,,302,4928
Auke Creek,2002,0,,303,4928
Auke Creek,2002,0,,304,4928
Babine,1946,0,,231,0
Babine,1946,57,,232,57
Babine,1946,214,,233,271
Babine,1946,595,,234,866
Babine,1946,740,,235,1606
Babine,1946,847,,236,2453
Babine,1946,1378,,237,3831
Babine,1946,949,,238,4780
Babine,1946,821,,239,5601
Babine,1946,847,,240,6448
Babine,1946,1246,,241,7694
Babine,1946,1230,,242,8924
Babine,1946,1682,,243,10606
Babine,1946,2234,,244,12840
Babine,1946,1771,,245,14611
Babine,1946,1763,,246,16374
Babine,1946,1879,,247,18253
Babine,1946,1572,,248,19825
Babine,1946,916,,249,20741
Babine,1946,1530,,250,22271
Babine,1946,877,,251,23148
Babine,1946,662,,252,23810
Babine,1946,586,,253,24396
Babine,1946,491,,254,24887
Babine,1946,607,,255,25494
Babine,1946,409,,256,25903
Babine,1946,570,,257,26473
Babine,1946,524,,258,26997
Babine,1946,313,,259,27310
Babine,1946,239,,260,27549
Babine,1946,100,,261,27649
Babine,1946,120,,262,27769
Babine,1946,105,,263,27874
Babine,1946,61,,264,27935
Babine,1946,47,,265,27982
Babine,1946,67,,266,28049
Babine,1946,41,,267,28090
Babine,1946,21,,268,28111
Babine,1946,20,,269,28131
Babine,1946,13,,270,28144
Babine,1946,8,,271,28152
Babine,1946,3,,272,28155
Babine,1946,1,,273,28156
Babine,1946,5,,274,28161
Babine,1946,0,,275,28161
Babine,1947,0,,220,0
Babine,1947,1,,221,1
Babine,1947,5,,222,6
Babine,1947,46,,223,52
Babine,1947,136,,224,188
Babine,1947,220,,225,408
Babine,1947,524,,226,932
Babine,1947,726,,227,1658
Babine,1947,1099,,228,2757
Babine,1947,938,,229,3695
Babine,1947,911,,230,4606
Babine,1947,1172,,231,5778
Babine,1947,1053,,232,6831
Babine,1947,921,,233,7752
Babine,1947,1439,,234,9191
Babine,1947,2306,,235,11497
Babine,1947,2479,,236,13976
Babine,1947,2674,,237,16650
Babine,1947,2918,,238,19568
Babine,1947,3348,,239,22916
Babine,1947,4772,,240,27688
Babine,1947,3733,,241,31421
Babine,1947,2664,,242,34085
Babine,1947,3479,,243,37564
Babine,1947,2277,,244,39841
Babine,1947,2163,,245,42004
Babine,1947,1747,,246,43751
Babine,1947,1180,,247,44931
Babine,1947,1486,,248,46417
Babine,1947,1583,,249,48000
Babine,1947,1439,,250,49439
Babine,1947,1179,,251,50618
Babine,1947,1005,,252,51623
Babine,1947,993,,253,52616
Babine,1947,776,,254,53392
Babine,1947,529,,255,53921
Babine,1947,311,,256,54232
Babine,1947,274,,257,54506
Babine,1947,313,,258,54819
Babine,1947,183,,259,55002
Babine,1947,117,,260,55119
Babine,1947,117,,261,55236
Babine,1947,81,,262,55317
Babine,1947,54,,263,55371
Babine,1947,30,,264,55401
Babine,1947,8,,265,55409
Babine,1947,6,,266,55415
Babine,1947,4,,267,55419
Babine,1947,2,,268,55421
Babine,1947,0,,269,55421
Babine,1949,0,,219,0
Babine,1949,2,,220,2
Babine,1949,1,,221,3
Babine,1949,4,,222,7
Babine,1949,2,,223,9
Babine,1949,2,,224,11
Babine,1949,29,,225,40
Babine,1949,27,,226,67
Babine,1949,37,,227,104
Babine,1949,62,,228,166
Babine,1949,85,,229,251
Babine,1949,76,,230,327
Babine,1949,80,,231,407
Babine,1949,152,,232,559
Babine,1949,143,,233,702
Babine,1949,173,,234,875
Babine,1949,222,,235,1097
Babine,1949,415,,236,1512
Babine,1949,605,,237,2117
Babine,1949,506,,238,2623
Babine,1949,573,,239,3196
Babine,1949,646,,240,3842
Babine,1949,494,,241,4336
Babine,1949,844,,242,5180
Babine,1949,1020,,243,6200
Babine,1949,1052,,244,7252
Babine,1949,1005,,245,8257
Babine,1949,1014,,246,9271
Babine,1949,870,,247,10141
Babine,1949,659,,248,10800
Babine,1949,579,,249,11379
Babine,1949,576,,250,11955
Babine,1949,219,,251,12174
Babine,1949,340,,252,12514
Babine,1949,308,,253,12822
Babine,1949,246,,254,13068
Babine,1949,209,,255,13277
Babine,1949,110,,256,13387
Babine,1949,93,,257,13480
Babine,1949,48,,258,13528
Babine,1949,49,,259,13577
Babine,1949,48,,260,13625
Babine,1949,15,,261,13640
Babine,1949,10,,262,13650
Babine,1949,3,,263,13653
Babine,1949,5,,264,13658
Babine,1949,1,,265,13659
Babine,1949,2,,266,13661
Babine,1949,1,,267,13662
Babine,1949,0,,268,13662
Babine,1949,1,,269,13663
Babine,1949,0,,270,13663
Babine,1949,2,,271,13665
Babine,1949,0,,272,13665
Babine,1950,0,,214,0
Babine,1950,1,,215,1
Babine,1950,1,,216,2
Babine,1950,1,,217,3
Babine,1950,0,,218,3
Babine,1950,2,,219,5
Babine,1950,2,,220,7
Babine,1950,4,,221,11
Babine,1950,1,,222,12
Babine,1950,3,,223,15
Babine,1950,12,,224,27
Babine,1950,23,,225,50
Babine,1950,45,,226,95
Babine,1950,76,,227,171
Babine,1950,39,,228,210
Babine,1950,36,,229,246
Babine,1950,105,,230,351
Babine,1950,320,,231,671
Babine,1950,470,,232,1141
Babine,1950,982,,233,2123
Babine,1950,2050,,234,4173
Babine,1950,1627,,235,5800
Babine,1950,3082,,236,8882
Babine,1950,2816,,237,11698
Babine,1950,2965,,238,14663
Babine,1950,2854,,239,17517
Babine,1950,2227,,240,19744
Babine,1950,1765,,241,21509
Babine,1950,1153,,242,22662
Babine,1950,1095,,243,23757
Babine,1950,1546,,244,25303
Babine,1950,1727,,245,27030
Babine,1950,2049,,246,29079
Babine,1950,1183,,247,30262
Babine,1950,1232,,248,31494
Babine,1950,841,,249,32335
Babine,1950,846,,250,33181
Babine,1950,727,,251,33908
Babine,1950,757,,252,34665
Babine,1950,703,,253,35368
Babine,1950,622,,254,35990
Babine,1950,556,,255,36546
Babine,1950,336,,256,36882
Babine,1950,416,,257,37298
Babine,1950,358,,258,37656
Babine,1950,271,,259,37927
Babine,1950,217,,260,38144
Babine,1950,189,,261,38333
Babine,1950,124,,262,38457
Babine,1950,89,,263,38546
Babine,1950,72,,264,38618
Babine,1950,63,,265,38681
Babine,1950,22,,266,38703
Babine,1950,9,,267,38712
Babine,1950,10,,268,38722
Babine,1950,0,,269,38722
Babine,1950,2,,270,38724
Babine,1950,2,,271,38726
Babine,1950,1,,272,38727
Babine,1950,0,,273,38727
Babine,1950,1,,274,38728
Babine,1950,0,,275,38728
Babine,1951,0,,234,0
Babine,1951,1,,235,1
Babine,1951,1,,236,2
Babine,1951,1,,237,3
Babine,1951,1,,238,4
Babine,1951,2,,239,6
Babine,1951,1,,240,7
Babine,1951,6,,241,13
Babine,1951,3,,242,16
Babine,1951,4,,243,20
Babine,1951,5,,244,25
Babine,1951,2,,245,27
Babine,1951,3,,246,30
Babine,1951,4,,247,34
Babine,1951,0,,248,34
Babine,1951,1,,249,35
Babine,1951,1,,250,36
Babine,1951,1,,251,37
Babine,1951,4,,252,41
Babine,1951,5,,253,46
Babine,1951,0,,254,46
Babine,1951,3,,255,49
Babine,1951,1,,256,50
Babine,1951,0,,257,50
Babine,1952,0,,233,0
Babine,1952,2,,234,2
Babine,1952,0,,235,2
Babine,1952,0,,236,2
Babine,1952,6,,237,8
Babine,1952,4,,238,12
Babine,1952,6,,239,18
Babine,1952,5,,240,23
Babine,1952,14,,241,37
Babine,1952,11,,242,48
Babine,1952,9,,243,57
Babine,1952,8,,244,65
Babine,1952,8,,245,73
Babine,1952,8,,246,81
Babine,1952,12,,247,93
Babine,1952,8,,248,101
Babine,1952,11,,249,112
Babine,1952,14,,250,126
Babine,1952,14,,251,140
Babine,1952,21,,252,161
Babine,1952,56,,253,217
Babine,1952,103,,254,320
Babine,1952,238,,255,558
Babine,1952,262,,256,820
Babine,1952,326,,257,1146
Babine,1952,273,,258,1419
Babine,1952,196,,259,1615
Babine,1952,443,,260,2058
Babine,1952,267,,261,2325
Babine,1952,145,,262,2470
Babine,1952,133,,263,2603
Babine,1952,58,,264,2661
Babine,1952,20,,265,2681
Babine,1952,11,,266,2692
Babine,1952,8,,267,2700
Babine,1952,4,,268,2704
Babine,1952,0,,269,2704
Babine,1952,0,,270,2704
Babine,1952,1,,271,2705
Babine,1952,0,,272,2705
Babine,1952,1,,273,2706
Babine,1952,0,,274,2706
Babine,1953,0,,217,0
Babine,1953,2,,218,2
Babine,1953,0,,219,2
Babine,1953,1,,220,3
Babine,1953,0,,221,3
Babine,1953,1,,222,4
Babine,1953,0,,223,4
Babine,1953,2,,224,6
Babine,1953,10,,225,16
Babine,1953,14,,226,30
Babine,1953,28,,227,58
Babine,1953,28,,228,86
Babine,1953,79,,229,165
Babine,1953,75,,230,240
Babine,1953,118,,231,358
Babine,1953,65,,232,423
Babine,1953,59,,233,482
Babine,1953,57,,234,539
Babine,1953,54,,235,593
Babine,1953,52,,236,645
Babine,1953,61,,237,706
Babine,1953,69,,238,775
Babine,1953,63,,239,838
Babine,1953,41,,240,879
Babine,1953,34,,241,913
Babine,1953,27,,242,940
Babine,1953,21,,243,961
Babine,1953,23,,244,984
Babine,1953,8,,245,992
Babine,1953,6,,246,998
Babine,1953,4,,247,1002
Babine,1953,4,,248,1006
Babine,1953,3,,249,1009
Babine,1953,0,,250,1009
Babine,1953,1,,251,1010
Babine,1953,2,,252,1012
Babine,1953,2,,253,1014
Babine,1953,2,,254,1016
Babine,1953,1,,255,1017
Babine,1953,0,,256,1017
Babine,1953,0,,257,1017
Babine,1953,0,,258,1017
Babine,1953,0,,259,1017
Babine,1953,0,,260,1017
Babine,1953,1,,261,1018
Babine,1953,0,,262,1018
Babine,1954,0,,233,0
Babine,1954,2,,234,2
Babine,1954,7,,235,9
Babine,1954,10,,236,19
Babine,1954,21,,237,40
Babine,1954,41,,238,81
Babine,1954,36,,239,117
Babine,1954,60,,240,177
Babine,1954,97,,241,274
Babine,1954,177,,242,451
Babine,1954,301,,243,752
Babine,1954,476,,244,1228
Babine,1954,463,,245,1691
Babine,1954,497,,246,2188
Babine,1954,429,,247,2617
Babine,1954,268,,248,2885
Babine,1954,212,,249,3097
Babine,1954,249,,250,3346
Babine,1954,265,,251,3611
Babine,1954,281,,252,3892
Babine,1954,259,,253,4151
Babine,1954,141,,254,4292
Babine,1954,75,,255,4367
Babine,1954,66,,256,4433
Babine,1954,63,,257,4496
Babine,1954,31,,258,4527
Babine,1954,38,,259,4565
Babine,1954,24,,260,4589
Babine,1954,8,,261,4597
Babine,1954,2,,262,4599
Babine,1954,3,,263,4602
Babine,1954,1,,264,4603
Babine,1954,0,,265,4603
Babine,1954,0,,266,4603
Babine,1954,1,,267,4604
Babine,1954,0,,268,4604
Babine,1955,0,,225,0
Babine,1955,2,,226,2
Babine,1955,1,,227,3
Babine,1955,1,,228,4
Babine,1955,0,,229,4
Babine,1955,1,,230,5
Babine,1955,3,,231,8
Babine,1955,8,,232,16
Babine,1955,2,,233,18
Babine,1955,3,,234,21
Babine,1955,29,,235,50
Babine,1955,20,,236,70
Babine,1955,42,,237,112
Babine,1955,72,,238,184
Babine,1955,94,,239,278
Babine,1955,94,,240,372
Babine,1955,122,,241,494
Babine,1955,133,,242,627
Babine,1955,244,,243,871
Babine,1955,265,,244,1136
Babine,1955,212,,245,1348
Babine,1955,215,,246,1563
Babine,1955,135,,247,1698
Babine,1955,106,,248,1804
Babine,1955,104,,249,1908
Babine,1955,77,,250,1985
Babine,1955,46,,251,2031
Babine,1955,36,,252,2067
Babine,1955,37,,253,2104
Babine,1955,16,,254,2120
Babine,1955,21,,255,2141
Babine,1955,1,,256,2142
Babine,1955,6,,257,2148
Babine,1955,1,,258,2149
Babine,1955,2,,259,2151
Babine,1955,0,,260,2151
Babine,1956,0,,224,0
Babine,1956,1,,225,1
Babine,1956,2,,226,3
Babine,1956,5,,227,8
Babine,1956,10,,228,18
Babine,1956,17,,229,35
Babine,1956,14,,230,49
Babine,1956,10,,231,59
Babine,1956,34,,232,93
Babine,1956,75,,233,168
Babine,1956,75,,234,243
Babine,1956,86,,235,329
Babine,1956,115,,236,444
Babine,1956,111,,237,555
Babine,1956,31,,238,586
Babine,1956,32,,239,618
Babine,1956,31,,240,649
Babine,1956,42,,241,691
Babine,1956,61,,242,752
Babine,1956,95,,243,847
Babine,1956,86,,244,933
Babine,1956,116,,245,1049
Babine,1956,169,,246,1218
Babine,1956,172,,247,1390
Babine,1956,183,,248,1573
Babine,1956,115,,249,1688
Babine,1956,175,,250,1863
Babine,1956,116,,251,1979
Babine,1956,156,,252,2135
Babine,1956,104,,253,2239
Babine,1956,84,,254,2323
Babine,1956,76,,255,2399
Babine,1956,66,,256,2465
Babine,1956,84,,257,2549
Babine,1956,54,,258,2603
Babine,1956,21,,259,2624
Babine,1956,14,,260,2638
Babine,1956,16,,261,2654
Babine,1956,19,,262,2673
Babine,1956,4,,263,2677
Babine,1956,6,,264,2683
Babine,1956,5,,265,2688
Babine,1956,3,,266,2691
Babine,1956,0,,267,2691
Babine,1957,0,,212,0
Babine,1957,2,,213,2
Babine,1957,1,,214,3
Babine,1957,3,,215,6
Babine,1957,15,,216,21
Babine,1957,60,,217,81
Babine,1957,171,,218,252
Babine,1957,184,,219,436
Babine,1957,240,,220,676
Babine,1957,275,,221,951
Babine,1957,446,,222,1397
Babine,1957,545,,223,1942
Babine,1957,511,,224,2453
Babine,1957,433,,225,2886
Babine,1957,372,,226,3258
Babine,1957,497,,227,3755
Babine,1957,485,,228,4240
Babine,1957,460,,229,4700
Babine,1957,533,,230,5233
Babine,1957,737,,231,5970
Babine,1957,1179,,232,7149
Babine,1957,1272,,233,8421
Babine,1957,1766,,234,10187
Babine,1957,2156,,235,12343
Babine,1957,2378,,236,14721
Babine,1957,1964,,237,16685
Babine,1957,2005,,238,18690
Babine,1957,1341,,239,20031
Babine,1957,743,,240,20774
Babine,1957,838,,241,21612
Babine,1957,1140,,242,22752
Babine,1957,958,,243,23710
Babine,1957,659,,244,24369
Babine,1957,638,,245,25007
Babine,1957,358,,246,25365
Babine,1957,204,,247,25569
Babine,1957,116,,248,25685
Babine,1957,62,,249,25747
Babine,1957,27,,250,25774
Babine,1957,42,,251,25816
Babine,1957,24,,252,25840
Babine,1957,5,,253,25845
Babine,1957,7,,254,25852
Babine,1957,7,,255,25859
Babine,1957,1,,256,25860
Babine,1957,1,,257,25861
Babine,1957,4,,258,25865
Babine,1957,0,,259,25865
Babine,1958,0,,213,0
Babine,1958,1,,214,1
Babine,1958,0,,215,1
Babine,1958,0,,216,1
Babine,1958,5,,217,6
Babine,1958,3,,218,9
Babine,1958,4,,219,13
Babine,1958,7,,220,20
Babine,1958,8,,221,28
Babine,1958,9,,222,37
Babine,1958,11,,223,48
Babine,1958,22,,224,70
Babine,1958,49,,225,119
Babine,1958,143,,226,262
Babine,1958,227,,227,489
Babine,1958,251,,228,740
Babine,1958,208,,229,948
Babine,1958,245,,230,1193
Babine,1958,148,,231,1341
Babine,1958,147,,232,1488
Babine,1958,82,,233,1570
Babine,1958,96,,234,1666
Babine,1958,126,,235,1792
Babine,1958,148,,236,1940
Babine,1958,180,,237,2120
Babine,1958,208,,238,2328
Babine,1958,408,,239,2736
Babine,1958,323,,240,3059
Babine,1958,262,,241,3321
Babine,1958,252,,242,3573
Babine,1958,182,,243,3755
Babine,1958,348,,244,4103
Babine,1958,409,,245,4512
Babine,1958,325,,246,4837
Babine,1958,254,,247,5091
Babine,1958,220,,248,5311
Babine,1958,191,,249,5502
Babine,1958,115,,250,5617
Babine,1958,198,,251,5815
Babine,1958,214,,252,6029
Babine,1958,189,,253,6218
Babine,1958,97,,254,6315
Babine,1958,90,,255,6405
Babine,1958,68,,256,6473
Babine,1958,44,,257,6517
Babine,1958,29,,258,6546
Babine,1958,18,,259,6564
Babine,1958,16,,260,6580
Babine,1958,4,,261,6584
Babine,1958,7,,262,6591
Babine,1958,2,,263,6593
Babine,1958,4,,264,6597
Babine,1958,2,,265,6599
Babine,1958,0,,266,6599
Babine,1958,1,,267,6600
Babine,1958,0,,268,6600
Babine,1959,0,,213,0
Babine,1959,1,,214,1
Babine,1959,0,,215,1
Babine,1959,2,,216,3
Babine,1959,2,,217,5
Babine,1959,0,,218,5
Babine,1959,13,,219,18
Babine,1959,12,,220,30
Babine,1959,35,,221,65
Babine,1959,91,,222,156
Babine,1959,282,,223,438
Babine,1959,685,,224,1123
Babine,1959,1540,,225,2663
Babine,1959,2585,,226,5248
Babine,1959,3259,,227,8507
Babine,1959,3124,,228,11631
Babine,1959,3399,,229,15030
Babine,1959,3194,,230,18224
Babine,1959,2945,,231,21169
Babine,1959,2606,,232,23775
Babine,1959,3046,,233,26821
Babine,1959,2656,,234,29477
Babine,1959,2592,,235,32069
Babine,1959,2322,,236,34391
Babine,1959,2220,,237,36611
Babine,1959,2701,,238,39312
Babine,1959,2736,,239,42048
Babine,1959,2378,,240,44426
Babine,1959,1476,,241,45902
Babine,1959,1048,,242,46950
Babine,1959,1487,,243,48437
Babine,1959,1451,,244,49888
Babine,1959,1064,,245,50952
Babine,1959,940,,246,51892
Babine,1959,881,,247,52773
Babine,1959,728,,248,53501
Babine,1959,787,,249,54288
Babine,1959,582,,250,54870
Babine,1959,335,,251,55205
Babine,1959,516,,252,55721
Babine,1959,354,,253,56075
Babine,1959,271,,254,56346
Babine,1959,129,,255,56475
Babine,1959,86,,256,56561
Babine,1959,103,,257,56664
Babine,1959,48,,258,56712
Babine,1959,31,,259,56743
Babine,1959,10,,260,56753
Babine,1959,5,,261,56758
Babine,1959,2,,262,56760
Babine,1959,4,,263,56764
Babine,1959,1,,264,56765
Babine,1959,1,,265,56766
Babine,1959,0,,266,56766
Babine,1960,0,,225,0
Babine,1960,2,,226,2
Babine,1960,1,,227,3
Babine,1960,7,,228,10
Babine,1960,12,,229,22
Babine,1960,18,,230,40
Babine,1960,35,,231,75
Babine,1960,37,,232,112
Babine,1960,30,,233,142
Babine,1960,31,,234,173
Babine,1960,79,,235,252
Babine,1960,67,,236,319
Babine,1960,150,,237,469
Babine,1960,121,,238,590
Babine,1960,131,,239,721
Babine,1960,187,,240,908
Babine,1960,142,,241,1050
Babine,1960,204,,242,1254
Babine,1960,184,,243,1438
Babine,1960,367,,244,1805
Babine,1960,438,,245,2243
Babine,1960,325,,246,2568
Babine,1960,237,,247,2805
Babine,1960,209,,248,3014
Babine,1960,151,,249,3165
Babine,1960,184,,250,3349
Babine,1960,175,,251,3524
Babine,1960,189,,252,3713
Babine,1960,217,,253,3930
Babine,1960,188,,254,4118
Babine,1960,124,,255,4242
Babine,1960,83,,256,4325
Babine,1960,101,,257,4426
Babine,1960,79,,258,4505
Babine,1960,98,,259,4603
Babine,1960,87,,260,4690
Babine,1960,65,,261,4755
Babine,1960,38,,262,4793
Babine,1960,40,,263,4833
Babine,1960,12,,264,4845
Babine,1960,11,,265,4856
Babine,1960,6,,266,4862
Babine,1960,6,,267,4868
Babine,1960,7,,268,4875
Babine,1960,1,,269,4876
Babine,1960,0,,270,4876
Babine,1961,0,,204,0
Babine,1961,2,,205,2
Babine,1961,0,,206,2
Babine,1961,0,,207,2
Babine,1961,0,,208,2
Babine,1961,1,,209,3
Babine,1961,4,,210,7
Babine,1961,20,,211,27
Babine,1961,24,,212,51
Babine,1961,165,,213,216
Babine,1961,84,,214,300
Babine,1961,148,,215,448
Babine,1961,219,,216,667
Babine,1961,722,,217,1389
Babine,1961,915,,218,2304
Babine,1961,1070,,219,3374
Babine,1961,746,,220,4120
Babine,1961,612,,221,4732
Babine,1961,716,,222,5448
Babine,1961,917,,223,6365
Babine,1961,1105,,224,7470
Babine,1961,2172,,225,9642
Babine,1961,2242,,226,11884
Babine,1961,2284,,227,14168
Babine,1961,2684,,228,16852
Babine,1961,3128,,229,19980
Babine,1961,3992,,230,23972
Babine,1961,3815,,231,27787
Babine,1961,4111,,232,31898
Babine,1961,4182,,233,36080
Babine,1961,3722,,234,39802
Babine,1961,3537,,235,43339
Babine,1961,3412,,236,46751
Babine,1961,2661,,237,49412
Babine,1961,2686,,238,52098
Babine,1961,2758,,239,54856
Babine,1961,2117,,240,56973
Babine,1961,2181,,241,59154
Babine,1961,2282,,242,61436
Babine,1961,2997,,243,64433
Babine,1961,1098,,244,65531
Babine,1961,937,,245,66468
Babine,1961,620,,246,67088
Babine,1961,648,,247,67736
Babine,1961,545,,248,68281
Babine,1961,510,,249,68791
Babine,1961,227,,250,69018
Babine,1961,202,,251,69220
Babine,1961,170,,252,69390
Babine,1961,135,,253,69525
Babine,1961,122,,254,69647
Babine,1961,126,,255,69773
Babine,1961,94,,256,69867
Babine,1961,69,,257,69936
Babine,1961,49,,258,69985
Babine,1961,25,,259,70010
Babine,1961,13,,260,70023
Babine,1961,9,,261,70032
Babine,1961,6,,262,70038
Babine,1961,6,,263,70044
Babine,1961,0,,264,70044
Babine,1962,0,,221,0
Babine,1962,1,,222,1
Babine,1962,20,,223,21
Babine,1962,73,,224,94
Babine,1962,99,,225,193
Babine,1962,188,,226,381
Babine,1962,300,,227,681
Babine,1962,435,,228,1116
Babine,1962,622,,229,1738
Babine,1962,644,,230,2382
Babine,1962,677,,231,3059
Babine,1962,718,,232,3777
Babine,1962,152,,233,3929
Babine,1962,806,,234,4735
Babine,1962,881,,235,5616
Babine,1962,982,,236,6598
Babine,1962,667,,237,7265
Babine,1962,962,,238,8227
Babine,1962,1420,,239,9647
Babine,1962,1507,,240,11154
Babine,1962,1911,,241,13065
Babine,1962,2588,,242,15653
Babine,1962,3171,,243,18824
Babine,1962,3118,,244,21942
Babine,1962,2139,,245,24081
Babine,1962,1736,,246,25817
Babine,1962,1472,,247,27289
Babine,1962,2238,,248,29527
Babine,1962,1620,,249,31147
Babine,1962,1136,,250,32283
Babine,1962,836,,251,33119
Babine,1962,874,,252,33993
Babine,1962,921,,253,34914
Babine,1962,609,,254,35523
Babine,1962,444,,255,35967
Babine,1962,336,,256,36303
Babine,1962,260,,257,36563
Babine,1962,276,,258,36839
Babine,1962,335,,259,37174
Babine,1962,123,,260,37297
Babine,1962,59,,261,37356
Babine,1962,38,,262,37394
Babine,1962,21,,263,37415
Babine,1962,66,,264,37481
Babine,1962,19,,265,37500
Babine,1963,0,,215,0
Babine,1963,3,,216,3
Babine,1963,4,,217,7
Babine,1963,8,,218,15
Babine,1963,29,,219,44
Babine,1963,81,,220,125
Babine,1963,230,,221,355
Babine,1963,420,,222,775
Babine,1963,1326,,223,2101
Babine,1963,2453,,224,4554
Babine,1963,3749,,225,8303
Babine,1963,6181,,226,14484
Babine,1963,4640,,227,19124
Babine,1963,5797,,228,24921
Babine,1963,5755,,229,30676
Babine,1963,3841,,230,34517
Babine,1963,3865,,231,38382
Babine,1963,5239,,232,43621
Babine,1963,6560,,233,50181
Babine,1963,5355,,234,55536
Babine,1963,4965,,235,60501
Babine,1963,4626,,236,65127
Babine,1963,3705,,237,68832
Babine,1963,3646,,238,72478
Babine,1963,3451,,239,75929
Babine,1963,2994,,240,78923
Babine,1963,2392,,241,81315
Babine,1963,1682,,242,82997
Babine,1963,1372,,243,84369
Babine,1963,1388,,244,85757
Babine,1963,981,,245,86738
Babine,1963,812,,246,87550
Babine,1963,502,,247,88052
Babine,1963,451,,248,88503
Babine,1963,576,,249,89079
Babine,1963,574,,250,89653
Babine,1963,431,,251,90084
Babine,1963,231,,252,90315
Babine,1963,117,,253,90432
Babine,1963,68,,254,90500
Babine,1963,66,,255,90566
Babine,1963,34,,256,90600
Babine,1965,0,,212,0
Babine,1965,1,,213,1
Babine,1965,1,,214,2
Babine,1965,12,,215,14
Babine,1965,11,,216,25
Babine,1965,26,,217,51
Babine,1965,54,,218,105
Babine,1965,112,,219,217
Babine,1965,173,,220,390
Babine,1965,347,,221,737
Babine,1965,374,,222,1111
Babine,1965,646,,223,1757
Babine,1965,762,,224,2519
Babine,1965,876,,225,3395
Babine,1965,987,,226,4382
Babine,1965,1195,,227,5577
Babine,1965,1593,,228,7170
Babine,1965,1799,,229,8969
Babine,1965,1974,,230,10943
Babine,1965,3408,,231,14351
Babine,1965,5203,,232,19554
Babine,1965,6765,,233,26319
Babine,1965,6062,,234,32381
Babine,1965,4784,,235,37165
Babine,1965,4508,,236,41673
Babine,1965,3352,,237,45025
Babine,1965,3706,,238,48731
Babine,1965,3968,,239,52699
Babine,1965,2779,,240,55478
Babine,1965,1348,,241,56826
Babine,1965,999,,242,57825
Babine,1965,1330,,243,59155
Babine,1965,1256,,244,60411
Babine,1965,805,,245,61216
Babine,1965,792,,246,62008
Babine,1965,870,,247,62878
Babine,1965,806,,248,63684
Babine,1965,856,,249,64540
Babine,1965,694,,250,65234
Babine,1965,531,,251,65765
Babine,1965,469,,252,66234
Babine,1965,366,,253,66600
Babine,1965,251,,254,66851
Babine,1965,131,,255,66982
Babine,1965,163,,256,67145
Babine,1965,55,,257,67200
Babine,1966,0,,219,0
Babine,1966,1,,220,1
Babine,1966,5,,221,6
Babine,1966,9,,222,15
Babine,1966,17,,223,32
Babine,1966,21,,224,53
Babine,1966,20,,225,73
Babine,1966,55,,226,128
Babine,1966,75,,227,203
Babine,1966,156,,228,359
Babine,1966,229,,229,588
Babine,1966,227,,230,815
Babine,1966,289,,231,1104
Babine,1966,298,,232,1402
Babine,1966,480,,233,1882
Babine,1966,640,,234,2522
Babine,1966,1395,,235,3917
Babine,1966,2209,,236,6126
Babine,1966,4719,,237,10845
Babine,1966,4311,,238,15156
Babine,1966,3953,,239,19109
Babine,1966,4470,,240,23579
Babine,1966,3309,,241,26888
Babine,1966,3150,,242,30038
Babine,1966,2980,,243,33018
Babine,1966,1312,,244,34330
Babine,1966,1123,,245,35453
Babine,1966,1154,,246,36607
Babine,1966,1378,,247,37985
Babine,1966,1322,,248,39307
Babine,1966,1593,,249,40900
Babine,1966,958,,250,41858
Babine,1966,712,,251,42570
Babine,1966,578,,252,43148
Babine,1966,803,,253,43951
Babine,1966,492,,254,44443
Babine,1966,482,,255,44925
Babine,1966,553,,256,45478
Babine,1966,348,,257,45826
Babine,1966,174,,258,46000
Babine,1967,0,,212,0
Babine,1967,1,,213,1
Babine,1967,11,,214,12
Babine,1967,4,,215,16
Babine,1967,7,,216,23
Babine,1967,23,,217,46
Babine,1967,15,,218,61
Babine,1967,51,,219,112
Babine,1967,67,,220,179
Babine,1967,78,,221,257
Babine,1967,127,,222,384
Babine,1967,143,,223,527
Babine,1967,166,,224,693
Babine,1967,273,,225,966
Babine,1967,272,,226,1238
Babine,1967,294,,227,1532
Babine,1967,354,,228,1886
Babine,1967,480,,229,2366
Babine,1967,911,,230,3277
Babine,1967,2466,,231,5743
Babine,1967,2968,,232,8711
Babine,1967,2845,,233,11556
Babine,1967,2600,,234,14156
Babine,1967,2249,,235,16405
Babine,1967,1551,,236,17956
Babine,1967,1222,,237,19178
Babine,1967,951,,238,20129
Babine,1967,1736,,239,21865
Babine,1967,1491,,240,23356
Babine,1967,1750,,241,25106
Babine,1967,2449,,242,27555
Babine,1967,1792,,243,29347
Babine,1967,2201,,244,31548
Babine,1967,1525,,245,33073
Babine,1967,1512,,246,34585
Babine,1967,1522,,247,36107
Babine,1967,1591,,248,37698
Babine,1967,1395,,249,39093
Babine,1967,747,,250,39840
Babine,1967,540,,251,40380
Babine,1967,568,,252,40948
Babine,1967,544,,253,41492
Babine,1967,553,,254,42045
Babine,1967,487,,255,42532
Babine,1967,361,,256,42893
Babine,1967,170,,257,43063
Babine,1967,163,,258,43226
Babine,1967,82,,259,43308
Babine,1967,68,,260,43376
Babine,1967,54,,261,43430
Babine,1967,31,,262,43461
Babine,1967,15,,263,43476
Babine,1967,12,,264,43488
Babine,1967,6,,265,43494
Babine,1967,5,,266,43499
Babine,1968,0,,219,0
Babine,1968,4,,220,4
Babine,1968,5,,221,9
Babine,1968,10,,222,19
Babine,1968,6,,223,25
Babine,1968,18,,224,43
Babine,1968,47,,225,90
Babine,1968,116,,226,206
Babine,1968,82,,227,288
Babine,1968,203,,228,491
Babine,1968,168,,229,659
Babine,1968,230,,230,889
Babine,1968,370,,231,1259
Babine,1968,705,,232,1964
Babine,1968,1144,,233,3108
Babine,1968,1985,,234,5093
Babine,1968,2423,,235,7516
Babine,1968,3380,,236,10896
Babine,1968,4303,,237,15199
Babine,1968,5275,,238,20474
Babine,1968,5703,,239,26177
Babine,1968,4107,,240,30284
Babine,1968,3208,,241,33492
Babine,1968,3636,,242,37128
Babine,1968,3989,,243,41117
Babine,1968,5132,,244,46249
Babine,1968,5317,,245,51566
Babine,1968,4678,,246,56244
Babine,1968,4179,,247,60423
Babine,1968,3504,,248,63927
Babine,1968,3479,,249,67406
Babine,1968,4362,,250,71768
Babine,1968,2707,,251,74475
Babine,1968,2574,,252,77049
Babine,1968,1824,,253,78873
Babine,1968,2025,,254,80898
Babine,1968,1075,,255,81973
Babine,1968,757,,256,82730
Babine,1968,852,,257,83582
Babine,1968,418,,258,84000
Babine,1969,0,,210,0
Babine,1969,1,,211,1
Babine,1969,0,,212,1
Babine,1969,2,,213,3
Babine,1969,7,,214,10
Babine,1969,3,,215,13
Babine,1969,4,,216,17
Babine,1969,10,,217,27
Babine,1969,65,,218,92
Babine,1969,53,,219,145
Babine,1969,35,,220,180
Babine,1969,36,,221,216
Babine,1969,26,,222,242
Babine,1969,48,,223,290
Babine,1969,101,,224,391
Babine,1969,240,,225,631
Babine,1969,197,,226,828
Babine,1969,118,,227,946
Babine,1969,69,,228,1015
Babine,1969,164,,229,1179
Babine,1969,94,,230,1273
Babine,1969,96,,231,1369
Babine,1969,71,,232,1440
Babine,1969,65,,233,1505
Babine,1969,66,,234,1571
Babine,1969,84,,235,1655
Babine,1969,328,,236,1983
Babine,1969,2088,,237,4071
Babine,1969,1421,,238,5492
Babine,1969,4249,,239,9741
Babine,1969,8037,,240,17778
Babine,1969,4946,,241,22724
Babine,1969,1391,,242,24115
Babine,1969,620,,243,24735
Babine,1969,778,,244,25513
Babine,1969,2692,,245,28205
Babine,1969,3690,,246,31895
Babine,1969,7348,,247,39243
Babine,1969,6831,,248,46074
Babine,1969,6475,,249,52549
Babine,1969,4430,,250,56979
Babine,1969,3490,,251,60469
Babine,1969,2954,,252,63423
Babine,1969,2620,,253,66043
Babine,1969,3006,,254,69049
Babine,1969,2445,,255,71494
Babine,1969,1185,,256,72679
Babine,1969,915,,257,73594
Babine,1969,659,,258,74253
Babine,1969,485,,259,74738
Babine,1969,277,,260,75015
Babine,1969,204,,261,75219
Babine,1969,138,,262,75357
Babine,1969,67,,263,75424
Babine,1969,75,,264,75499
Babine,1970,0,,219,0
Babine,1970,1,,220,1
Babine,1970,3,,221,4
Babine,1970,3,,222,7
Babine,1970,1,,223,8
Babine,1970,13,,224,21
Babine,1970,26,,225,47
Babine,1970,88,,226,135
Babine,1970,166,,227,301
Babine,1970,135,,228,436
Babine,1970,306,,229,742
Babine,1970,490,,230,1232
Babine,1970,1299,,231,2531
Babine,1970,1591,,232,4122
Babine,1970,2952,,233,7074
Babine,1970,4652,,234,11726
Babine,1970,8869,,235,20595
Babine,1970,11991,,236,32586
Babine,1970,15220,,237,47806
Babine,1970,13543,,238,61349
Babine,1970,11775,,239,73124
Babine,1970,10419,,240,83543
Babine,1970,9166,,241,92709
Babine,1970,7807,,242,100516
Babine,1970,6029,,243,106545
Babine,1970,6395,,244,112940
Babine,1970,7838,,245,120778
Babine,1970,8378,,246,129156
Babine,1970,6964,,247,136120
Babine,1970,7181,,248,143301
Babine,1970,5426,,249,148727
Babine,1970,3609,,250,152336
Babine,1970,2932,,251,155268
Babine,1970,2660,,252,157928
Babine,1970,2306,,253,160234
Babine,1970,2002,,254,162236
Babine,1970,1584,,255,163820
Babine,1970,889,,256,164709
Babine,1970,782,,257,165491
Babine,1970,509,,258,166000
Babine,1971,0,,217,0
Babine,1971,4,,218,4
Babine,1971,21,,219,25
Babine,1971,49,,220,74
Babine,1971,72,,221,146
Babine,1971,80,,222,226
Babine,1971,118,,223,344
Babine,1971,195,,224,539
Babine,1971,273,,225,812
Babine,1971,272,,226,1084
Babine,1971,369,,227,1453
Babine,1971,540,,228,1993
Babine,1971,749,,229,2742
Babine,1971,1034,,230,3776
Babine,1971,1314,,231,5090
Babine,1971,1823,,232,6913
Babine,1971,2426,,233,9339
Babine,1971,3117,,234,12456
Babine,1971,2908,,235,15364
Babine,1971,3092,,236,18456
Babine,1971,3253,,237,21709
Babine,1971,3784,,238,25493
Babine,1971,4891,,239,30384
Babine,1971,6132,,240,36516
Babine,1971,5346,,241,41862
Babine,1971,4978,,242,46840
Babine,1971,4514,,243,51354
Babine,1971,4779,,244,56133
Babine,1971,5919,,245,62052
Babine,1971,3919,,246,65971
Babine,1971,2885,,247,68856
Babine,1971,1868,,248,70724
Babine,1971,1861,,249,72585
Babine,1971,1790,,250,74375
Babine,1971,1823,,251,76198
Babine,1971,1427,,252,77625
Babine,1971,2133,,253,79758
Babine,1971,1656,,254,81414
Babine,1971,1873,,255,83287
Babine,1971,2320,,256,85607
Babine,1971,1780,,257,87387
Babine,1971,1645,,258,89032
Babine,1971,1308,,259,90340
Babine,1971,821,,260,91161
Babine,1971,870,,261,92031
Babine,1971,573,,262,92604
Babine,1971,236,,263,92840
Babine,1971,145,,264,92985
Babine,1971,105,,265,93090
Babine,1971,66,,266,93156
Babine,1971,44,,267,93200
Babine,1972,0,,228,0
Babine,1972,1,,229,1
Babine,1972,10,,230,11
Babine,1972,25,,231,36
Babine,1972,55,,232,91
Babine,1972,72,,233,163
Babine,1972,85,,234,248
Babine,1972,125,,235,373
Babine,1972,126,,236,499
Babine,1972,122,,237,621
Babine,1972,250,,238,871
Babine,1972,266,,239,1137
Babine,1972,566,,240,1703
Babine,1972,980,,241,2683
Babine,1972,1191,,242,3874
Babine,1972,1825,,243,5699
Babine,1972,2079,,244,7778
Babine,1972,1543,,245,9321
Babine,1972,2182,,246,11503
Babine,1972,2121,,247,13624
Babine,1972,2301,,248,15925
Babine,1972,2311,,249,18236
Babine,1972,2407,,250,20643
Babine,1972,1832,,251,22475
Babine,1972,2321,,252,24796
Babine,1972,1336,,253,26132
Babine,1972,1430,,254,27562
Babine,1972,1800,,255,29362
Babine,1972,1045,,256,30407
Babine,1972,453,,257,30860
Babine,1972,457,,258,31317
Babine,1972,282,,259,31599
Babine,1972,179,,260,31778
Babine,1972,114,,261,31892
Babine,1972,96,,262,31988
Babine,1972,115,,263,32103
Babine,1972,63,,264,32166
Babine,1973,0,,210,0
Babine,1973,1,,211,1
Babine,1973,2,,212,3
Babine,1973,2,,213,5
Babine,1973,3,,214,8
Babine,1973,5,,215,13
Babine,1973,9,,216,22
Babine,1973,25,,217,47
Babine,1973,21,,218,68
Babine,1973,40,,219,108
Babine,1973,50,,220,158
Babine,1973,174,,221,332
Babine,1973,230,,222,562
Babine,1973,206,,223,768
Babine,1973,364,,224,1132
Babine,1973,532,,225,1664
Babine,1973,1105,,226,2769
Babine,1973,2017,,227,4786
Babine,1973,2583,,228,7369
Babine,1973,1646,,229,9015
Babine,1973,1121,,230,10136
Babine,1973,2508,,231,12644
Babine,1973,4779,,232,17423
Babine,1973,6573,,233,23996
Babine,1973,6728,,234,30724
Babine,1973,8265,,235,38989
Babine,1973,9403,,236,48392
Babine,1973,9566,,237,57958
Babine,1973,5823,,238,63781
Babine,1973,6169,,239,69950
Babine,1973,6720,,240,76670
Babine,1973,3416,,241,80086
Babine,1973,2997,,242,83083
Babine,1973,2831,,243,85914
Babine,1973,2664,,244,88578
Babine,1973,3431,,245,92009
Babine,1973,2063,,246,94072
Babine,1973,2421,,247,96493
Babine,1973,1312,,248,97805
Babine,1973,1959,,249,99764
Babine,1973,2044,,250,101808
Babine,1973,2105,,251,103913
Babine,1973,1322,,252,105235
Babine,1973,1692,,253,106927
Babine,1973,1278,,254,108205
Babine,1973,1207,,255,109412
Babine,1973,646,,256,110058
Babine,1973,475,,257,110533
Babine,1973,453,,258,110986
Babine,1974,0,,226,0
Babine,1974,11,,227,11
Babine,1974,30,,228,41
Babine,1974,121,,229,162
Babine,1974,69,,230,231
Babine,1974,74,,231,305
Babine,1974,96,,232,401
Babine,1974,103,,233,504
Babine,1974,57,,234,561
Babine,1974,109,,235,670
Babine,1974,225,,236,895
Babine,1974,307,,237,1202
Babine,1974,204,,238,1406
Babine,1974,266,,239,1672
Babine,1974,905,,240,2577
Babine,1974,751,,241,3328
Babine,1974,1590,,242,4918
Babine,1974,1668,,243,6586
Babine,1974,1899,,244,8485
Babine,1974,1352,,245,9837
Babine,1974,1386,,246,11223
Babine,1974,1417,,247,12640
Babine,1974,947,,248,13587
Babine,1974,795,,249,14382
Babine,1974,905,,250,15287
Babine,1974,515,,251,15802
Babine,1974,503,,252,16305
Babine,1974,358,,253,16663
Babine,1974,289,,254,16952
Babine,1974,273,,255,17225
Babine,1974,104,,256,17329
Babine,1974,197,,257,17526
Babine,1974,113,,258,17639
Babine,1974,94,,259,17733
Babine,1974,66,,260,17799
Babine,1974,36,,261,17835
Babine,1974,20,,262,17855
Babine,1975,0,,217,0
Babine,1975,1,,218,1
Babine,1975,2,,219,3
Babine,1975,7,,220,10
Babine,1975,12,,221,22
Babine,1975,17,,222,39
Babine,1975,31,,223,70
Babine,1975,43,,224,113
Babine,1975,113,,225,226
Babine,1975,170,,226,396
Babine,1975,261,,227,657
Babine,1975,1047,,228,1704
Babine,1975,2018,,229,3722
Babine,1975,3884,,230,7606
Babine,1975,4959,,231,12565
Babine,1975,9930,,232,22495
Babine,1975,8238,,233,30733
Babine,1975,5229,,234,35962
Babine,1975,7810,,235,43772
Babine,1975,7396,,236,51168
Babine,1975,9515,,237,60683
Babine,1975,10851,,238,71534
Babine,1975,9111,,239,80645
Babine,1975,13037,,240,93682
Babine,1975,12331,,241,106013
Babine,1975,14525,,242,120538
Babine,1975,8492,,243,129030
Babine,1975,7600,,244,136630
Babine,1975,4744,,245,141374
Babine,1975,7476,,246,148850
Babine,1975,6103,,247,154953
Babine,1975,6137,,248,161090
Babine,1975,6116,,249,167206
Babine,1975,4717,,250,171923
Babine,1975,5473,,251,177396
Babine,1975,5155,,252,182551
Babine,1975,4219,,253,186770
Babine,1975,2886,,254,189656
Babine,1975,1228,,255,190884
Babine,1975,2058,,256,192942
Babine,1975,1574,,257,194516
Babine,1975,955,,258,195471
Babine,1975,863,,259,196334
Babine,1975,202,,260,196536
Babine,1975,549,,261,197085
Babine,1975,91,,262,197176
Babine,1975,80,,263,197256
Babine,1975,28,,264,197284
Babine,1975,4,,265,197288
Babine,1975,9,,266,197297
Babine,1975,5,,267,197302
Babine,1975,1,,268,197303
Babine,1975,0,,269,197303
Babine,1975,4,,270,197307
Babine,1975,0,,271,197307
Babine,1975,0,,272,197307
Babine,1975,0,,273,197307
Babine,1976,0,,225,0
Babine,1976,1,,226,1
Babine,1976,4,,227,5
Babine,1976,0,,228,5
Babine,1976,2,,229,7
Babine,1976,0,,230,7
Babine,1976,10,,231,17
Babine,1976,0,,232,17
Babine,1976,1,,233,18
Babine,1976,0,,234,18
Babine,1976,1,,235,19
Babine,1976,4,,236,23
Babine,1976,27,,237,50
Babine,1976,78,,238,128
Babine,1976,259,,239,387
Babine,1976,877,,240,1264
Babine,1976,822,,241,2086
Babine,1976,1452,,242,3538
Babine,1976,4158,,243,7696
Babine,1976,4735,,244,12431
Babine,1976,6649,,245,19080
Babine,1976,7441,,246,26521
Babine,1976,8253,,247,34774
Babine,1976,7444,,248,42218
Babine,1976,6671,,249,48889
Babine,1976,7710,,250,56599
Babine,1976,5135,,251,61734
Babine,1976,4873,,252,66607
Babine,1976,4330,,253,70937
Babine,1976,3533,,254,74470
Babine,1976,3840,,255,78310
Babine,1976,3144,,256,81454
Babine,1976,2925,,257,84379
Babine,1976,2774,,258,87153
Babine,1976,2192,,259,89345
Babine,1976,1548,,260,90893
Babine,1976,864,,261,91757
Babine,1976,491,,262,92248
Babine,1976,368,,263,92616
Babine,1976,321,,264,92937
Babine,1976,259,,265,93196
Babine,1976,213,,266,93409
Babine,1976,136,,267,93545
Babine,1976,147,,268,93692
Babine,1976,94,,269,93786
Babine,1976,33,,270,93819
Babine,1976,1,,271,93820
Babine,1976,1,,272,93821
Babine,1976,1,,273,93822
Babine,1976,2,,274,93824
Babine,1976,1,,275,93825
Babine,1976,0,,276,93825
Babine,1977,0,,213,0
Babine,1977,6,,214,6
Babine,1977,7,,215,13
Babine,1977,22,,216,35
Babine,1977,109,,217,144
Babine,1977,707,,218,851
Babine,1977,737,,219,1588
Babine,1977,1035,,220,2623
Babine,1977,1220,,221,3843
Babine,1977,1625,,222,5468
Babine,1977,1807,,223,7275
Babine,1977,2026,,224,9301
Babine,1977,2296,,225,11597
Babine,1977,2554,,226,14151
Babine,1977,2426,,227,16577
Babine,1977,1512,,228,18089
Babine,1977,1665,,229,19754
Babine,1977,1804,,230,21558
Babine,1977,2571,,231,24129
Babine,1977,1386,,232,25515
Babine,1977,1968,,233,27483
Babine,1977,2377,,234,29860
Babine,1977,1793,,235,31653
Babine,1977,1422,,236,33075
Babine,1977,1216,,237,34291
Babine,1977,771,,238,35062
Babine,1977,949,,239,36011
Babine,1977,1044,,240,37055
Babine,1977,2235,,241,39290
Babine,1977,3844,,242,43134
Babine,1977,1959,,243,45093
Babine,1977,868,,244,45961
Babine,1977,1089,,245,47050
Babine,1977,1092,,246,48142
Babine,1977,1214,,247,49356
Babine,1977,2426,,248,51782
Babine,1977,2443,,249,54225
Babine,1977,1817,,250,56042
Babine,1977,1091,,251,57133
Babine,1977,1628,,252,58761
Babine,1977,1255,,253,60016
Babine,1977,899,,254,60915
Babine,1977,1003,,255,61918
Babine,1977,711,,256,62629
Babine,1977,559,,257,63188
Babine,1977,639,,258,63827
Babine,1977,619,,259,64446
Babine,1977,433,,260,64879
Babine,1977,602,,261,65481
Babine,1977,586,,262,66067
Babine,1977,477,,263,66544
Babine,1977,489,,264,67033
Babine,1977,393,,265,67426
Babine,1977,243,,266,67669
Babine,1977,196,,267,67865
Babine,1977,103,,268,67968
Babine,1977,45,,269,68013
Babine,1977,24,,270,68037
Babine,1977,14,,271,68051
Babine,1977,6,,272,68057
Babine,1977,10,,273,68067
Babine,1977,4,,274,68071
Babine,1977,4,,275,68075
Babine,1977,0,,276,68075
Babine,1977,0,,277,68075
Babine,1977,2,,278,68077
Babine,1977,0,,279,68077
Babine,1978,0,,213,0
Babine,1978,14,,214,14
Babine,1978,47,,215,61
Babine,1978,17,,216,78
Babine,1978,76,,217,154
Babine,1978,55,,218,209
Babine,1978,247,,219,456
Babine,1978,253,,220,709
Babine,1978,243,,221,952
Babine,1978,155,,222,1107
Babine,1978,52,,223,1159
Babine,1978,79,,224,1238
Babine,1978,244,,225,1482
Babine,1978,545,,226,2027
Babine,1978,913,,227,2940
Babine,1978,1154,,228,4094
Babine,1978,2147,,229,6241
Babine,1978,1936,,230,8177
Babine,1978,2373,,231,10550
Babine,1978,3152,,232,13702
Babine,1978,5839,,233,19541
Babine,1978,5461,,234,25002
Babine,1978,5842,,235,30844
Babine,1978,6791,,236,37635
Babine,1978,8003,,237,45638
Babine,1978,5902,,238,51540
Babine,1978,5499,,239,57039
Babine,1978,4420,,240,61459
Babine,1978,5960,,241,67419
Babine,1978,7397,,242,74816
Babine,1978,7883,,243,82699
Babine,1978,12416,,244,95115
Babine,1978,8112,,245,103227
Babine,1978,8589,,246,111816
Babine,1978,6435,,247,118251
Babine,1978,6691,,248,124942
Babine,1978,5881,,249,130823
Babine,1978,5518,,250,136341
Babine,1978,6973,,251,143314
Babine,1978,4770,,252,148084
Babine,1978,6926,,253,155010
Babine,1978,7639,,254,162649
Babine,1978,7451,,255,170100
Babine,1978,2772,,256,172872
Babine,1978,1369,,257,174241
Babine,1978,863,,258,175104
Babine,1978,754,,259,175858
Babine,1978,409,,260,176267
Babine,1978,413,,261,176680
Babine,1978,376,,262,177056
Babine,1978,177,,263,177233
Babine,1978,260,,264,177493
Babine,1978,119,,265,177612
Babine,1978,41,,266,177653
Babine,1978,21,,267,177674
Babine,1978,12,,268,177686
Babine,1978,7,,269,177693
Babine,1978,4,,270,177697
Babine,1978,4,,271,177701
Babine,1978,1,,272,177702
Babine,1978,0,,273,177702
Babine,1978,1,,274,177703
Babine,1978,3,,275,177706
Babine,1978,0,,276,177706
Babine,1978,1,,277,177707
Babine,1978,1,,278,177708
Babine,1978,0,,279,177708
Babine,1979,0,,211,0
Babine,1979,1,,212,1
Babine,1979,0,,213,1
Babine,1979,31,,214,32
Babine,1979,76,,215,108
Babine,1979,142,,216,250
Babine,1979,227,,217,477
Babine,1979,422,,218,899
Babine,1979,636,,219,1535
Babine,1979,648,,220,2183
Babine,1979,737,,221,2920
Babine,1979,1364,,222,4284
Babine,1979,1774,,223,6058
Babine,1979,2142,,224,8200
Babine,1979,2228,,225,10428
Babine,1979,2187,,226,12615
Babine,1979,1803,,227,14418
Babine,1979,2013,,228,16431
Babine,1979,2238,,229,18669
Babine,1979,2898,,230,21567
Babine,1979,2408,,231,23975
Babine,1979,2243,,232,26218
Babine,1979,1870,,233,28088
Babine,1979,1858,,234,29946
Babine,1979,1647,,235,31593
Babine,1979,1721,,236,33314
Babine,1979,1834,,237,35148
Babine,1979,1332,,238,36480
Babine,1979,879,,239,37359
Babine,1979,789,,240,38148
Babine,1979,609,,241,38757
Babine,1979,666,,242,39423
Babine,1979,1275,,243,40698
Babine,1979,1340,,244,42038
Babine,1979,1579,,245,43617
Babine,1979,2192,,246,45809
Babine,1979,2045,,247,47854
Babine,1979,1344,,248,49198
Babine,1979,1030,,249,50228
Babine,1979,767,,250,50995
Babine,1979,729,,251,51724
Babine,1979,1988,,252,53712
Babine,1979,1041,,253,54753
Babine,1979,378,,254,55131
Babine,1979,193,,255,55324
Babine,1979,165,,256,55489
Babine,1979,40,,257,55529
Babine,1979,43,,258,55572
Babine,1979,24,,259,55596
Babine,1979,28,,260,55624
Babine,1979,24,,261,55648
Babine,1979,32,,262,55680
Babine,1979,4,,263,55684
Babine,1979,2,,264,55686
Babine,1979,3,,265,55689
Babine,1979,3,,266,55692
Babine,1979,1,,267,55693
Babine,1979,2,,268,55695
Babine,1979,5,,269,55700
Babine,1979,1,,270,55701
Babine,1979,0,,271,55701
Babine,1979,1,,272,55702
Babine,1979,1,,273,55703
Babine,1979,0,,274,55703
Babine,1980,0,,214,0
Babine,1980,2,,215,2
Babine,1980,0,,216,2
Babine,1980,1,,217,3
Babine,1980,1,,218,4
Babine,1980,1,,219,5
Babine,1980,6,,220,11
Babine,1980,3,,221,14
Babine,1980,9,,222,23
Babine,1980,33,,223,56
Babine,1980,298,,224,354
Babine,1980,570,,225,924
Babine,1980,1217,,226,2141
Babine,1980,1547,,227,3688
Babine,1980,2871,,228,6559
Babine,1980,5537,,229,12096
Babine,1980,9463,,230,21559
Babine,1980,9217,,231,30776
Babine,1980,7744,,232,38520
Babine,1980,5683,,233,44203
Babine,1980,6702,,234,50905
Babine,1980,5448,,235,56353
Babine,1980,7336,,236,63689
Babine,1980,7035,,237,70724
Babine,1980,6821,,238,77545
Babine,1980,7208,,239,84753
Babine,1980,6096,,240,90849
Babine,1980,6243,,241,97092
Babine,1980,3348,,242,100440
Babine,1980,6303,,243,106743
Babine,1980,6783,,244,113526
Babine,1980,7479,,245,121005
Babine,1980,10722,,246,131727
Babine,1980,9765,,247,141492
Babine,1980,10364,,248,151856
Babine,1980,15067,,249,166923
Babine,1980,16821,,250,183744
Babine,1980,8932,,251,192676
Babine,1980,5167,,252,197843
Babine,1980,2853,,253,200696
Babine,1980,2401,,254,203097
Babine,1980,2932,,255,206029
Babine,1980,2890,,256,208919
Babine,1980,3473,,257,212392
Babine,1980,4176,,258,216568
Babine,1980,5471,,259,222039
Babine,1980,4547,,260,226586
Babine,1980,5889,,261,232475
Babine,1980,5058,,262,237533
Babine,1980,3871,,263,241404
Babine,1980,2956,,264,244360
Babine,1980,1672,,265,246032
Babine,1980,1921,,266,247953
Babine,1980,1541,,267,249494
Babine,1980,1002,,268,250496
Babine,1980,704,,269,251200
Babine,1980,184,,270,251384
Babine,1980,34,,271,251418
Babine,1980,22,,272,251440
Babine,1980,11,,273,251451
Babine,1981,0,,212,0
Babine,1981,3,,213,3
Babine,1981,9,,214,12
Babine,1981,20,,215,32
Babine,1981,30,,216,62
Babine,1981,95,,217,157
Babine,1981,459,,218,616
Babine,1981,598,,219,1214
Babine,1981,618,,220,1832
Babine,1981,754,,221,2586
Babine,1981,905,,222,3491
Babine,1981,1470,,223,4961
Babine,1981,2187,,224,7148
Babine,1981,2364,,225,9512
Babine,1981,2453,,226,11965
Babine,1981,2756,,227,14721
Babine,1981,3620,,228,18341
Babine,1981,3606,,229,21947
Babine,1981,3984,,230,25931
Babine,1981,3595,,231,29526
Babine,1981,2524,,232,32050
Babine,1981,3263,,233,35313
Babine,1981,3100,,234,38413
Babine,1981,2707,,235,41120
Babine,1981,3131,,236,44251
Babine,1981,6985,,237,51236
Babine,1981,7329,,238,58565
Babine,1981,4206,,239,62771
Babine,1981,4326,,240,67097
Babine,1981,1782,,241,68879
Babine,1981,1300,,242,70179
Babine,1981,1135,,243,71314
Babine,1981,2199,,244,73513
Babine,1981,1253,,245,74766
Babine,1981,2704,,246,77470
Babine,1981,3047,,247,80517
Babine,1981,2676,,248,83193
Babine,1981,5021,,249,88214
Babine,1981,6395,,250,94609
Babine,1981,2549,,251,97158
Babine,1981,4429,,252,101587
Babine,1981,4906,,253,106493
Babine,1981,1769,,254,108262
Babine,1981,1310,,255,109572
Babine,1981,868,,256,110440
Babine,1981,575,,257,111015
Babine,1981,1395,,258,112410
Babine,1981,367,,259,112777
Babine,1981,591,,260,113368
Babine,1981,818,,261,114186
Babine,1981,269,,262,114455
Babine,1981,342,,263,114797
Babine,1981,168,,264,114965
Babine,1981,213,,265,115178
Babine,1981,85,,266,115263
Babine,1981,42,,267,115305
Babine,1981,25,,268,115330
Babine,1981,11,,269,115341
Babine,1981,5,,270,115346
Babine,1981,12,,271,115358
Babine,1981,2,,272,115360
Babine,1982,0,,210,0
Babine,1982,1,,211,1
Babine,1982,1,,212,2
Babine,1982,0,,213,2
Babine,1982,0,,214,2
Babine,1982,1,,215,3
Babine,1982,0,,216,3
Babine,1982,0,,217,3
Babine,1982,3,,218,6
Babine,1982,5,,219,11
Babine,1982,32,,220,43
Babine,1982,85,,221,128
Babine,1982,165,,222,293
Babine,1982,330,,223,623
Babine,1982,703,,224,1326
Babine,1982,782,,225,2108
Babine,1982,1488,,226,3596
Babine,1982,2496,,227,6092
Babine,1982,4466,,228,10558
Babine,1982,6109,,229,16667
Babine,1982,5937,,230,22604
Babine,1982,7286,,231,29890
Babine,1982,8624,,232,38514
Babine,1982,10578,,233,49092
Babine,1982,17620,,234,66712
Babine,1982,16358,,235,83070
Babine,1982,17683,,236,100753
Babine,1982,20370,,237,121123
Babine,1982,16300,,238,137423
Babine,1982,18175,,239,155598
Babine,1982,16169,,240,171767
Babine,1982,10346,,241,182113
Babine,1982,9561,,242,191674
Babine,1982,8573,,243,200247
Babine,1982,9307,,244,209554
Babine,1982,11824,,245,221378
Babine,1982,10916,,246,232294
Babine,1982,7431,,247,239725
Babine,1982,5583,,248,245308
Babine,1982,5249,,249,250557
Babine,1982,3581,,250,254138
Babine,1982,4894,,251,259032
Babine,1982,3833,,252,262865
Babine,1982,2985,,253,265850
Babine,1982,2509,,254,268359
Babine,1982,2004,,255,270363
Babine,1982,1623,,256,271986
Babine,1982,1196,,257,273182
Babine,1982,920,,258,274102
Babine,1982,1368,,259,275470
Babine,1982,1185,,260,276655
Babine,1982,758,,261,277413
Babine,1982,675,,262,278088
Babine,1982,638,,263,278726
Babine,1982,446,,264,279172
Babine,1982,370,,265,279542
Babine,1982,311,,266,279853
Babine,1982,103,,267,279956
Babine,1982,11,,268,279967
Babine,1982,40,,269,280007
Babine,1982,73,,270,280080
Babine,1983,0,,210,0
Babine,1983,6,,211,6
Babine,1983,15,,212,21
Babine,1983,32,,213,53
Babine,1983,71,,214,124
Babine,1983,40,,215,164
Babine,1983,152,,216,316
Babine,1983,239,,217,555
Babine,1983,352,,218,907
Babine,1983,594,,219,1501
Babine,1983,882,,220,2383
Babine,1983,1814,,221,4197
Babine,1983,3359,,222,7556
Babine,1983,6189,,223,13745
Babine,1983,8424,,224,22169
Babine,1983,8934,,225,31103
Babine,1983,10559,,226,41662
Babine,1983,15456,,227,57118
Babine,1983,13412,,228,70530
Babine,1983,11790,,229,82320
Babine,1983,15423,,230,97743
Babine,1983,13949,,231,111692
Babine,1983,14188,,232,125880
Babine,1983,14208,,233,140088
Babine,1983,16484,,234,156572
Babine,1983,14592,,235,171164
Babine,1983,14842,,236,186006
Babine,1983,16786,,237,202792
Babine,1983,9970,,238,212762
Babine,1983,15398,,239,228160
Babine,1983,13827,,240,241987
Babine,1983,19758,,241,261745
Babine,1983,11813,,242,273558
Babine,1983,16987,,243,290545
Babine,1983,17637,,244,308182
Babine,1983,13511,,245,321693
Babine,1983,10975,,246,332668
Babine,1983,9468,,247,342136
Babine,1983,7404,,248,349540
Babine,1983,10239,,249,359779
Babine,1983,8263,,250,368042
Babine,1983,7262,,251,375304
Babine,1983,5525,,252,380829
Babine,1983,2478,,253,383307
Babine,1983,3275,,254,386582
Babine,1983,2659,,255,389241
Babine,1983,3300,,256,392541
Babine,1983,3212,,257,395753
Babine,1983,2656,,258,398409
Babine,1983,1612,,259,400021
Babine,1983,1236,,260,401257
Babine,1983,1187,,261,402444
Babine,1983,549,,262,402993
Babine,1983,469,,263,403462
Babine,1983,342,,264,403804
Babine,1983,166,,265,403970
Babine,1983,90,,266,404060
Babine,1983,28,,267,404088
Babine,1984,0,,218,0
Babine,1984,6,,219,6
Babine,1984,15,,220,21
Babine,1984,28,,221,49
Babine,1984,29,,222,78
Babine,1984,32,,223,110
Babine,1984,60,,224,170
Babine,1984,60,,225,230
Babine,1984,81,,226,311
Babine,1984,161,,227,472
Babine,1984,144,,228,616
Babine,1984,711,,229,1327
Babine,1984,1077,,230,2404
Babine,1984,1892,,231,4296
Babine,1984,2928,,232,7224
Babine,1984,2893,,233,10117
Babine,1984,2837,,234,12954
Babine,1984,3144,,235,16098
Babine,1984,3364,,236,19462
Babine,1984,3500,,237,22962
Babine,1984,4903,,238,27865
Babine,1984,5122,,239,32987
Babine,1984,3343,,240,36330
Babine,1984,3060,,241,39390
Babine,1984,4157,,242,43547
Babine,1984,4433,,243,47980
Babine,1984,2980,,244,50960
Babine,1984,2491,,245,53451
Babine,1984,1695,,246,55146
Babine,1984,1544,,247,56690
Babine,1984,1586,,248,58276
Babine,1984,2025,,249,60301
Babine,1984,1499,,250,61800
Babine,1984,828,,251,62628
Babine,1984,1203,,252,63831
Babine,1984,1080,,253,64911
Babine,1984,888,,254,65799
Babine,1984,1292,,255,67091
Babine,1984,862,,256,67953
Babine,1984,385,,257,68338
Babine,1984,282,,258,68620
Babine,1984,241,,259,68861
Babine,1984,178,,260,69039
Babine,1984,166,,261,69205
Babine,1984,80,,262,69285
Babine,1984,60,,263,69345
Babine,1984,46,,264,69391
Babine,1984,15,,265,69406
Babine,1984,4,,266,69410
Babine,1984,6,,267,69416
Babine,1984,5,,268,69421
Babine,1984,0,,269,69421
Babine,1984,1,,270,69422
Babine,1984,0,,271,69422
Babine,1985,0,,211,0
Babine,1985,1,,212,1
Babine,1985,1,,213,2
Babine,1985,5,,214,7
Babine,1985,10,,215,17
Babine,1985,7,,216,24
Babine,1985,57,,217,81
Babine,1985,85,,218,166
Babine,1985,104,,219,270
Babine,1985,145,,220,415
Babine,1985,133,,221,548
Babine,1985,214,,222,762
Babine,1985,161,,223,923
Babine,1985,305,,224,1228
Babine,1985,465,,225,1693
Babine,1985,408,,226,2101
Babine,1985,545,,227,2646
Babine,1985,1137,,228,3783
Babine,1985,2041,,229,5824
Babine,1985,2229,,230,8053
Babine,1985,2455,,231,10508
Babine,1985,2450,,232,12958
Babine,1985,4530,,233,17488
Babine,1985,8020,,234,25508
Babine,1985,11121,,235,36629
Babine,1985,9136,,236,45765
Babine,1985,8338,,237,54103
Babine,1985,8198,,238,62301
Babine,1985,5277,,239,67578
Babine,1985,4745,,240,72323
Babine,1985,5233,,241,77556
Babine,1985,3669,,242,81225
Babine,1985,4266,,243,85491
Babine,1985,5347,,244,90838
Babine,1985,6096,,245,96934
Babine,1985,6293,,246,103227
Babine,1985,5938,,247,109165
Babine,1985,6735,,248,115900
Babine,1985,9214,,249,125114
Babine,1985,8015,,250,133129
Babine,1985,8663,,251,141792
Babine,1985,7391,,252,149183
Babine,1985,6545,,253,155728
Babine,1985,5808,,254,161536
Babine,1985,9116,,255,170652
Babine,1985,12083,,256,182735
Babine,1985,10947,,257,193682
Babine,1985,6532,,258,200214
Babine,1985,3874,,259,204088
Babine,1985,2927,,260,207015
Babine,1985,2279,,261,209294
Babine,1985,1559,,262,210853
Babine,1985,789,,263,211642
Babine,1985,888,,264,212530
Babine,1985,743,,265,213273
Babine,1985,553,,266,213826
Babine,1985,252,,267,214078
Babine,1985,115,,268,214193
Babine,1985,56,,269,214249
Babine,1985,66,,270,214315
Babine,1985,17,,271,214332
Babine,1985,5,,272,214337
Babine,1985,3,,273,214340
Babine,1985,3,,274,214343
Babine,1985,0,,275,214343
Babine,1985,2,,276,214345
Babine,1985,0,,277,214345
Babine,1985,0,,278,214345
Babine,1985,0,,279,214345
Babine,1985,0,,280,214345
Babine,1985,0,,281,214345
Babine,1985,1,,282,214346
Babine,1985,2,,283,214348
Babine,1985,0,,284,214348
Babine,1985,0,,285,214348
Babine,1985,1,,286,214349
Babine,1985,0,,287,214349
Babine,1986,0,,213,0
Babine,1986,2,,214,2
Babine,1986,2,,215,4
Babine,1986,6,,216,10
Babine,1986,10,,217,20
Babine,1986,31,,218,51
Babine,1986,86,,219,137
Babine,1986,159,,220,296
Babine,1986,235,,221,531
Babine,1986,323,,222,854
Babine,1986,470,,223,1324
Babine,1986,811,,224,2135
Babine,1986,1197,,225,3332
Babine,1986,1844,,226,5176
Babine,1986,3436,,227,8612
Babine,1986,3562,,228,12174
Babine,1986,4373,,229,16547
Babine,1986,3618,,230,20165
Babine,1986,2580,,231,22745
Babine,1986,5404,,232,28149
Babine,1986,7745,,233,35894
Babine,1986,6897,,234,42791
Babine,1986,5997,,235,48788
Babine,1986,7080,,236,55868
Babine,1986,6740,,237,62608
Babine,1986,5790,,238,68398
Babine,1986,5908,,239,74306
Babine,1986,5068,,240,79374
Babine,1986,6183,,241,85557
Babine,1986,4756,,242,90313
Babine,1986,5179,,243,95492
Babine,1986,7934,,244,103426
Babine,1986,10089,,245,113515
Babine,1986,9172,,246,122687
Babine,1986,7114,,247,129801
Babine,1986,5292,,248,135093
Babine,1986,4726,,249,139819
Babine,1986,3640,,250,143459
Babine,1986,3695,,251,147154
Babine,1986,2379,,252,149533
Babine,1986,2806,,253,152339
Babine,1986,2930,,254,155269
Babine,1986,3195,,255,158464
Babine,1986,2401,,256,160865
Babine,1986,2620,,257,163485
Babine,1986,1983,,258,165468
Babine,1986,1050,,259,166518
Babine,1986,675,,260,167193
Babine,1986,479,,261,167672
Babine,1986,597,,262,168269
Babine,1986,513,,263,168782
Babine,1986,354,,264,169136
Babine,1987,0,,204,0
Babine,1987,5,,205,5
Babine,1987,0,,206,5
Babine,1987,3,,207,8
Babine,1987,0,,208,8
Babine,1987,1,,209,9
Babine,1987,0,,210,9
Babine,1987,1,,211,10
Babine,1987,1,,212,11
Babine,1987,4,,213,15
Babine,1987,0,,214,15
Babine,1987,5,,215,20
Babine,1987,13,,216,33
Babine,1987,21,,217,54
Babine,1987,77,,218,131
Babine,1987,103,,219,234
Babine,1987,200,,220,434
Babine,1987,294,,221,728
Babine,1987,423,,222,1151
Babine,1987,971,,223,2122
Babine,1987,1519,,224,3641
Babine,1987,1764,,225,5405
Babine,1987,2099,,226,7504
Babine,1987,2721,,227,10225
Babine,1987,3382,,228,13607
Babine,1987,3554,,229,17161
Babine,1987,4343,,230,21504
Babine,1987,4647,,231,26151
Babine,1987,4116,,232,30267
Babine,1987,4128,,233,34395
Babine,1987,4569,,234,38964
Babine,1987,4776,,235,43740
Babine,1987,4727,,236,48467
Babine,1987,5003,,237,53470
Babine,1987,4775,,238,58245
Babine,1987,4945,,239,63190
Babine,1987,5672,,240,68862
Babine,1987,4360,,241,73222
Babine,1987,3902,,242,77124
Babine,1987,3580,,243,80704
Babine,1987,3747,,244,84451
Babine,1987,8458,,245,92909
Babine,1987,6083,,246,98992
Babine,1987,5894,,247,104886
Babine,1987,5577,,248,110463
Babine,1987,6584,,249,117047
Babine,1987,6198,,250,123245
Babine,1987,4378,,251,127623
Babine,1987,3747,,252,131370
Babine,1987,3881,,253,135251
Babine,1987,3060,,254,138311
Babine,1987,4026,,255,142337
Babine,1987,4037,,256,146374
Babine,1987,4074,,257,150448
Babine,1987,4730,,258,155178
Babine,1987,4190,,259,159368
Babine,1987,2690,,260,162058
Babine,1987,1626,,261,163684
Babine,1987,2154,,262,165838
Babine,1987,1217,,263,167055
Babine,1987,1100,,264,168155
Babine,1987,860,,265,169015
Babine,1987,352,,266,169367
Babine,1987,116,,267,169483
Babine,1987,34,,268,169517
Babine,1987,13,,269,169530
Babine,1987,14,,270,169544
Babine,1987,17,,271,169561
Babine,1987,2,,272,169563
Babine,1987,5,,273,169568
Babine,1988,0,,216,0
Babine,1988,2,,217,2
Babine,1988,1,,218,3
Babine,1988,2,,219,5
Babine,1988,1,,220,6
Babine,1988,6,,221,12
Babine,1988,17,,222,29
Babine,1988,22,,223,51
Babine,1988,52,,224,103
Babine,1988,58,,225,161
Babine,1988,103,,226,264
Babine,1988,153,,227,417
Babine,1988,158,,228,575
Babine,1988,204,,229,779
Babine,1988,182,,230,961
Babine,1988,417,,231,1378
Babine,1988,1360,,232,2738
Babine,1988,1776,,233,4514
Babine,1988,2845,,234,7359
Babine,1988,3441,,235,10800
Babine,1988,3919,,236,14719
Babine,1988,4470,,237,19189
Babine,1988,3053,,238,22242
Babine,1988,3794,,239,26036
Babine,1988,4652,,240,30688
Babine,1988,3771,,241,34459
Babine,1988,4652,,242,39111
Babine,1988,4482,,243,43593
Babine,1988,3259,,244,46852
Babine,1988,2757,,245,49609
Babine,1988,1627,,246,51236
Babine,1988,2027,,247,53263
Babine,1988,1408,,248,54671
Babine,1988,956,,249,55627
Babine,1988,752,,250,56379
Babine,1988,559,,251,56938
Babine,1988,312,,252,57250
Babine,1988,430,,253,57680
Babine,1988,471,,254,58151
Babine,1988,399,,255,58550
Babine,1988,326,,256,58876
Babine,1988,224,,257,59100
Babine,1988,253,,258,59353
Babine,1988,120,,259,59473
Babine,1988,101,,260,59574
Babine,1988,79,,261,59653
Babine,1988,38,,262,59691
Babine,1988,28,,263,59719
Babine,1988,16,,264,59735
Babine,1988,8,,265,59743
Babine,1988,12,,266,59755
Babine,1988,0,,267,59755
Babine,1988,3,,268,59758
Babine,1988,2,,269,59760
Babine,1988,1,,270,59761
Babine,1988,1,,271,59762
Babine,1988,2,,272,59764
Babine,1988,1,,273,59765
Babine,1988,0,,274,59765
Babine,1989,0,,209,0
Babine,1989,3,,210,3
Babine,1989,2,,211,5
Babine,1989,4,,212,9
Babine,1989,6,,213,15
Babine,1989,5,,214,20
Babine,1989,28,,215,48
Babine,1989,42,,216,90
Babine,1989,190,,217,280
Babine,1989,307,,218,587
Babine,1989,687,,219,1274
Babine,1989,1268,,220,2542
Babine,1989,1686,,221,4228
Babine,1989,3202,,222,7430
Babine,1989,3923,,223,11353
Babine,1989,5818,,224,17171
Babine,1989,6268,,225,23439
Babine,1989,5336,,226,28775
Babine,1989,3443,,227,32218
Babine,1989,7811,,228,40029
Babine,1989,7664,,229,47693
Babine,1989,5619,,230,53312
Babine,1989,5948,,231,59260
Babine,1989,7058,,232,66318
Babine,1989,8332,,233,74650
Babine,1989,9464,,234,84114
Babine,1989,11078,,235,95192
Babine,1989,9142,,236,104334
Babine,1989,7828,,237,112162
Babine,1989,9022,,238,121184
Babine,1989,11808,,239,132992
Babine,1989,14104,,240,147096
Babine,1989,14927,,241,162023
Babine,1989,14131,,242,176154
Babine,1989,14022,,243,190176
Babine,1989,13370,,244,203546
Babine,1989,12563,,245,216109
Babine,1989,13502,,246,229611
Babine,1989,13380,,247,242991
Babine,1989,9745,,248,252736
Babine,1989,9040,,249,261776
Babine,1989,13015,,250,274791
Babine,1989,11840,,251,286631
Babine,1989,12508,,252,299139
Babine,1989,7993,,253,307132
Babine,1989,6706,,254,313838
Babine,1989,4587,,255,318425
Babine,1989,4485,,256,322910
Babine,1989,4740,,257,327650
Babine,1989,3922,,258,331572
Babine,1989,1401,,259,332973
Babine,1989,1194,,260,334167
Babine,1989,849,,261,335016
Babine,1989,932,,262,335948
Babine,1989,937,,263,336885
Babine,1989,753,,264,337638
Babine,1989,837,,265,338475
Babine,1989,856,,266,339331
Babine,1989,190,,267,339521
Babine,1989,320,,268,339841
Babine,1989,110,,269,339951
Babine,1989,35,,270,339986
Babine,1989,40,,271,340026
Babine,1989,25,,272,340051
Babine,1989,15,,273,340066
Babine,1989,3,,274,340069
Babine,1989,1,,275,340070
Babine,1989,0,,276,340070
Babine,1989,0,,277,340070
Babine,1989,3,,278,340073
Babine,1989,0,,279,340073
Babine,1989,0,,280,340073
Babine,1989,0,,281,340073
Babine,1989,0,,282,340073
Babine,1989,1,,283,340074
Babine,1989,1,,284,340075
Babine,1989,0,,285,340075
Babine,1990,0,,210,0
Babine,1990,7,,211,7
Babine,1990,5,,212,12
Babine,1990,21,,213,33
Babine,1990,31,,214,64
Babine,1990,99,,215,163
Babine,1990,136,,216,299
Babine,1990,352,,217,651
Babine,1990,919,,218,1570
Babine,1990,1040,,219,2610
Babine,1990,1220,,220,3830
Babine,1990,2078,,221,5908
Babine,1990,3262,,222,9170
Babine,1990,5717,,223,14887
Babine,1990,11691,,224,26578
Babine,1990,17708,,225,44286
Babine,1990,25049,,226,69335
Babine,1990,15778,,227,85113
Babine,1990,17051,,228,102164
Babine,1990,9850,,229,112014
Babine,1990,11492,,230,123506
Babine,1990,11205,,231,134711
Babine,1990,18654,,232,153365
Babine,1990,24160,,233,177525
Babine,1990,27192,,234,204717
Babine,1990,29758,,235,234475
Babine,1990,31073,,236,265548
Babine,1990,23355,,237,288903
Babine,1990,13692,,238,302595
Babine,1990,15838,,239,318433
Babine,1990,16384,,240,334817
Babine,1990,13075,,241,347892
Babine,1990,9666,,242,357558
Babine,1990,9361,,243,366919
Babine,1990,9415,,244,376334
Babine,1990,7524,,245,383858
Babine,1990,5681,,246,389539
Babine,1990,4198,,247,393737
Babine,1990,4494,,248,398231
Babine,1990,4492,,249,402723
Babine,1990,3957,,250,406680
Babine,1990,2940,,251,409620
Babine,1990,2498,,252,412118
Babine,1990,1828,,253,413946
Babine,1990,1352,,254,415298
Babine,1990,1193,,255,416491
Babine,1990,1206,,256,417697
Babine,1990,1177,,257,418874
Babine,1990,1241,,258,420115
Babine,1990,847,,259,420962
Babine,1990,741,,260,421703
Babine,1990,637,,261,422340
Babine,1990,748,,262,423088
Babine,1990,644,,263,423732
Babine,1990,706,,264,424438
Babine,1990,451,,265,424889
Babine,1990,388,,266,425277
Babine,1990,443,,267,425720
Babine,1990,165,,268,425885
Babine,1990,171,,269,426056
Babine,1990,21,,270,426077
Babine,1990,71,,271,426148
Babine,1990,19,,272,426167
Babine,1990,2,,273,426169
Babine,1990,1,,274,426170
Babine,1990,1,,275,426171
Babine,1990,1,,276,426172
Babine,1990,0,,277,426172
Babine,1990,1,,278,426173
Babine,1990,0,,279,426173
Babine,1991,0,,210,0
Babine,1991,1,,211,1
Babine,1991,12,,212,13
Babine,1991,23,,213,36
Babine,1991,203,,214,239
Babine,1991,405,,215,644
Babine,1991,309,,216,953
Babine,1991,126,,217,1079
Babine,1991,276,,218,1355
Babine,1991,780,,219,2135
Babine,1991,777,,220,2912
Babine,1991,622,,221,3534
Babine,1991,1935,,222,5469
Babine,1991,2153,,223,7622
Babine,1991,2596,,224,10218
Babine,1991,2520,,225,12738
Babine,1991,5444,,226,18182
Babine,1991,8343,,227,26525
Babine,1991,9634,,228,36159
Babine,1991,11190,,229,47349
Babine,1991,10614,,230,57963
Babine,1991,7130,,231,65093
Babine,1991,6097,,232,71190
Babine,1991,6267,,233,77457
Babine,1991,4777,,234,82234
Babine,1991,5380,,235,87614
Babine,1991,4861,,236,92475
Babine,1991,4561,,237,97036
Babine,1991,6068,,238,103104
Babine,1991,8773,,239,111877
Babine,1991,13226,,240,125103
Babine,1991,26347,,241,151450
Babine,1991,12098,,242,163548
Babine,1991,8014,,243,171562
Babine,1991,4497,,244,176059
Babine,1991,4863,,245,180922
Babine,1991,5859,,246,186781
Babine,1991,5106,,247,191887
Babine,1991,4768,,248,196655
Babine,1991,5719,,249,202374
Babine,1991,5220,,250,207594
Babine,1991,4747,,251,212341
Babine,1991,3130,,252,215471
Babine,1991,4115,,253,219586
Babine,1991,3413,,254,222999
Babine,1991,2972,,255,225971
Babine,1991,1981,,256,227952
Babine,1991,942,,257,228894
Babine,1991,936,,258,229830
Babine,1991,929,,259,230759
Babine,1991,574,,260,231333
Babine,1991,295,,261,231628
Babine,1991,187,,262,231815
Babine,1991,74,,263,231889
Babine,1991,25,,264,231914
Babine,1991,40,,265,231954
Babine,1991,16,,266,231970
Babine,1991,3,,267,231973
Babine,1991,9,,268,231982
Babine,1991,14,,269,231996
Babine,1991,7,,270,232003
Babine,1991,10,,271,232013
Babine,1991,0,,272,232013
Babine,1991,3,,273,232016
Babine,1991,0,,274,232016
Babine,1991,0,,275,232016
Babine,1991,0,,276,232016
Babine,1991,2,,277,232018
Babine,1991,1,,278,232019
Babine,1991,2,,279,232021
Babine,1991,0,,280,232021
Babine,1992,14,,211,14
Babine,1992,27,,212,41
Babine,1992,95,,213,136
Babine,1992,285,,214,421
Babine,1992,309,,215,730
Babine,1992,198,,216,928
Babine,1992,309,,217,1237
Babine,1992,799,,218,2036
Babine,1992,2006,,219,4042
Babine,1992,1212,,220,5254
Babine,1992,1254,,221,6508
Babine,1992,903,,222,7411
Babine,1992,1946,,223,9357
Babine,1992,2997,,224,12354
Babine,1992,4011,,225,16365
Babine,1992,5047,,226,21412
Babine,1992,6124,,227,27536
Babine,1992,5545,,228,33081
Babine,1992,5543,,229,38624
Babine,1992,5016,,230,43640
Babine,1992,5527,,231,49167
Babine,1992,6339,,232,55506
Babine,1992,6719,,233,62225
Babine,1992,5908,,234,68133
Babine,1992,8311,,235,76444
Babine,1992,7480,,236,83924
Babine,1992,8032,,237,91956
Babine,1992,8043,,238,99999
Babine,1992,8708,,239,108707
Babine,1992,7743,,240,116450
Babine,1992,7063,,241,123513
Babine,1992,4600,,242,128113
Babine,1992,3903,,243,132016
Babine,1992,4282,,244,136298
Babine,1992,3840,,245,140138
Babine,1992,4118,,246,144256
Babine,1992,3454,,247,147710
Babine,1992,3358,,248,151068
Babine,1992,3945,,249,155013
Babine,1992,3219,,250,158232
Babine,1992,4036,,251,162268
Babine,1992,3447,,252,165715
Babine,1992,2592,,253,168307
Babine,1992,1867,,254,170174
Babine,1992,1078,,255,171252
Babine,1992,1362,,256,172614
Babine,1992,894,,257,173508
Babine,1992,940,,258,174448
Babine,1992,504,,259,174952
Babine,1992,584,,260,175536
Babine,1992,319,,261,175855
Babine,1992,288,,262,176143
Babine,1992,260,,263,176403
Babine,1992,151,,264,176554
Babine,1992,61,,265,176615
Babine,1992,145,,266,176760
Babine,1992,144,,267,176904
Babine,1992,40,,268,176944
Babine,1992,11,,269,176955
Babine,1992,10,,270,176965
Babine,1992,0,,271,176965
Babine,1992,2,,272,176967
Babine,1992,0,,273,176967
Babine,1993,0,,209,0
Babine,1993,23,,210,23
Babine,1993,113,,211,136
Babine,1993,11,,212,147
Babine,1993,44,,213,191
Babine,1993,13,,214,204
Babine,1993,28,,215,232
Babine,1993,8,,216,240
Babine,1993,78,,217,318
Babine,1993,69,,218,387
Babine,1993,142,,219,529
Babine,1993,114,,220,643
Babine,1993,121,,221,764
Babine,1993,96,,222,860
Babine,1993,106,,223,966
Babine,1993,222,,224,1188
Babine,1993,78,,225,1266
Babine,1993,111,,226,1377
Babine,1993,88,,227,1465
Babine,1993,408,,228,1873
Babine,1993,557,,229,2430
Babine,1993,893,,230,3323
Babine,1993,447,,231,3770
Babine,1993,1012,,232,4782
Babine,1993,1985,,233,6767
Babine,1993,2280,,234,9047
Babine,1993,2441,,235,11488
Babine,1993,4465,,236,15953
Babine,1993,2794,,237,18747
Babine,1993,2639,,238,21386
Babine,1993,2873,,239,24259
Babine,1993,3208,,240,27467
Babine,1993,2269,,241,29736
Babine,1993,1909,,242,31645
Babine,1993,661,,243,32306
Babine,1993,1740,,244,34046
Babine,1993,1887,,245,35933
Babine,1993,1738,,246,37671
Babine,1993,1643,,247,39314
Babine,1993,1408,,248,40722
Babine,1993,1259,,249,41981
Babine,1993,1044,,250,43025
Babine,1993,767,,251,43792
Babine,1993,804,,252,44596
Babine,1993,408,,253,45004
Babine,1993,308,,254,45312
Babine,1993,160,,255,45472
Babine,1993,95,,256,45567
Babine,1993,113,,257,45680
Babine,1993,66,,258,45746
Babine,1993,77,,259,45823
Babine,1993,36,,260,45859
Babine,1993,37,,261,45896
Babine,1993,26,,262,45922
Babine,1993,52,,263,45974
Babine,1993,11,,264,45985
Babine,1993,3,,265,45988
Babine,1993,14,,266,46002
Babine,1993,6,,267,46008
Babine,1993,3,,268,46011
Babine,1993,7,,269,46018
Babine,1993,13,,270,46031
Babine,1993,3,,271,46034
Babine,1993,2,,272,46036
Babine,1993,0,,273,46036
Babine,1994,0,,211,0
Babine,1994,47,,212,47
Babine,1994,115,,213,162
Babine,1994,284,,214,446
Babine,1994,249,,215,695
Babine,1994,673,,216,1368
Babine,1994,802,,217,2170
Babine,1994,861,,218,3031
Babine,1994,1073,,219,4104
Babine,1994,901,,220,5005
Babine,1994,740,,221,5745
Babine,1994,309,,222,6054
Babine,1994,1457,,223,7511
Babine,1994,2278,,224,9789
Babine,1994,3177,,225,12966
Babine,1994,3337,,226,16303
Babine,1994,2564,,227,18867
Babine,1994,2139,,228,21006
Babine,1994,2457,,229,23463
Babine,1994,2913,,230,26376
Babine,1994,3749,,231,30125
Babine,1994,2633,,232,32758
Babine,1994,2789,,233,35547
Babine,1994,4054,,234,39601
Babine,1994,2086,,235,41687
Babine,1994,2361,,236,44048
Babine,1994,2844,,237,46892
Babine,1994,2143,,238,49035
Babine,1994,2207,,239,51242
Babine,1994,1873,,240,53115
Babine,1994,2920,,241,56035
Babine,1994,3470,,242,59505
Babine,1994,3930,,243,63435
Babine,1994,2987,,244,66422
Babine,1994,3994,,245,70416
Babine,1994,2408,,246,72824
Babine,1994,2086,,247,74910
Babine,1994,2846,,248,77756
Babine,1994,1811,,249,79567
Babine,1994,2296,,250,81863
Babine,1994,2295,,251,84158
Babine,1994,1808,,252,85966
Babine,1994,1357,,253,87323
Babine,1994,842,,254,88165
Babine,1994,716,,255,88881
Babine,1994,1285,,256,90166
Babine,1994,1473,,257,91639
Babine,1994,903,,258,92542
Babine,1994,813,,259,93355
Babine,1994,399,,260,93754
Babine,1994,285,,261,94039
Babine,1994,218,,262,94257
Babine,1994,303,,263,94560
Babine,1994,140,,264,94700
Babine,1994,140,,265,94840
Babine,1994,41,,266,94881
Babine,1994,30,,267,94911
Babine,1994,15,,268,94926
Babine,1994,10,,269,94936
Babine,1994,6,,270,94942
Babine,1994,4,,271,94946
Babine,1994,1,,272,94947
Babine,1994,0,,273,94947
Babine,1994,0,,274,94947
Babine,1994,0,,275,94947
Babine,1994,1,,276,94948
Babine,1994,0,,277,94948
Babine,1994,2,,278,94950
Babine,1994,0,,279,94950
Babine,1995,0,,204,0
Babine,1995,1,,205,1
Babine,1995,1,,206,2
Babine,1995,2,,207,4
Babine,1995,2,,208,6
Babine,1995,0,,209,6
Babine,1995,1,,210,7
Babine,1995,0,,211,7
Babine,1995,1,,212,8
Babine,1995,11,,213,19
Babine,1995,0,,214,19
Babine,1995,2,,215,21
Babine,1995,1,,216,22
Babine,1995,3,,217,25
Babine,1995,7,,218,32
Babine,1995,3,,219,35
Babine,1995,6,,220,41
Babine,1995,25,,221,66
Babine,1995,28,,222,94
Babine,1995,42,,223,136
Babine,1995,199,,224,335
Babine,1995,345,,225,680
Babine,1995,294,,226,974
Babine,1995,472,,227,1446
Babine,1995,647,,228,2093
Babine,1995,348,,229,2441
Babine,1995,343,,230,2784
Babine,1995,245,,231,3029
Babine,1995,291,,232,3320
Babine,1995,345,,233,3665
Babine,1995,855,,234,4520
Babine,1995,1913,,235,6433
Babine,1995,1943,,236,8376
Babine,1995,1059,,237,9435
Babine,1995,702,,238,10137
Babine,1995,320,,239,10457
Babine,1995,251,,240,10708
Babine,1995,363,,241,11071
Babine,1995,756,,242,11827
Babine,1995,1113,,243,12940
Babine,1995,1238,,244,14178
Babine,1995,2000,,245,16178
Babine,1995,1918,,246,18096
Babine,1995,2208,,247,20304
Babine,1995,4862,,248,25166
Babine,1995,3787,,249,28953
Babine,1995,3444,,250,32397
Babine,1995,3823,,251,36220
Babine,1995,2991,,252,39211
Babine,1995,4002,,253,43213
Babine,1995,6779,,254,49992
Babine,1995,5629,,255,55621
Babine,1995,6235,,256,61856
Babine,1995,6118,,257,67974
Babine,1995,5400,,258,73374
Babine,1995,2309,,259,75683
Babine,1995,1795,,260,77478
Babine,1995,1789,,261,79267
Babine,1995,1119,,262,80386
Babine,1995,1348,,263,81734
Babine,1995,664,,264,82398
Babine,1995,169,,265,82567
Babine,1995,122,,266,82689
Babine,1995,62,,267,82751
Babine,1995,57,,268,82808
Babine,1995,28,,269,82836
Babine,1995,15,,270,82851
Babine,1995,10,,271,82861
Babine,1995,5,,272,82866
Babine,1995,6,,273,82872
Babine,1995,4,,274,82876
Babine,1995,5,,275,82881
Babine,1995,0,,276,82881
Babine,1995,0,,277,82881
Babine,1995,0,,278,82881
Babine,1995,2,,279,82883
Babine,1995,0,,280,82883
Babine,1996,0,,217,0
Babine,1996,1,,218,1
Babine,1996,7,,219,8
Babine,1996,103,,220,111
Babine,1996,126,,221,237
Babine,1996,226,,222,463
Babine,1996,332,,223,795
Babine,1996,736,,224,1531
Babine,1996,555,,225,2086
Babine,1996,2347,,226,4433
Babine,1996,2624,,227,7057
Babine,1996,6412,,228,13469
Babine,1996,6955,,229,20424
Babine,1996,7817,,230,28241
Babine,1996,6323,,231,34564
Babine,1996,2370,,232,36934
Babine,1996,12157,,233,49091
Babine,1996,16574,,234,65665
Babine,1996,11705,,235,77370
Babine,1996,15110,,236,92480
Babine,1996,17369,,237,109849
Babine,1996,12776,,238,122625
Babine,1996,7849,,239,130474
Babine,1996,5602,,240,136076
Babine,1996,19309,,241,155385
Babine,1996,32195,,242,187580
Babine,1996,20562,,243,208142
Babine,1996,16032,,244,224174
Babine,1996,13488,,245,237662
Babine,1996,15603,,246,253265
Babine,1996,13067,,247,266332
Babine,1996,8065,,248,274397
Babine,1996,8746,,249,283143
Babine,1996,5725,,250,288868
Babine,1996,4750,,251,293618
Babine,1996,4460,,252,298078
Babine,1996,3310,,253,301388
Babine,1996,2596,,254,303984
Babine,1996,2459,,255,306443
Babine,1996,1970,,256,308413
Babine,1996,1531,,257,309944
Babine,1996,1076,,258,311020
Babine,1996,1132,,259,312152
Babine,1996,588,,260,312740
Babine,1996,424,,261,313164
Babine,1996,357,,262,313521
Babine,1996,135,,263,313656
Babine,1996,107,,264,313763
Babine,1996,151,,265,313914
Babine,1996,48,,266,313962
Babine,1996,43,,267,314005
Babine,1996,15,,268,314020
Babine,1996,5,,269,314025
Babine,1996,6,,270,314031
Babine,1996,3,,271,314034
Babine,1996,1,,272,314035
Babine,1996,2,,273,314037
Babine,1996,2,,274,314039
Babine,1996,1,,275,314040
Babine,1996,0,,276,314040
Babine,1996,0,,277,314040
Babine,1996,0,,278,314040
Babine,1996,0,,279,314040
Babine,1996,0,,280,314040
Babine,1996,0,,281,314040
Babine,1996,0,,282,314040
Babine,1996,0,,283,314040
Babine,1996,0,,284,314040
Babine,1996,0,,285,314040
Babine,1996,1,,286,314041
Babine,1996,0,,287,314041
Babine,1997,0,,210,0
Babine,1997,1,,211,1
Babine,1997,0,,212,1
Babine,1997,0,,213,1
Babine,1997,0,,214,1
Babine,1997,0,,215,1
Babine,1997,0,,216,1
Babine,1997,7,,217,8
Babine,1997,5,,218,13
Babine,1997,26,,219,39
Babine,1997,52,,220,91
Babine,1997,48,,221,139
Babine,1997,57,,222,196
Babine,1997,136,,223,332
Babine,1997,110,,224,442
Babine,1997,205,,225,647
Babine,1997,494,,226,1141
Babine,1997,204,,227,1345
Babine,1997,170,,228,1515
Babine,1997,399,,229,1914
Babine,1997,439,,230,2353
Babine,1997,787,,231,3140
Babine,1997,906,,232,4046
Babine,1997,1610,,233,5656
Babine,1997,1615,,234,7271
Babine,1997,1470,,235,8741
Babine,1997,2215,,236,10956
Babine,1997,1580,,237,12536
Babine,1997,1050,,238,13586
Babine,1997,1349,,239,14935
Babine,1997,1489,,240,16424
Babine,1997,1272,,241,17696
Babine,1997,1059,,242,18755
Babine,1997,431,,243,19186
Babine,1997,325,,244,19511
Babine,1997,825,,245,20336
Babine,1997,702,,246,21038
Babine,1997,246,,247,21284
Babine,1997,467,,248,21751
Babine,1997,394,,249,22145
Babine,1997,460,,250,22605
Babine,1997,180,,251,22785
Babine,1997,165,,252,22950
Babine,1997,185,,253,23135
Babine,1997,246,,254,23381
Babine,1997,114,,255,23495
Babine,1997,207,,256,23702
Babine,1997,76,,257,23778
Babine,1997,47,,258,23825
Babine,1997,32,,259,23857
Babine,1997,18,,260,23875
Babine,1997,35,,261,23910
Babine,1997,30,,262,23940
Babine,1997,2,,263,23942
Babine,1997,0,,264,23942
Babine,1997,10,,265,23952
Babine,1997,8,,266,23960
Babine,1997,3,,267,23963
Babine,1997,3,,268,23966
Babine,1997,2,,269,23968
Babine,1997,0,,270,23968
Babine,1997,3,,271,23971
Babine,1997,2,,272,23973
Babine,1997,3,,273,23976
Babine,1997,0,,274,23976
Babine,1998,0,,206,0
Babine,1998,1,,207,1
Babine,1998,0,,208,1
Babine,1998,0,,209,1
Babine,1998,0,,210,1
Babine,1998,0,,211,1
Babine,1998,6,,212,7
Babine,1998,5,,213,12
Babine,1998,26,,214,38
Babine,1998,93,,215,131
Babine,1998,238,,216,369
Babine,1998,672,,217,1041
Babine,1998,638,,218,1679
Babine,1998,720,,219,2399
Babine,1998,1121,,220,3520
Babine,1998,1997,,221,5517
Babine,1998,1445,,222,6962
Babine,1998,614,,223,7576
Babine,1998,1630,,224,9206
Babine,1998,404,,225,9610
Babine,1998,621,,226,10231
Babine,1998,800,,227,11031
Babine,1998,273,,228,11304
Babine,1998,864,,229,12168
Babine,1998,299,,230,12467
Babine,1998,718,,231,13185
Babine,1998,1244,,232,14429
Babine,1998,949,,233,15378
Babine,1998,1859,,234,17237
Babine,1998,2399,,235,19636
Babine,1998,3343,,236,22979
Babine,1998,1815,,237,24794
Babine,1998,2425,,238,27219
Babine,1998,1962,,239,29181
Babine,1998,1819,,240,31000
Babine,1998,1963,,241,32963
Babine,1998,1354,,242,34317
Babine,1998,2347,,243,36664
Babine,1998,3000,,244,39664
Babine,1998,3016,,245,42680
Babine,1998,2007,,246,44687
Babine,1998,2315,,247,47002
Babine,1998,3002,,248,50004
Babine,1998,3706,,249,53710
Babine,1998,4709,,250,58419
Babine,1998,2009,,251,60428
Babine,1998,1539,,252,61967
Babine,1998,1406,,253,63373
Babine,1998,1564,,254,64937
Babine,1998,1097,,255,66034
Babine,1998,1040,,256,67074
Babine,1998,941,,257,68015
Babine,1998,836,,258,68851
Babine,1998,570,,259,69421
Babine,1998,513,,260,69934
Babine,1998,233,,261,70167
Babine,1998,209,,262,70376
Babine,1998,141,,263,70517
Babine,1998,66,,264,70583
Babine,1998,50,,265,70633
Babine,1998,28,,266,70661
Babine,1998,23,,267,70684
Babine,1998,20,,268,70704
Babine,1998,14,,269,70718
Babine,1998,2,,270,70720
Babine,1998,7,,271,70727
Babine,1998,2,,272,70729
Babine,1998,1,,273,70730
Babine,1998,0,,274,70730
Babine,1998,1,,275,70731
Babine,1998,0,,276,70731
Babine,1999,0,,206,0
Babine,1999,1,,207,1
Babine,1999,0,,208,1
Babine,1999,0,,209,1
Babine,1999,0,,210,1
Babine,1999,1,,211,2
Babine,1999,1,,212,3
Babine,1999,2,,213,5
Babine,1999,0,,214,5
Babine,1999,0,,215,5
Babine,1999,0,,216,5
Babine,1999,0,,217,5
Babine,1999,0,,218,5
Babine,1999,4,,219,9
Babine,1999,13,,220,22
Babine,1999,25,,221,47
Babine,1999,16,,222,63
Babine,1999,24,,223,87
Babine,1999,24,,224,111
Babine,1999,17,,225,128
Babine,1999,41,,226,169
Babine,1999,64,,227,233
Babine,1999,108,,228,341
Babine,1999,249,,229,590
Babine,1999,354,,230,944
Babine,1999,727,,231,1671
Babine,1999,384,,232,2055
Babine,1999,547,,233,2602
Babine,1999,1690,,234,4292
Babine,1999,1325,,235,5617
Babine,1999,1179,,236,6796
Babine,1999,1968,,237,8764
Babine,1999,2551,,238,11315
Babine,1999,1245,,239,12560
Babine,1999,558,,240,13118
Babine,1999,567,,241,13685
Babine,1999,776,,242,14461
Babine,1999,963,,243,15424
Babine,1999,1355,,244,16779
Babine,1999,1844,,245,18623
Babine,1999,1706,,246,20329
Babine,1999,1815,,247,22144
Babine,1999,1867,,248,24011
Babine,1999,2542,,249,26553
Babine,1999,2749,,250,29302
Babine,1999,2295,,251,31597
Babine,1999,1390,,252,32987
Babine,1999,2037,,253,35024
Babine,1999,1812,,254,36836
Babine,1999,2110,,255,38946
Babine,1999,1933,,256,40879
Babine,1999,1165,,257,42044
Babine,1999,851,,258,42895
Babine,1999,458,,259,43353
Babine,1999,266,,260,43619
Babine,1999,275,,261,43894
Babine,1999,183,,262,44077
Babine,1999,160,,263,44237
Babine,1999,106,,264,44343
Babine,1999,77,,265,44420
Babine,1999,56,,266,44476
Babine,1999,32,,267,44508
Babine,1999,7,,268,44515
Babine,1999,12,,269,44527
Babine,1999,5,,270,44532
Babine,1999,4,,271,44536
Babine,1999,1,,272,44537
Babine,1999,1,,273,44538
Babine,1999,1,,274,44539
Babine,1999,10,,275,44549
Babine,1999,2,,276,44551
Babine,1999,0,,277,44551
Babine,1999,0,,278,44551
Babine,1999,0,,279,44551
Babine,1999,0,,280,44551
Babine,1999,0,,281,44551
Babine,1999,1,,282,44552
Babine,1999,0,,283,44552
Babine,2000,0,,216,0
Babine,2000,1,,217,1
Babine,2000,1,,218,2
Babine,2000,1,,219,3
Babine,2000,1,,220,4
Babine,2000,4,,221,8
Babine,2000,10,,222,18
Babine,2000,30,,223,48
Babine,2000,84,,224,132
Babine,2000,66,,225,198
Babine,2000,151,,226,349
Babine,2000,233,,227,582
Babine,2000,574,,228,1156
Babine,2000,1351,,229,2507
Babine,2000,1397,,230,3904
Babine,2000,1605,,231,5509
Babine,2000,2614,,232,8123
Babine,2000,2239,,233,10362
Babine,2000,2361,,234,12723
Babine,2000,2065,,235,14788
Babine,2000,1704,,236,16492
Babine,2000,2105,,237,18597
Babine,2000,1010,,238,19607
Babine,2000,962,,239,20569
Babine,2000,781,,240,21350
Babine,2000,2253,,241,23603
Babine,2000,838,,242,24441
Babine,2000,779,,243,25220
Babine,2000,829,,244,26049
Babine,2000,1292,,245,27341
Babine,2000,1870,,246,29211
Babine,2000,964,,247,30175
Babine,2000,1096,,248,31271
Babine,2000,544,,249,31815
Babine,2000,1446,,250,33261
Babine,2000,1620,,251,34881
Babine,2000,845,,252,35726
Babine,2000,521,,253,36247
Babine,2000,420,,254,36667
Babine,2000,345,,255,37012
Babine,2000,230,,256,37242
Babine,2000,230,,257,37472
Babine,2000,159,,258,37631
Babine,2000,179,,259,37810
Babine,2000,126,,260,37936
Babine,2000,80,,261,38016
Babine,2000,47,,262,38063
Babine,2000,31,,263,38094
Babine,2000,17,,264,38111
Babine,2000,15,,265,38126
Babine,2000,13,,266,38139
Babine,2000,6,,267,38145
Babine,2000,5,,268,38150
Babine,2000,3,,269,38153
Babine,2000,0,,270,38153
Babine,2000,1,,271,38154
Babine,2000,1,,272,38155
Babine,2000,0,,273,38155
Babine,2000,1,,274,38156
Babine,2000,0,,275,38156
Babine,2001,0,,213,0
Babine,2001,1,,214,1
Babine,2001,0,,215,1
Babine,2001,0,,216,1
Babine,2001,0,,217,1
Babine,2001,1,,218,2
Babine,2001,0,,219,2
Babine,2001,1,,220,3
Babine,2001,14,,221,17
Babine,2001,1,,222,18
Babine,2001,2,,223,20
Babine,2001,91,,224,111
Babine,2001,44,,225,155
Babine,2001,98,,226,253
Babine,2001,347,,227,600
Babine,2001,108,,228,708
Babine,2001,179,,229,887
Babine,2001,982,,230,1869
Babine,2001,564,,231,2433
Babine,2001,1071,,232,3504
Babine,2001,1501,,233,5005
Babine,2001,1366,,234,6371
Babine,2001,1050,,235,7421
Babine,2001,3197,,236,10618
Babine,2001,3341,,237,13959
Babine,2001,3251,,238,17210
Babine,2001,3273,,239,20483
Babine,2001,2306,,240,22789
Babine,2001,2170,,241,24959
Babine,2001,2877,,242,27836
Babine,2001,2212,,243,30048
Babine,2001,4062,,244,34110
Babine,2001,3340,,245,37450
Babine,2001,7771,,246,45221
Babine,2001,3790,,247,49011
Babine,2001,4130,,248,53141
Babine,2001,4293,,249,57434
Babine,2001,3414,,250,60848
Babine,2001,2687,,251,63535
Babine,2001,2489,,252,66024
Babine,2001,2119,,253,68143
Babine,2001,1416,,254,69559
Babine,2001,1895,,255,71454
Babine,2001,1866,,256,73320
Babine,2001,1377,,257,74697
Babine,2001,1794,,258,76491
Babine,2001,1184,,259,77675
Babine,2001,978,,260,78653
Babine,2001,513,,261,79166
Babine,2001,388,,262,79554
Babine,2001,182,,263,79736
Babine,2001,70,,264,79806
Babine,2001,68,,265,79874
Babine,2001,48,,266,79922
Babine,2001,29,,267,79951
Babine,2001,27,,268,79978
Babine,2001,13,,269,79991
Babine,2001,8,,270,79999
Babine,2001,6,,271,80005
Babine,2001,4,,272,80009
Babine,2001,2,,273,80011
Babine,2001,1,,274,80012
Babine,2001,0,,275,80012
Babine,2002,1,,219,1
Babine,2002,0,,220,1
Babine,2002,2,,221,3
Babine,2002,1,,222,4
Babine,2002,6,,223,10
Babine,2002,9,,224,19
Babine,2002,14,,225,33
Babine,2002,27,,226,60
Babine,2002,45,,227,105
Babine,2002,27,,228,132
Babine,2002,60,,229,192
Babine,2002,117,,230,309
Babine,2002,173,,231,482
Babine,2002,350,,232,832
Babine,2002,1089,,233,1921
Babine,2002,711,,234,2632
Babine,2002,1289,,235,3921
Babine,2002,1348,,236,5269
Babine,2002,1053,,237,6322
Babine,2002,2044,,238,8366
Babine,2002,1613,,239,9979
Babine,2002,2073,,240,12052
Babine,2002,2295,,241,14347
Babine,2002,1891,,242,16238
Babine,2002,1766,,243,18004
Babine,2002,1576,,244,19580
Babine,2002,1201,,245,20781
Babine,2002,1175,,246,21956
Babine,2002,732,,247,22688
Babine,2002,644,,248,23332
Babine,2002,465,,249,23797
Babine,2002,559,,250,24356
Babine,2002,510,,251,24866
Babine,2002,377,,252,25243
Babine,2002,313,,253,25556
Babine,2002,225,,254,25781
Babine,2002,157,,255,25938
Babine,2002,83,,256,26021
Babine,2002,90,,257,26111
Babine,2002,89,,258,26200
Babine,2002,61,,259,26261
Babine,2002,28,,260,26289
Babine,2002,21,,261,26310
Babine,2002,14,,262,26324
Babine,2002,6,,263,26330
Babine,2002,3,,264,26333
Babine,2002,9,,265,26342
Babine,2002,3,,266,26345
Babine,2002,1,,267,26346
Babine,2002,0,,268,26346
Babine,2002,4,,269,26350
Babine,2002,0,,270,26350
Babine,2002,0,,271,26350
Babine,2002,0,,272,26350
Babine,2002,0,,273,26350
Babine,2002,0,,274,26350
Babine,2002,0,,275,26350
Babine,2002,0,,276,26350
Babine,2002,0,,277,26350
Babine,2002,0,,278,26350
Babine,2002,0,,279,26350
Babine,2002,1,,280,26351
Babine,2002,0,,281,26351
Babine,2003,0,,208,0
Babine,2003,11,,209,11
Babine,2003,6,,210,17
Babine,2003,41,,211,58
Babine,2003,119,,212,177
Babine,2003,205,,213,382
Babine,2003,283,,214,665
Babine,2003,320,,215,985
Babine,2003,1701,,216,2686
Babine,2003,2317,,217,5003
Babine,2003,1438,,218,6441
Babine,2003,3006,,219,9447
Babine,2003,4887,,220,14334
Babine,2003,5910,,221,20244
Babine,2003,7365,,222,27609
Babine,2003,4436,,223,32045
Babine,2003,5199,,224,37244
Babine,2003,6153,,225,43397
Babine,2003,5705,,226,49102
Babine,2003,8580,,227,57682
Babine,2003,7622,,228,65304
Babine,2003,5437,,229,70741
Babine,2003,3256,,230,73997
Babine,2003,4058,,231,78055
Babine,2003,3826,,232,81881
Babine,2003,2954,,233,84835
Babine,2003,2273,,234,87108
Babine,2003,3311,,235,90419
Babine,2003,1958,,236,92377
Babine,2003,2372,,237,94749
Babine,2003,2167,,238,96916
Babine,2003,3003,,239,99919
Babine,2003,2403,,240,102322
Babine,2003,3013,,241,105335
Babine,2003,2640,,242,107975
Babine,2003,3836,,243,111811
Babine,2003,4126,,244,115937
Babine,2003,4091,,245,120028
Babine,2003,4137,,246,124165
Babine,2003,5074,,247,129239
Babine,2003,4417,,248,133656
Babine,2003,6764,,249,140420
Babine,2003,3636,,250,144056
Babine,2003,1824,,251,145880
Babine,2003,1921,,252,147801
Babine,2003,1822,,253,149623
Babine,2003,2281,,254,151904
Babine,2003,2316,,255,154220
Babine,2003,1615,,256,155835
Babine,2003,1476,,257,157311
Babine,2003,1143,,258,158454
Babine,2003,659,,259,159113
Babine,2003,725,,260,159838
Babine,2003,588,,261,160426
Babine,2003,264,,262,160690
Babine,2003,190,,263,160880
Babine,2003,104,,264,160984
Babine,2003,90,,265,161074
Babine,2003,32,,266,161106
Babine,2003,46,,267,161152
Babine,2003,25,,268,161177
Babine,2003,14,,269,161191
Babine,2003,12,,270,161203
Babine,2003,3,,271,161206
Babine,2003,7,,272,161213
Babine,2003,5,,273,161218
Babine,2003,1,,274,161219
Babine,2003,0,,275,161219
Babine,2003,0,,276,161219
Babine,2003,0,,277,161219
Babine,2003,0,,278,161219
Babine,2003,0,,279,161219
Babine,2003,0,,280,161219
Babine,2003,1,,281,161220
Babine,2003,0,,282,161220
Babine,2004,0,,201,0
Babine,2004,1,,202,1
Babine,2004,0,,203,1
Babine,2004,0,,204,1
Babine,2004,0,,205,1
Babine,2004,0,,206,1
Babine,2004,0,,207,1
Babine,2004,0,,208,1
Babine,2004,0,,209,1
Babine,2004,18,,210,19
Babine,2004,54,,211,73
Babine,2004,54,,212,127
Babine,2004,90,,213,217
Babine,2004,102,,214,319
Babine,2004,198,,215,517
Babine,2004,221,,216,738
Babine,2004,382,,217,1120
Babine,2004,622,,218,1742
Babine,2004,901,,219,2643
Babine,2004,850,,220,3493
Babine,2004,1101,,221,4594
Babine,2004,958,,222,5552
Babine,2004,1205,,223,6757
Babine,2004,1388,,224,8145
Babine,2004,1587,,225,9732
Babine,2004,1751,,226,11483
Babine,2004,2444,,227,13927
Babine,2004,2524,,228,16451
Babine,2004,2234,,229,18685
Babine,2004,1957,,230,20642
Babine,2004,1004,,231,21646
Babine,2004,866,,232,22512
Babine,2004,732,,233,23244
Babine,2004,962,,234,24206
Babine,2004,995,,235,25201
Babine,2004,448,,236,25649
Babine,2004,532,,237,26181
Babine,2004,373,,238,26554
Babine,2004,324,,239,26878
Babine,2004,385,,240,27263
Babine,2004,320,,241,27583
Babine,2004,689,,242,28272
Babine,2004,480,,243,28752
Babine,2004,473,,244,29225
Babine,2004,1102,,245,30327
Babine,2004,3126,,246,33453
Babine,2004,840,,247,34293
Babine,2004,386,,248,34679
Babine,2004,667,,249,35346
Babine,2004,365,,250,35711
Babine,2004,332,,251,36043
Babine,2004,435,,252,36478
Babine,2004,553,,253,37031
Babine,2004,319,,254,37350
Babine,2004,888,,255,38238
Babine,2004,338,,256,38576
Babine,2004,108,,257,38684
Babine,2004,50,,258,38734
Babine,2004,28,,259,38762
Babine,2004,17,,260,38779
Babine,2004,10,,261,38789
Babine,2004,21,,262,38810
Babine,2004,5,,263,38815
Babine,2004,8,,264,38823
Babine,2004,8,,265,38831
Babine,2004,2,,266,38833
Babine,2004,12,,267,38845
Babine,2004,0,,268,38845
Babine,2004,1,,269,38846
Babine,2004,0,,270,38846
Babine,2004,2,,271,38848
Babine,2004,0,,272,38848
Babine,2004,1,,273,38849
Babine,2004,0,,274,38849
Babine,2004,1,,275,38850
Babine,2004,0,,276,38850
Babine,2005,0,,207,0
Babine,2005,26,,208,26
Babine,2005,73,,209,99
Babine,2005,701,,210,800
Babine,2005,2608,,211,3408
Babine,2005,1901,,212,5309
Babine,2005,4400,,213,9709
Babine,2005,2592,,214,12301
Babine,2005,1708,,215,14009
Babine,2005,6711,,216,20720
Babine,2005,4817,,217,25537
Babine,2005,7160,,218,32697
Babine,2005,6033,,219,38730
Babine,2005,6172,,220,44902
Babine,2005,7270,,221,52172
Babine,2005,8194,,222,60366
Babine,2005,12783,,223,73149
Babine,2005,10953,,224,84102
Babine,2005,14677,,225,98779
Babine,2005,11078,,226,109857
Babine,2005,26119,,227,135976
Babine,2005,9963,,228,145939
Babine,2005,12455,,229,158394
Babine,2005,10114,,230,168508
Babine,2005,12428,,231,180936
Babine,2005,9638,,232,190574
Babine,2005,11169,,233,201743
Babine,2005,12371,,234,214114
Babine,2005,6858,,235,220972
Babine,2005,5205,,236,226177
Babine,2005,5105,,237,231282
Babine,2005,3360,,238,234642
Babine,2005,4659,,239,239301
Babine,2005,4284,,240,243585
Babine,2005,4503,,241,248088
Babine,2005,3317,,242,251405
Babine,2005,3353,,243,254758
Babine,2005,3004,,244,257762
Babine,2005,3913,,245,261675
Babine,2005,4899,,246,266574
Babine,2005,5287,,247,271861
Babine,2005,4716,,248,276577
Babine,2005,4297,,249,280874
Babine,2005,4024,,250,284898
Babine,2005,3103,,251,288001
Babine,2005,2895,,252,290896
Babine,2005,2052,,253,292948
Babine,2005,2156,,254,295104
Babine,2005,1661,,255,296765
Babine,2005,2050,,256,298815
Babine,2005,1637,,257,300452
Babine,2005,1699,,258,302151
Babine,2005,882,,259,303033
Babine,2005,1080,,260,304113
Babine,2005,592,,261,304705
Babine,2005,450,,262,305155
Babine,2005,284,,263,305439
Babine,2005,160,,264,305599
Babine,2005,80,,265,305679
Babine,2005,53,,266,305732
Babine,2005,28,,267,305760
Babine,2005,18,,268,305778
Babine,2005,24,,269,305802
Babine,2005,12,,270,305814
Babine,2005,15,,271,305829
Babine,2005,9,,272,305838
Babine,2005,1,,273,305839
Babine,2005,3,,274,305842
Babine,2005,0,,275,305842
Babine,2005,0,,276,305842
Babine,2005,1,,277,305843
Babine,2005,1,,278,305844
Babine,2005,0,,279,305844
Babine,2006,0,,202,0
Babine,2006,5,,203,5
Babine,2006,4,,204,9
Babine,2006,1,,205,10
Babine,2006,1,,206,11
Babine,2006,0,,207,11
Babine,2006,3,,208,14
Babine,2006,2,,209,16
Babine,2006,1,,210,17
Babine,2006,4,,211,21
Babine,2006,7,,212,28
Babine,2006,14,,213,42
Babine,2006,24,,214,66
Babine,2006,176,,215,242
Babine,2006,268,,216,510
Babine,2006,231,,217,741
Babine,2006,486,,218,1227
Babine,2006,375,,219,1602
Babine,2006,189,,220,1791
Babine,2006,303,,221,2094
Babine,2006,882,,222,2976
Babine,2006,548,,223,3524
Babine,2006,1478,,224,5002
Babine,2006,1985,,225,6987
Babine,2006,903,,226,7890
Babine,2006,1635,,227,9525
Babine,2006,1474,,228,10999
Babine,2006,1244,,229,12243
Babine,2006,1978,,230,14221
Babine,2006,1240,,231,15461
Babine,2006,768,,232,16229
Babine,2006,967,,233,17196
Babine,2006,1044,,234,18240
Babine,2006,444,,235,18684
Babine,2006,576,,236,19260
Babine,2006,605,,237,19865
Babine,2006,449,,238,20314
Babine,2006,551,,239,20865
Babine,2006,647,,240,21512
Babine,2006,485,,241,21997
Babine,2006,377,,242,22374
Babine,2006,559,,243,22933
Babine,2006,717,,244,23650
Babine,2006,406,,245,24056
Babine,2006,859,,246,24915
Babine,2006,357,,247,25272
Babine,2006,555,,248,25827
Babine,2006,547,,249,26374
Babine,2006,311,,250,26685
Babine,2006,368,,251,27053
Babine,2006,298,,252,27351
Babine,2006,347,,253,27698
Babine,2006,311,,254,28009
Babine,2006,196,,255,28205
Babine,2006,175,,256,28380
Babine,2006,208,,257,28588
Babine,2006,99,,258,28687
Babine,2006,96,,259,28783
Babine,2006,39,,260,28822
Babine,2006,33,,261,28855
Babine,2006,18,,262,28873
Babine,2006,15,,263,28888
Babine,2006,17,,264,28905
Babine,2006,11,,265,28916
Babine,2006,6,,266,28922
Babine,2006,3,,267,28925
Babine,2006,3,,268,28928
Babine,2006,4,,269,28932
Babine,2006,1,,270,28933
Babine,2006,0,,271,28933
Babine,2006,0,,272,28933
Babine,2006,0,,273,28933
Babine,2006,0,,274,28933
Babine,2006,0,,275,28933
Babine,2006,0,,276,28933
Babine,2006,0,,277,28933
Babine,2007,4,,219,4
Babine,2007,15,,220,19
Babine,2007,36,,221,55
Babine,2007,71,,222,126
Babine,2007,153,,223,279
Babine,2007,434,,224,713
Babine,2007,882,,225,1595
Babine,2007,1287,,226,2882
Babine,2007,1981,,227,4863
Babine,2007,2814,,228,7677
Babine,2007,3072,,229,10749
Babine,2007,7312,,230,18061
Babine,2007,7777,,231,25838
Babine,2007,7031,,232,32869
Babine,2007,3805,,233,36674
Babine,2007,1929,,234,38603
Babine,2007,2825,,235,41428
Babine,2007,10598,,236,52026
Babine,2007,4707,,237,56733
Babine,2007,7475,,238,64208
Babine,2007,7773,,239,71981
Babine,2007,1709,,240,73690
Babine,2007,2841,,241,76531
Babine,2007,5661,,242,82192
Babine,2007,1857,,243,84049
Babine,2007,2587,,244,86636
Babine,2007,2112,,245,88748
Babine,2007,577,,246,89325
Babine,2007,3029,,247,92354
Babine,2007,2951,,248,95305
Babine,2007,1545,,249,96850
Babine,2007,1173,,250,98023
Babine,2007,1572,,251,99595
Babine,2007,865,,252,100460
Babine,2007,1506,,253,101966
Babine,2007,1953,,254,103919
Babine,2007,1101,,255,105020
Babine,2007,1579,,256,106599
Babine,2007,932,,257,107531
Babine,2007,1058,,258,108589
Babine,2007,954,,259,109543
Babine,2007,959,,260,110502
Babine,2007,566,,261,111068
Babine,2007,324,,262,111392
Babine,2007,165,,263,111557
Babine,2007,124,,264,111681
Babine,2007,58,,265,111739
Babine,2007,50,,266,111789
Babine,2007,23,,267,111812
Babine,2007,12,,268,111824
Babine,2007,6,,269,111830
Babine,2007,30,,270,111860
Babine,2007,2,,271,111862
Babine,2007,8,,272,111870
Babine,2007,5,,273,111875
Babine,2008,0,,209,0
Babine,2008,3,,210,3
Babine,2008,5,,211,8
Babine,2008,6,,212,14
Babine,2008,17,,213,31
Babine,2008,9,,214,40
Babine,2008,6,,215,46
Babine,2008,8,,216,54
Babine,2008,1,,217,55
Babine,2008,5,,218,60
Babine,2008,17,,219,77
Babine,2008,9,,220,86
Babine,2008,16,,221,102
Babine,2008,58,,222,160
Babine,2008,35,,223,195
Babine,2008,180,,224,375
Babine,2008,269,,225,644
Babine,2008,136,,226,780
Babine,2008,269,,227,1049
Babine,2008,386,,228,1435
Babine,2008,200,,229,1635
Babine,2008,511,,230,2146
Babine,2008,1288,,231,3434
Babine,2008,709,,232,4143
Babine,2008,925,,233,5068
Babine,2008,2051,,234,7119
Babine,2008,1445,,235,8564
Babine,2008,1093,,236,9657
Babine,2008,1922,,237,11579
Babine,2008,464,,238,12043
Babine,2008,1473,,239,13516
Babine,2008,1221,,240,14737
Babine,2008,626,,241,15363
Babine,2008,679,,242,16042
Babine,2008,582,,243,16624
Babine,2008,1244,,244,17868
Babine,2008,974,,245,18842
Babine,2008,904,,246,19746
Babine,2008,1116,,247,20862
Babine,2008,841,,248,21703
Babine,2008,678,,249,22381
Babine,2008,648,,250,23029
Babine,2008,758,,251,23787
Babine,2008,500,,252,24287
Babine,2008,490,,253,24777
Babine,2008,354,,254,25131
Babine,2008,223,,255,25354
Babine,2008,132,,256,25486
Babine,2008,62,,257,25548
Babine,2008,65,,258,25613
Babine,2008,36,,259,25649
Babine,2008,21,,260,25670
Babine,2008,12,,261,25682
Babine,2008,6,,262,25688
Babine,2008,8,,263,25696
Babine,2008,3,,264,25699
Babine,2008,3,,265,25702
Babine,2008,1,,266,25703
Babine,2008,0,,267,25703
Babine,2009,0,,210,0
Babine,2009,2,,211,2
Babine,2009,6,,212,8
Babine,2009,3,,213,11
Babine,2009,31,,214,42
Babine,2009,45,,215,87
Babine,2009,39,,216,126
Babine,2009,138,,217,264
Babine,2009,250,,218,514
Babine,2009,343,,219,857
Babine,2009,511,,220,1368
Babine,2009,2007,,221,3375
Babine,2009,4311,,222,7686
Babine,2009,8210,,223,15896
Babine,2009,11219,,224,27115
Babine,2009,11514,,225,38629
Babine,2009,13620,,226,52249
Babine,2009,21397,,227,73646
Babine,2009,29902,,228,103548
Babine,2009,29171,,229,132719
Babine,2009,18630,,230,151349
Babine,2009,21981,,231,173330
Babine,2009,24692,,232,198022
Babine,2009,22299,,233,220321
Babine,2009,21147,,234,241468
Babine,2009,19478,,235,260946
Babine,2009,10932,,236,271878
Babine,2009,10727,,237,282605
Babine,2009,8352,,238,290957
Babine,2009,12927,,239,303884
Babine,2009,13634,,240,317518
Babine,2009,12036,,241,329554
Babine,2009,18260,,242,347814
Babine,2009,12948,,243,360762
Babine,2009,7000,,244,367762
Babine,2009,8751,,245,376513
Babine,2009,9996,,246,386509
Babine,2009,8873,,247,395382
Babine,2009,7956,,248,403338
Babine,2009,18424,,249,421762
Babine,2009,12158,,250,433920
Babine,2009,8637,,251,442557
Babine,2009,8575,,252,451132
Babine,2009,10099,,253,461231
Babine,2009,7905,,254,469136
Babine,2009,9864,,255,479000
Babine,2009,4062,,256,483062
Babine,2009,7681,,257,490743
Babine,2009,5485,,258,496228
Babine,2009,6683,,259,502911
Babine,2009,7672,,260,510583
Babine,2009,2935,,261,513518
Babine,2009,1923,,262,515441
Babine,2009,1063,,263,516504
Babine,2009,468,,264,516972
Babine,2010,0,,209,0
Babine,2010,6,,210,6
Babine,2010,2,,211,8
Babine,2010,13,,212,21
Babine,2010,13,,213,34
Babine,2010,26,,214,60
Babine,2010,53,,215,113
Babine,2010,150,,216,263
Babine,2010,69,,217,332
Babine,2010,243,,218,575
Babine,2010,125,,219,700
Babine,2010,232,,220,932
Babine,2010,267,,221,1199
Babine,2010,201,,222,1400
Babine,2010,283,,223,1683
Babine,2010,384,,224,2067
Babine,2010,872,,225,2939
Babine,2010,1179,,226,4118
Babine,2010,1319,,227,5437
Babine,2010,1563,,228,7000
Babine,2010,1817,,229,8817
Babine,2010,2320,,230,11137
Babine,2010,2597,,231,13734
Babine,2010,2276,,232,16010
Babine,2010,2589,,233,18599
Babine,2010,1846,,234,20445
Babine,2010,1419,,235,21864
Babine,2010,2041,,236,23905
Babine,2010,2700,,237,26605
Babine,2010,2118,,238,28723
Babine,2010,879,,239,29602
Babine,2010,1059,,240,30661
Babine,2010,1666,,241,32327
Babine,2010,1481,,242,33808
Babine,2010,2307,,243,36115
Babine,2010,1871,,244,37986
Babine,2010,2037,,245,40023
Babine,2010,1376,,246,41399
Babine,2010,1160,,247,42559
Babine,2010,1299,,248,43858
Babine,2010,1617,,249,45475
Babine,2010,1424,,250,46899
Babine,2010,1478,,251,48377
Babine,2010,1340,,252,49717
Babine,2010,934,,253,50651
Babine,2010,919,,254,51570
Babine,2010,628,,255,52198
Babine,2010,612,,256,52810
Babine,2010,631,,257,53441
Babine,2010,657,,258,54098
Babine,2010,443,,259,54541
Babine,2010,338,,260,54879
Babine,2010,230,,261,55109
Babine,2010,135,,262,55244
Babine,2010,59,,263,55303
Babine,2010,82,,264,55385
Babine,2010,27,,265,55412
Babine,2010,30,,266,55442
Babine,2010,20,,267,55462
Babine,2010,6,,268,55468
Babine,2010,14,,269,55482
Babine,2010,7,,270,55489
Babine,2011,4,,222,4
Babine,2011,248,,223,252
Babine,2011,600,,224,852
Babine,2011,132,,225,984
Babine,2011,3472,,226,4456
Babine,2011,2486,,227,6942
Babine,2011,788,,228,7730
Babine,2011,2375,,229,10105
Babine,2011,3651,,230,13756
Babine,2011,4410,,231,18166
Babine,2011,3028,,232,21194
Babine,2011,5516,,233,26710
Babine,2011,6245,,234,32955
Babine,2011,5058,,235,38013
Babine,2011,3216,,236,41229
Babine,2011,1929,,237,43158
Babine,2011,1641,,238,44799
Babine,2011,1344,,239,46143
Babine,2011,998,,240,47141
Babine,2011,1331,,241,48472
Babine,2011,2411,,242,50883
Babine,2011,2205,,243,53088
Babine,2011,2361,,244,55449
Babine,2011,2288,,245,57737
Babine,2011,2387,,246,60124
Babine,2011,1428,,247,61552
Babine,2011,1086,,248,62638
Babine,2011,1177,,249,63815
Babine,2011,1521,,250,65336
Babine,2011,702,,251,66038
Babine,2011,2899,,252,68937
Babine,2011,517,,253,69454
Babine,2011,427,,254,69881
Babine,2011,425,,255,70306
Babine,2011,670,,256,70976
Babine,2011,312,,257,71288
Babine,2011,226,,258,71514
Babine,2011,221,,259,71735
Babine,2011,196,,260,71931
Babine,2011,150,,261,72081
Babine,2011,121,,262,72202
Babine,2011,92,,263,72294
Babine,2011,64,,264,72358
Babine,2011,35,,265,72393
Babine,2011,37,,266,72430
Babine,2011,42,,267,72472
Babine,2011,8,,268,72480
Babine,2011,8,,269,72488
Babine,2011,10,,270,72498
Babine,2011,1,,271,72499
Babine,2011,1,,272,72500
Babine,2011,0,,273,72500
Babine,2011,1,,274,72501
Babine,2011,0,,275,72501
Babine,2012,0,,219,0
Babine,2012,3,,220,3
Babine,2012,0,,221,3
Babine,2012,3,,222,6
Babine,2012,7,,223,13
Babine,2012,23,,224,36
Babine,2012,11,,225,47
Babine,2012,67,,226,114
Babine,2012,43,,227,157
Babine,2012,107,,228,264
Babine,2012,76,,229,340
Babine,2012,392,,230,732
Babine,2012,474,,231,1206
Babine,2012,990,,232,2196
Babine,2012,1600,,233,3796
Babine,2012,2442,,234,6238
Babine,2012,3806,,235,10044
Babine,2012,2978,,236,13022
Babine,2012,3290,,237,16312
Babine,2012,3113,,238,19425
Babine,2012,3465,,239,22890
Babine,2012,3155,,240,26045
Babine,2012,2814,,241,28859
Babine,2012,2951,,242,31810
Babine,2012,2807,,243,34617
Babine,2012,1782,,244,36399
Babine,2012,2328,,245,38727
Babine,2012,1962,,246,40689
Babine,2012,2241,,247,42930
Babine,2012,1475,,248,44405
Babine,2012,755,,249,45160
Babine,2012,689,,250,45849
Babine,2012,602,,251,46451
Babine,2012,327,,252,46778
Babine,2012,108,,253,46886
Babine,2012,28,,254,46914
Babine,2012,435,,255,47349
Babine,2012,218,,256,47567
Babine,2012,0,,257,47567
Babine,2012,141,,258,47708
Babine,2012,57,,259,47765
Babine,2012,50,,260,47815
Babine,2012,27,,261,47842
Babine,2012,21,,262,47863
Babine,2012,24,,263,47887
Babine,2012,14,,264,47901
Babine,2012,10,,265,47911
Babine,2012,5,,266,47916
Babine,2012,2,,267,47918
Babine,2012,6,,268,47924
Babine,2012,0,,269,47924
Babine,2012,0,,270,47924
Babine,2012,0,,271,47924
Babine,2012,0,,272,47924
Babine,2012,1,,273,47925
Babine,2012,0,,274,47925
Litnik,2012,0,,175,0
Litnik,2012,0,,176,0
Litnik,2012,0,,177,0
Litnik,2012,0,,178,0
Litnik,2012,0,,179,0
Litnik,2012,0,,180,0
Litnik,2012,0,,181,0
Litnik,2012,0,,182,0
Litnik,2012,0,,183,0
Litnik,2012,0,,184,0
Litnik,2012,0,,185,0
Litnik,2012,0,,186,0
Litnik,2012,0,,187,0
Litnik,2012,0,,188,0
Litnik,2012,0,,189,0
Litnik,2012,0,,190,0
Litnik,2012,0,,191,0
Litnik,2012,0,,192,0
Litnik,2012,3,,193,3
Litnik,2012,9,,194,12
Litnik,2012,8,,195,20
Litnik,2012,2,,196,22
Litnik,2012,13,,197,35
Litnik,2012,8,,198,43
Litnik,2012,1,,199,44
Litnik,2012,10,,200,54
Litnik,2012,3,,201,57
Litnik,2012,6,,202,63
Litnik,2012,15,,203,78
Litnik,2012,10,,204,88
Litnik,2012,1,,205,89
Litnik,2012,5,,206,94
Litnik,2012,1,,207,95
Litnik,2012,2,,208,97
Litnik,2012,0,,209,97
Litnik,2012,1,,210,98
Litnik,2012,2,,211,100
Litnik,2012,886,,212,986
Litnik,2012,42,,213,1028
Litnik,2012,13,,214,1041
Litnik,2012,3,,215,1044
Litnik,2012,19,,216,1063
Litnik,2012,57,,217,1120
Litnik,2012,190,,218,1310
Litnik,2012,298,,219,1608
Litnik,2012,78,,220,1686
Litnik,2012,84,,221,1770
Litnik,2012,72,,222,1842
Litnik,2012,39,,223,1881
Litnik,2012,32,,224,1913
Litnik,2012,1128,,225,3041
Litnik,2012,1734,,226,4775
Litnik,2012,19687,,227,24462
Litnik,2012,15746,,228,40208
Litnik,2012,2327,,229,42535
Litnik,2012,1768,,230,44303
Litnik,2012,1386,,231,45689
Litnik,2012,1658,,232,47347
Litnik,2012,833,,233,48180
Litnik,2012,425,,234,48605
Litnik,2012,600,,235,49205
Litnik,2012,1936,,236,51141
Litnik,2012,787,,237,51928
Litnik,2012,60000,,238,111928
Litnik,2012,0,,239,111928
Litnik,2012,0,,240,111928
Litnik,2012,0,,241,111928
Litnik,2012,0,,242,111928
Litnik,2012,0,,243,111928
Litnik,2012,0,,244,111928
Litnik,2012,0,,245,111928
Litnik,2012,0,,246,111928
Litnik,2012,0,,247,111928
Litnik,2012,0,,248,111928
Litnik,2012,0,,249,111928
Litnik,2012,0,,250,111928
Litnik,2012,0,,251,111928
Litnik,2012,0,,252,111928
Litnik,2012,0,,253,111928
Litnik,2012,0,,254,111928
Litnik,2012,0,,255,111928
Litnik,2012,0,,256,111928
Litnik,2012,0,,257,111928
Litnik,2012,0,,258,111928
Litnik,2012,0,,259,111928
Litnik,2012,0,,260,111928
Litnik,2012,0,,261,111928
Litnik,2012,0,,262,111928
Litnik,2012,0,,263,111928
Litnik,2012,0,,264,111928
Litnik,2012,0,,265,111928
Litnik,2012,0,,266,111928
Litnik,2012,0,,267,111928
Litnik,2012,0,,268,111928
Litnik,2012,0,,269,111928
Litnik,2012,0,,270,111928
Litnik,2012,0,,271,111928
Litnik,2012,0,,272,111928
Litnik,2012,0,,273,111928
Litnik,2012,0,,274,111928
Litnik,2011,0,,174,0
Litnik,2011,0,,175,0
Litnik,2011,0,,176,0
Litnik,2011,0,,177,0
Litnik,2011,0,,178,0
Litnik,2011,0,,179,0
Litnik,2011,0,,180,0
Litnik,2011,0,,181,0
Litnik,2011,0,,182,0
Litnik,2011,0,,183,0
Litnik,2011,0,,184,0
Litnik,2011,0,,185,0
Litnik,2011,0,,186,0
Litnik,2011,0,,187,0
Litnik,2011,0,,188,0
Litnik,2011,0,,189,0
Litnik,2011,0,,190,0
Litnik,2011,0,,191,0
Litnik,2011,0,,192,0
Litnik,2011,0,,193,0
Litnik,2011,0,,194,0
Litnik,2011,0,,195,0
Litnik,2011,0,,196,0
Litnik,2011,0,,197,0
Litnik,2011,0,,198,0
Litnik,2011,0,,199,0
Litnik,2011,0,,200,0
Litnik,2011,0,,201,0
Litnik,2011,0,,202,0
Litnik,2011,0,,203,0
Litnik,2011,0,,204,0
Litnik,2011,0,,205,0
Litnik,2011,0,,206,0
Litnik,2011,0,,207,0
Litnik,2011,0,,208,0
Litnik,2011,0,,209,0
Litnik,2011,0,,210,0
Litnik,2011,0,,211,0
Litnik,2011,1,,212,1
Litnik,2011,21,,213,22
Litnik,2011,3,,214,25
Litnik,2011,12,,215,37
Litnik,2011,2,,216,39
Litnik,2011,2,,217,41
Litnik,2011,0,,218,41
Litnik,2011,8,,219,49
Litnik,2011,15,,220,64
Litnik,2011,15,,221,79
Litnik,2011,14,,222,93
Litnik,2011,12,,223,105
Litnik,2011,44,,224,149
Litnik,2011,5,,225,154
Litnik,2011,23,,226,177
Litnik,2011,2,,227,179
Litnik,2011,34,,228,213
Litnik,2011,20,,229,233
Litnik,2011,545,,230,778
Litnik,2011,1899,,231,2677
Litnik,2011,1564,,232,4241
Litnik,2011,0,,233,4241
Litnik,2011,0,,234,4241
Litnik,2011,0,,235,4241
Litnik,2011,0,,236,4241
Litnik,2011,0,,237,4241
Litnik,2011,0,,238,4241
Litnik,2011,0,,239,4241
Litnik,2011,0,,240,4241
Litnik,2011,0,,241,4241
Litnik,2011,0,,242,4241
Litnik,2011,0,,243,4241
Litnik,2011,0,,244,4241
Litnik,2011,0,,245,4241
Litnik,2011,0,,246,4241
Litnik,2011,0,,247,4241
Litnik,2011,0,,248,4241
Litnik,2011,0,,249,4241
Litnik,2011,0,,250,4241
Litnik,2011,0,,251,4241
Litnik,2011,0,,252,4241
Litnik,2011,0,,253,4241
Litnik,2011,0,,254,4241
Litnik,2011,0,,255,4241
Litnik,2011,0,,256,4241
Litnik,2011,0,,257,4241
Litnik,2011,0,,258,4241
Litnik,2011,0,,259,4241
Litnik,2011,0,,260,4241
Litnik,2011,0,,261,4241
Litnik,2011,0,,262,4241
Litnik,2011,0,,263,4241
Litnik,2011,0,,264,4241
Litnik,2011,0,,265,4241
Litnik,2011,0,,266,4241
Litnik,2011,0,,267,4241
Litnik,2011,0,,268,4241
Litnik,2011,0,,269,4241
Litnik,2011,0,,270,4241
Litnik,2011,0,,271,4241
Litnik,2011,0,,272,4241
Litnik,2011,0,,273,4241
Litnik,2010,0,,174,0
Litnik,2010,0,,175,0
Litnik,2010,0,,176,0
Litnik,2010,0,,177,0
Litnik,2010,0,,178,0
Litnik,2010,0,,179,0
Litnik,2010,0,,180,0
Litnik,2010,0,,181,0
Litnik,2010,0,,182,0
Litnik,2010,0,,183,0
Litnik,2010,0,,184,0
Litnik,2010,0,,185,0
Litnik,2010,0,,186,0
Litnik,2010,0,,187,0
Litnik,2010,0,,188,0
Litnik,2010,0,,189,0
Litnik,2010,0,,190,0
Litnik,2010,0,,191,0
Litnik,2010,2,,192,2
Litnik,2010,0,,193,2
Litnik,2010,2,,194,4
Litnik,2010,0,,195,4
Litnik,2010,4,,196,8
Litnik,2010,9,,197,17
Litnik,2010,3,,198,20
Litnik,2010,0,,199,20
Litnik,2010,0,,200,20
Litnik,2010,0,,201,20
Litnik,2010,2,,202,22
Litnik,2010,0,,203,22
Litnik,2010,1,,204,23
Litnik,2010,1,,205,24
Litnik,2010,3,,206,27
Litnik,2010,0,,207,27
Litnik,2010,5,,208,32
Litnik,2010,1,,209,33
Litnik,2010,4,,210,37
Litnik,2010,1135,,211,1172
Litnik,2010,864,,212,2036
Litnik,2010,9,,213,2045
Litnik,2010,37,,214,2082
Litnik,2010,163,,215,2245
Litnik,2010,141,,216,2386
Litnik,2010,156,,217,2542
Litnik,2010,897,,218,3439
Litnik,2010,182,,219,3621
Litnik,2010,3929,,220,7550
Litnik,2010,1322,,221,8872
Litnik,2010,316,,222,9188
Litnik,2010,93,,223,9281
Litnik,2010,535,,224,9816
Litnik,2010,8,,225,9824
Litnik,2010,5,,226,9829
Litnik,2010,17974,,227,27803
Litnik,2010,2370,,228,30173
Litnik,2010,3639,,229,33812
Litnik,2010,1525,,230,35337
Litnik,2010,376,,231,35713
Litnik,2010,41,,232,35754
Litnik,2010,337,,233,36091
Litnik,2010,2016,,234,38107
Litnik,2010,16,,235,38123
Litnik,2010,172,,236,38295
Litnik,2010,443,,237,38738
Litnik,2010,1089,,238,39827
Litnik,2010,975,,239,40802
Litnik,2010,752,,240,41554
Litnik,2010,1131,,241,42685
Litnik,2010,825,,242,43510
Litnik,2010,1390,,243,44900
Litnik,2010,1010,,244,45910
Litnik,2010,1109,,245,47019
Litnik,2010,1409,,246,48428
Litnik,2010,3241,,247,51669
Litnik,2010,5454,,248,57123
Litnik,2010,614,,249,57737
Litnik,2010,4500,,250,62237
Litnik,2010,0,,251,62237
Litnik,2010,0,,252,62237
Litnik,2010,0,,253,62237
Litnik,2010,0,,254,62237
Litnik,2010,0,,255,62237
Litnik,2010,0,,256,62237
Litnik,2010,0,,257,62237
Litnik,2010,0,,258,62237
Litnik,2010,0,,259,62237
Litnik,2010,0,,260,62237
Litnik,2010,0,,261,62237
Litnik,2010,0,,262,62237
Litnik,2010,0,,263,62237
Litnik,2010,0,,264,62237
Litnik,2010,0,,265,62237
Litnik,2010,0,,266,62237
Litnik,2010,0,,267,62237
Litnik,2010,0,,268,62237
Litnik,2010,0,,269,62237
Litnik,2010,0,,270,62237
Litnik,2010,0,,271,62237
Litnik,2010,0,,272,62237
Litnik,2010,0,,273,62237
Litnik,2009,0,,174,0
Litnik,2009,0,,175,0
Litnik,2009,0,,176,0
Litnik,2009,0,,177,0
Litnik,2009,0,,178,0
Litnik,2009,0,,179,0
Litnik,2009,0,,180,0
Litnik,2009,0,,181,0
Litnik,2009,0,,182,0
Litnik,2009,0,,183,0
Litnik,2009,0,,184,0
Litnik,2009,0,,185,0
Litnik,2009,0,,186,0
Litnik,2009,0,,187,0
Litnik,2009,0,,188,0
Litnik,2009,0,,189,0
Litnik,2009,0,,190,0
Litnik,2009,0,,191,0
Litnik,2009,0,,192,0
Litnik,2009,0,,193,0
Litnik,2009,0,,194,0
Litnik,2009,0,,195,0
Litnik,2009,0,,196,0
Litnik,2009,0,,197,0
Litnik,2009,0,,198,0
Litnik,2009,0,,199,0
Litnik,2009,0,,200,0
Litnik,2009,0,,201,0
Litnik,2009,0,,202,0
Litnik,2009,5,,203,5
Litnik,2009,10,,204,15
Litnik,2009,1,,205,16
Litnik,2009,6,,206,22
Litnik,2009,22,,207,44
Litnik,2009,0,,208,44
Litnik,2009,1,,209,45
Litnik,2009,12,,210,57
Litnik,2009,14,,211,71
Litnik,2009,2,,212,73
Litnik,2009,1,,213,74
Litnik,2009,10,,214,84
Litnik,2009,19,,215,103
Litnik,2009,604,,216,707
Litnik,2009,132,,217,839
Litnik,2009,56,,218,895
Litnik,2009,0,,219,895
Litnik,2009,0,,220,895
Litnik,2009,0,,221,895
Litnik,2009,0,,222,895
Litnik,2009,0,,223,895
Litnik,2009,0,,224,895
Litnik,2009,0,,225,895
Litnik,2009,0,,226,895
Litnik,2009,0,,227,895
Litnik,2009,0,,228,895
Litnik,2009,0,,229,895
Litnik,2009,0,,230,895
Litnik,2009,0,,231,895
Litnik,2009,0,,232,895
Litnik,2009,0,,233,895
Litnik,2009,0,,234,895
Litnik,2009,0,,235,895
Litnik,2009,0,,236,895
Litnik,2009,0,,237,895
Litnik,2009,0,,238,895
Litnik,2009,0,,239,895
Litnik,2009,0,,240,895
Litnik,2009,0,,241,895
Litnik,2009,0,,242,895
Litnik,2009,0,,243,895
Litnik,2009,0,,244,895
Litnik,2009,0,,245,895
Litnik,2009,0,,246,895
Litnik,2009,0,,247,895
Litnik,2009,0,,248,895
Litnik,2009,0,,249,895
Litnik,2009,0,,250,895
Litnik,2009,0,,251,895
Litnik,2009,0,,252,895
Litnik,2009,0,,253,895
Litnik,2009,0,,254,895
Litnik,2009,0,,255,895
Litnik,2009,0,,256,895
Litnik,2009,0,,257,895
Litnik,2009,0,,258,895
Litnik,2009,0,,259,895
Litnik,2009,0,,260,895
Litnik,2009,0,,261,895
Litnik,2009,0,,262,895
Litnik,2009,0,,263,895
Litnik,2009,0,,264,895
Litnik,2009,0,,265,895
Litnik,2009,0,,266,895
Litnik,2009,0,,267,895
Litnik,2009,0,,268,895
Litnik,2009,0,,269,895
Litnik,2009,0,,270,895
Litnik,2009,0,,271,895
Litnik,2009,0,,272,895
Litnik,2009,0,,273,895
Litnik,2008,0,,175,0
Litnik,2008,0,,176,0
Litnik,2008,0,,177,0
Litnik,2008,0,,178,0
Litnik,2008,0,,179,0
Litnik,2008,0,,180,0
Litnik,2008,0,,181,0
Litnik,2008,1,,182,1
Litnik,2008,0,,183,1
Litnik,2008,0,,184,1
Litnik,2008,3,,185,4
Litnik,2008,13,,186,17
Litnik,2008,25,,187,42
Litnik,2008,16,,188,58
Litnik,2008,7,,189,65
Litnik,2008,24,,190,89
Litnik,2008,1,,191,90
Litnik,2008,3,,192,93
Litnik,2008,10,,193,103
Litnik,2008,2,,194,105
Litnik,2008,4,,195,109
Litnik,2008,1,,196,110
Litnik,2008,281,,197,391
Litnik,2008,103,,198,494
Litnik,2008,420,,199,914
Litnik,2008,115,,200,1029
Litnik,2008,81,,201,1110
Litnik,2008,55,,202,1165
Litnik,2008,104,,203,1269
Litnik,2008,44,,204,1313
Litnik,2008,17,,205,1330
Litnik,2008,280,,206,1610
Litnik,2008,72,,207,1682
Litnik,2008,77,,208,1759
Litnik,2008,125,,209,1884
Litnik,2008,111,,210,1995
Litnik,2008,232,,211,2227
Litnik,2008,144,,212,2371
Litnik,2008,91,,213,2462
Litnik,2008,76,,214,2538
Litnik,2008,31,,215,2569
Litnik,2008,17,,216,2586
Litnik,2008,6,,217,2592
Litnik,2008,57,,218,2649
Litnik,2008,45,,219,2694
Litnik,2008,22,,220,2716
Litnik,2008,13000,,221,15716
Litnik,2008,0,,222,15716
Litnik,2008,0,,223,15716
Litnik,2008,0,,224,15716
Litnik,2008,0,,225,15716
Litnik,2008,0,,226,15716
Litnik,2008,0,,227,15716
Litnik,2008,0,,228,15716
Litnik,2008,0,,229,15716
Litnik,2008,0,,230,15716
Litnik,2008,0,,231,15716
Litnik,2008,0,,232,15716
Litnik,2008,0,,233,15716
Litnik,2008,0,,234,15716
Litnik,2008,0,,235,15716
Litnik,2008,0,,236,15716
Litnik,2008,0,,237,15716
Litnik,2008,0,,238,15716
Litnik,2008,0,,239,15716
Litnik,2008,0,,240,15716
Litnik,2008,0,,241,15716
Litnik,2008,0,,242,15716
Litnik,2008,0,,243,15716
Litnik,2008,0,,244,15716
Litnik,2008,0,,245,15716
Litnik,2008,0,,246,15716
Litnik,2008,0,,247,15716
Litnik,2008,0,,248,15716
Litnik,2008,0,,249,15716
Litnik,2008,0,,250,15716
Litnik,2008,0,,251,15716
Litnik,2008,0,,252,15716
Litnik,2008,0,,253,15716
Litnik,2008,0,,254,15716
Litnik,2008,0,,255,15716
Litnik,2008,0,,256,15716
Litnik,2008,0,,257,15716
Litnik,2008,0,,258,15716
Litnik,2008,0,,259,15716
Litnik,2008,0,,260,15716
Litnik,2008,0,,261,15716
Litnik,2008,0,,262,15716
Litnik,2008,0,,263,15716
Litnik,2008,0,,264,15716
Litnik,2008,0,,265,15716
Litnik,2008,0,,266,15716
Litnik,2008,0,,267,15716
Litnik,2008,0,,268,15716
Litnik,2008,0,,269,15716
Litnik,2008,0,,270,15716
Litnik,2008,0,,271,15716
Litnik,2008,0,,272,15716
Litnik,2008,0,,273,15716
Litnik,2008,0,,274,15716
Litnik,2007,0,,174,0
Litnik,2007,0,,175,0
Litnik,2007,0,,176,0
Litnik,2007,0,,177,0
Litnik,2007,0,,178,0
Litnik,2007,0,,179,0
Litnik,2007,0,,180,0
Litnik,2007,0,,181,0
Litnik,2007,0,,182,0
Litnik,2007,0,,183,0
Litnik,2007,0,,184,0
Litnik,2007,0,,185,0
Litnik,2007,0,,186,0
Litnik,2007,0,,187,0
Litnik,2007,0,,188,0
Litnik,2007,0,,189,0
Litnik,2007,0,,190,0
Litnik,2007,0,,191,0
Litnik,2007,0,,192,0
Litnik,2007,0,,193,0
Litnik,2007,0,,194,0
Litnik,2007,2,,195,2
Litnik,2007,0,,196,2
Litnik,2007,0,,197,2
Litnik,2007,0,,198,2
Litnik,2007,0,,199,2
Litnik,2007,0,,200,2
Litnik,2007,1,,201,3
Litnik,2007,0,,202,3
Litnik,2007,0,,203,3
Litnik,2007,0,,204,3
Litnik,2007,8,,205,11
Litnik,2007,321,,206,332
Litnik,2007,300,,207,632
Litnik,2007,9,,208,641
Litnik,2007,20,,209,661
Litnik,2007,39,,210,700
Litnik,2007,27,,211,727
Litnik,2007,19,,212,746
Litnik,2007,27,,213,773
Litnik,2007,30,,214,803
Litnik,2007,9,,215,812
Litnik,2007,31,,216,843
Litnik,2007,188,,217,1031
Litnik,2007,43,,218,1074
Litnik,2007,35,,219,1109
Litnik,2007,38,,220,1147
Litnik,2007,50,,221,1197
Litnik,2007,81,,222,1278
Litnik,2007,80,,223,1358
Litnik,2007,64,,224,1422
Litnik,2007,27,,225,1449
Litnik,2007,132,,226,1581
Litnik,2007,144,,227,1725
Litnik,2007,52,,228,1777
Litnik,2007,10000,,229,11777
Litnik,2007,0,,230,11777
Litnik,2007,0,,231,11777
Litnik,2007,0,,232,11777
Litnik,2007,0,,233,11777
Litnik,2007,0,,234,11777
Litnik,2007,0,,235,11777
Litnik,2007,0,,236,11777
Litnik,2007,0,,237,11777
Litnik,2007,0,,238,11777
Litnik,2007,0,,239,11777
Litnik,2007,0,,240,11777
Litnik,2007,0,,241,11777
Litnik,2007,0,,242,11777
Litnik,2007,0,,243,11777
Litnik,2007,0,,244,11777
Litnik,2007,0,,245,11777
Litnik,2007,0,,246,11777
Litnik,2007,0,,247,11777
Litnik,2007,0,,248,11777
Litnik,2007,0,,249,11777
Litnik,2007,0,,250,11777
Litnik,2007,0,,251,11777
Litnik,2007,0,,252,11777
Litnik,2007,0,,253,11777
Litnik,2007,0,,254,11777
Litnik,2007,0,,255,11777
Litnik,2007,0,,256,11777
Litnik,2007,0,,257,11777
Litnik,2007,0,,258,11777
Litnik,2007,0,,259,11777
Litnik,2007,0,,260,11777
Litnik,2007,0,,261,11777
Litnik,2007,0,,262,11777
Litnik,2007,0,,263,11777
Litnik,2007,0,,264,11777
Litnik,2007,0,,265,11777
Litnik,2007,0,,266,11777
Litnik,2007,0,,267,11777
Litnik,2007,0,,268,11777
Litnik,2007,0,,269,11777
Litnik,2007,0,,270,11777
Litnik,2007,0,,271,11777
Litnik,2007,0,,272,11777
Litnik,2007,0,,273,11777
Litnik,2006,0,,174,0
Litnik,2006,0,,175,0
Litnik,2006,0,,176,0
Litnik,2006,0,,177,0
Litnik,2006,0,,178,0
Litnik,2006,0,,179,0
Litnik,2006,0,,180,0
Litnik,2006,0,,181,0
Litnik,2006,0,,182,0
Litnik,2006,0,,183,0
Litnik,2006,0,,184,0
Litnik,2006,0,,185,0
Litnik,2006,0,,186,0
Litnik,2006,0,,187,0
Litnik,2006,0,,188,0
Litnik,2006,0,,189,0
Litnik,2006,0,,190,0
Litnik,2006,0,,191,0
Litnik,2006,4,,192,4
Litnik,2006,0,,193,4
Litnik,2006,0,,194,4
Litnik,2006,0,,195,4
Litnik,2006,0,,196,4
Litnik,2006,0,,197,4
Litnik,2006,0,,198,4
Litnik,2006,2,,199,6
Litnik,2006,1,,200,7
Litnik,2006,26,,201,33
Litnik,2006,3,,202,36
Litnik,2006,82,,203,118
Litnik,2006,21,,204,139
Litnik,2006,598,,205,737
Litnik,2006,261,,206,998
Litnik,2006,120,,207,1118
Litnik,2006,331,,208,1449
Litnik,2006,98,,209,1547
Litnik,2006,205,,210,1752
Litnik,2006,1355,,211,3107
Litnik,2006,506,,212,3613
Litnik,2006,81,,213,3694
Litnik,2006,342,,214,4036
Litnik,2006,2981,,215,7017
Litnik,2006,2218,,216,9235
Litnik,2006,0,,217,9235
Litnik,2006,0,,218,9235
Litnik,2006,0,,219,9235
Litnik,2006,0,,220,9235
Litnik,2006,0,,221,9235
Litnik,2006,0,,222,9235
Litnik,2006,0,,223,9235
Litnik,2006,0,,224,9235
Litnik,2006,0,,225,9235
Litnik,2006,0,,226,9235
Litnik,2006,0,,227,9235
Litnik,2006,0,,228,9235
Litnik,2006,0,,229,9235
Litnik,2006,0,,230,9235
Litnik,2006,0,,231,9235
Litnik,2006,0,,232,9235
Litnik,2006,0,,233,9235
Litnik,2006,0,,234,9235
Litnik,2006,0,,235,9235
Litnik,2006,0,,236,9235
Litnik,2006,0,,237,9235
Litnik,2006,0,,238,9235
Litnik,2006,0,,239,9235
Litnik,2006,0,,240,9235
Litnik,2006,0,,241,9235
Litnik,2006,0,,242,9235
Litnik,2006,0,,243,9235
Litnik,2006,0,,244,9235
Litnik,2006,0,,245,9235
Litnik,2006,0,,246,9235
Litnik,2006,0,,247,9235
Litnik,2006,0,,248,9235
Litnik,2006,0,,249,9235
Litnik,2006,0,,250,9235
Litnik,2006,0,,251,9235
Litnik,2006,0,,252,9235
Litnik,2006,0,,253,9235
Litnik,2006,0,,254,9235
Litnik,2006,0,,255,9235
Litnik,2006,0,,256,9235
Litnik,2006,0,,257,9235
Litnik,2006,0,,258,9235
Litnik,2006,0,,259,9235
Litnik,2006,0,,260,9235
Litnik,2006,0,,261,9235
Litnik,2006,0,,262,9235
Litnik,2006,0,,263,9235
Litnik,2006,0,,264,9235
Litnik,2006,0,,265,9235
Litnik,2006,0,,266,9235
Litnik,2006,0,,267,9235
Litnik,2006,0,,268,9235
Litnik,2006,0,,269,9235
Litnik,2006,0,,270,9235
Litnik,2006,0,,271,9235
Litnik,2006,0,,272,9235
Litnik,2006,0,,273,9235
Litnik,2005,0,,174,0
Litnik,2005,0,,175,0
Litnik,2005,0,,176,0
Litnik,2005,0,,177,0
Litnik,2005,0,,178,0
Litnik,2005,0,,179,0
Litnik,2005,0,,180,0
Litnik,2005,0,,181,0
Litnik,2005,0,,182,0
Litnik,2005,0,,183,0
Litnik,2005,0,,184,0
Litnik,2005,0,,185,0
Litnik,2005,0,,186,0
Litnik,2005,0,,187,0
Litnik,2005,0,,188,0
Litnik,2005,0,,189,0
Litnik,2005,0,,190,0
Litnik,2005,0,,191,0
Litnik,2005,0,,192,0
Litnik,2005,0,,193,0
Litnik,2005,0,,194,0
Litnik,2005,0,,195,0
Litnik,2005,0,,196,0
Litnik,2005,0,,197,0
Litnik,2005,0,,198,0
Litnik,2005,0,,199,0
Litnik,2005,0,,200,0
Litnik,2005,0,,201,0
Litnik,2005,0,,202,0
Litnik,2005,0,,203,0
Litnik,2005,0,,204,0
Litnik,2005,0,,205,0
Litnik,2005,1,,206,1
Litnik,2005,4,,207,5
Litnik,2005,0,,208,5
Litnik,2005,2,,209,7
Litnik,2005,0,,210,7
Litnik,2005,0,,211,7
Litnik,2005,0,,212,7
Litnik,2005,0,,213,7
Litnik,2005,0,,214,7
Litnik,2005,0,,215,7
Litnik,2005,0,,216,7
Litnik,2005,0,,217,7
Litnik,2005,0,,218,7
Litnik,2005,0,,219,7
Litnik,2005,0,,220,7
Litnik,2005,0,,221,7
Litnik,2005,0,,222,7
Litnik,2005,0,,223,7
Litnik,2005,0,,224,7
Litnik,2005,0,,225,7
Litnik,2005,0,,226,7
Litnik,2005,2913,,227,2920
Litnik,2005,537,,228,3457
Litnik,2005,2149,,229,5606
Litnik,2005,5988,,230,11594
Litnik,2005,30000,,231,41594
Litnik,2005,0,,232,41594
Litnik,2005,0,,233,41594
Litnik,2005,0,,234,41594
Litnik,2005,0,,235,41594
Litnik,2005,0,,236,41594
Litnik,2005,0,,237,41594
Litnik,2005,0,,238,41594
Litnik,2005,0,,239,41594
Litnik,2005,0,,240,41594
Litnik,2005,0,,241,41594
Litnik,2005,0,,242,41594
Litnik,2005,0,,243,41594
Litnik,2005,0,,244,41594
Litnik,2005,0,,245,41594
Litnik,2005,0,,246,41594
Litnik,2005,0,,247,41594
Litnik,2005,0,,248,41594
Litnik,2005,0,,249,41594
Litnik,2005,0,,250,41594
Litnik,2005,0,,251,41594
Litnik,2005,0,,252,41594
Litnik,2005,0,,253,41594
Litnik,2005,0,,254,41594
Litnik,2005,0,,255,41594
Litnik,2005,0,,256,41594
Litnik,2005,0,,257,41594
Litnik,2005,0,,258,41594
Litnik,2005,0,,259,41594
Litnik,2005,0,,260,41594
Litnik,2005,0,,261,41594
Litnik,2005,0,,262,41594
Litnik,2005,0,,263,41594
Litnik,2005,0,,264,41594
Litnik,2005,0,,265,41594
Litnik,2005,0,,266,41594
Litnik,2005,0,,267,41594
Litnik,2005,0,,268,41594
Litnik,2005,0,,269,41594
Litnik,2005,0,,270,41594
Litnik,2005,0,,271,41594
Litnik,2005,0,,272,41594
Litnik,2005,0,,273,41594
Litnik,2004,0,,175,0
Litnik,2004,0,,176,0
Litnik,2004,0,,177,0
Litnik,2004,0,,178,0
Litnik,2004,0,,179,0
Litnik,2004,0,,180,0
Litnik,2004,0,,181,0
Litnik,2004,0,,182,0
Litnik,2004,0,,183,0
Litnik,2004,0,,184,0
Litnik,2004,0,,185,0
Litnik,2004,0,,186,0
Litnik,2004,1,,187,1
Litnik,2004,1,,188,2
Litnik,2004,0,,189,2
Litnik,2004,0,,190,2
Litnik,2004,1,,191,3
Litnik,2004,0,,192,3
Litnik,2004,0,,193,3
Litnik,2004,1,,194,4
Litnik,2004,0,,195,4
Litnik,2004,0,,196,4
Litnik,2004,0,,197,4
Litnik,2004,0,,198,4
Litnik,2004,0,,199,4
Litnik,2004,0,,200,4
Litnik,2004,0,,201,4
Litnik,2004,1,,202,5
Litnik,2004,0,,203,5
Litnik,2004,19,,204,24
Litnik,2004,25,,205,49
Litnik,2004,19,,206,68
Litnik,2004,920,,207,988
Litnik,2004,579,,208,1567
Litnik,2004,281,,209,1848
Litnik,2004,387,,210,2235
Litnik,2004,224,,211,2459
Litnik,2004,571,,212,3030
Litnik,2004,1004,,213,4034
Litnik,2004,604,,214,4638
Litnik,2004,695,,215,5333
Litnik,2004,910,,216,6243
Litnik,2004,768,,217,7011
Litnik,2004,552,,218,7563
Litnik,2004,2000,,219,9563
Litnik,2004,0,,220,9563
Litnik,2004,0,,221,9563
Litnik,2004,0,,222,9563
Litnik,2004,0,,223,9563
Litnik,2004,0,,224,9563
Litnik,2004,0,,225,9563
Litnik,2004,0,,226,9563
Litnik,2004,0,,227,9563
Litnik,2004,0,,228,9563
Litnik,2004,0,,229,9563
Litnik,2004,0,,230,9563
Litnik,2004,0,,231,9563
Litnik,2004,0,,232,9563
Litnik,2004,0,,233,9563
Litnik,2004,0,,234,9563
Litnik,2004,0,,235,9563
Litnik,2004,0,,236,9563
Litnik,2004,0,,237,9563
Litnik,2004,0,,238,9563
Litnik,2004,0,,239,9563
Litnik,2004,0,,240,9563
Litnik,2004,0,,241,9563
Litnik,2004,0,,242,9563
Litnik,2004,0,,243,9563
Litnik,2004,0,,244,9563
Litnik,2004,0,,245,9563
Litnik,2004,0,,246,9563
Litnik,2004,0,,247,9563
Litnik,2004,0,,248,9563
Litnik,2004,0,,249,9563
Litnik,2004,0,,250,9563
Litnik,2004,0,,251,9563
Litnik,2004,0,,252,9563
Litnik,2004,0,,253,9563
Litnik,2004,0,,254,9563
Litnik,2004,0,,255,9563
Litnik,2004,0,,256,9563
Litnik,2004,0,,257,9563
Litnik,2004,0,,258,9563
Litnik,2004,0,,259,9563
Litnik,2004,0,,260,9563
Litnik,2004,0,,261,9563
Litnik,2004,0,,262,9563
Litnik,2004,0,,263,9563
Litnik,2004,0,,264,9563
Litnik,2004,0,,265,9563
Litnik,2004,0,,266,9563
Litnik,2004,0,,267,9563
Litnik,2004,0,,268,9563
Litnik,2004,0,,269,9563
Litnik,2004,0,,270,9563
Litnik,2004,0,,271,9563
Litnik,2004,0,,272,9563
Litnik,2004,0,,273,9563
Litnik,2004,0,,274,9563
Litnik,2003,0,,174,0
Litnik,2003,0,,175,0
Litnik,2003,0,,176,0
Litnik,2003,0,,177,0
Litnik,2003,0,,178,0
Litnik,2003,0,,179,0
Litnik,2003,0,,180,0
Litnik,2003,0,,181,0
Litnik,2003,0,,182,0
Litnik,2003,0,,183,0
Litnik,2003,0,,184,0
Litnik,2003,0,,185,0
Litnik,2003,0,,186,0
Litnik,2003,0,,187,0
Litnik,2003,0,,188,0
Litnik,2003,0,,189,0
Litnik,2003,0,,190,0
Litnik,2003,0,,191,0
Litnik,2003,0,,192,0
Litnik,2003,0,,193,0
Litnik,2003,0,,194,0
Litnik,2003,0,,195,0
Litnik,2003,0,,196,0
Litnik,2003,0,,197,0
Litnik,2003,0,,198,0
Litnik,2003,0,,199,0
Litnik,2003,0,,200,0
Litnik,2003,0,,201,0
Litnik,2003,0,,202,0
Litnik,2003,0,,203,0
Litnik,2003,0,,204,0
Litnik,2003,0,,205,0
Litnik,2003,1,,206,1
Litnik,2003,2,,207,3
Litnik,2003,0,,208,3
Litnik,2003,0,,209,3
Litnik,2003,0,,210,3
Litnik,2003,8,,211,11
Litnik,2003,15,,212,26
Litnik,2003,9,,213,35
Litnik,2003,29,,214,64
Litnik,2003,21,,215,85
Litnik,2003,31,,216,116
Litnik,2003,13,,217,129
Litnik,2003,88,,218,217
Litnik,2003,70,,219,287
Litnik,2003,26,,220,313
Litnik,2003,23,,221,336
Litnik,2003,24,,222,360
Litnik,2003,169,,223,529
Litnik,2003,278,,224,807
Litnik,2003,137,,225,944
Litnik,2003,1857,,226,2801
Litnik,2003,1884,,227,4685
Litnik,2003,244,,228,4929
Litnik,2003,143,,229,5072
Litnik,2003,50,,230,5122
Litnik,2003,1790,,231,6912
Litnik,2003,6656,,232,13568
Litnik,2003,411,,233,13979
Litnik,2003,263,,234,14242
Litnik,2003,20088,,235,34330
Litnik,2003,0,,236,34330
Litnik,2003,0,,237,34330
Litnik,2003,0,,238,34330
Litnik,2003,0,,239,34330
Litnik,2003,0,,240,34330
Litnik,2003,0,,241,34330
Litnik,2003,0,,242,34330
Litnik,2003,0,,243,34330
Litnik,2003,0,,244,34330
Litnik,2003,0,,245,34330
Litnik,2003,0,,246,34330
Litnik,2003,0,,247,34330
Litnik,2003,0,,248,34330
Litnik,2003,0,,249,34330
Litnik,2003,0,,250,34330
Litnik,2003,0,,251,34330
Litnik,2003,0,,252,34330
Litnik,2003,0,,253,34330
Litnik,2003,0,,254,34330
Litnik,2003,0,,255,34330
Litnik,2003,0,,256,34330
Litnik,2003,0,,257,34330
Litnik,2003,0,,258,34330
Litnik,2003,0,,259,34330
Litnik,2003,0,,260,34330
Litnik,2003,0,,261,34330
Litnik,2003,0,,262,34330
Litnik,2003,0,,263,34330
Litnik,2003,0,,264,34330
Litnik,2003,0,,265,34330
Litnik,2003,0,,266,34330
Litnik,2003,0,,267,34330
Litnik,2003,0,,268,34330
Litnik,2003,0,,269,34330
Litnik,2003,0,,270,34330
Litnik,2003,0,,271,34330
Litnik,2003,0,,272,34330
Litnik,2003,0,,273,34330
Litnik,2002,0,,174,0
Litnik,2002,0,,175,0
Litnik,2002,0,,176,0
Litnik,2002,0,,177,0
Litnik,2002,0,,178,0
Litnik,2002,0,,179,0
Litnik,2002,0,,180,0
Litnik,2002,0,,181,0
Litnik,2002,0,,182,0
Litnik,2002,0,,183,0
Litnik,2002,0,,184,0
Litnik,2002,0,,185,0
Litnik,2002,0,,186,0
Litnik,2002,25,,187,25
Litnik,2002,4,,188,29
Litnik,2002,19,,189,48
Litnik,2002,5,,190,53
Litnik,2002,4,,191,57
Litnik,2002,10,,192,67
Litnik,2002,5,,193,72
Litnik,2002,5,,194,77
Litnik,2002,1,,195,78
Litnik,2002,16,,196,94
Litnik,2002,0,,197,94
Litnik,2002,0,,198,94
Litnik,2002,0,,199,94
Litnik,2002,0,,200,94
Litnik,2002,5,,201,99
Litnik,2002,2,,202,101
Litnik,2002,86,,203,187
Litnik,2002,280,,204,467
Litnik,2002,2,,205,469
Litnik,2002,3,,206,472
Litnik,2002,4,,207,476
Litnik,2002,11,,208,487
Litnik,2002,7,,209,494
Litnik,2002,22,,210,516
Litnik,2002,16,,211,532
Litnik,2002,33,,212,565
Litnik,2002,9,,213,574
Litnik,2002,17,,214,591
Litnik,2002,22,,215,613
Litnik,2002,2,,216,615
Litnik,2002,57,,217,672
Litnik,2002,86,,218,758
Litnik,2002,194,,219,952
Litnik,2002,2082,,220,3034
Litnik,2002,1901,,221,4935
Litnik,2002,8345,,222,13280
Litnik,2002,2388,,223,15668
Litnik,2002,1869,,224,17537
Litnik,2002,308,,225,17845
Litnik,2002,639,,226,18484
Litnik,2002,242,,227,18726
Litnik,2002,704,,228,19430
Litnik,2002,1001,,229,20431
Litnik,2002,411,,230,20842
Litnik,2002,495,,231,21337
Litnik,2002,11126,,232,32463
Litnik,2002,4557,,233,37020
Litnik,2002,22408,,234,59428
Litnik,2002,6534,,235,65962
Litnik,2002,1280,,236,67242
Litnik,2002,9000,,237,76242
Litnik,2002,0,,238,76242
Litnik,2002,0,,239,76242
Litnik,2002,0,,240,76242
Litnik,2002,0,,241,76242
Litnik,2002,0,,242,76242
Litnik,2002,0,,243,76242
Litnik,2002,0,,244,76242
Litnik,2002,0,,245,76242
Litnik,2002,0,,246,76242
Litnik,2002,0,,247,76242
Litnik,2002,0,,248,76242
Litnik,2002,0,,249,76242
Litnik,2002,0,,250,76242
Litnik,2002,0,,251,76242
Litnik,2002,0,,252,76242
Litnik,2002,0,,253,76242
Litnik,2002,0,,254,76242
Litnik,2002,0,,255,76242
Litnik,2002,0,,256,76242
Litnik,2002,0,,257,76242
Litnik,2002,0,,258,76242
Litnik,2002,0,,259,76242
Litnik,2002,0,,260,76242
Litnik,2002,0,,261,76242
Litnik,2002,0,,262,76242
Litnik,2002,0,,263,76242
Litnik,2002,0,,264,76242
Litnik,2002,0,,265,76242
Litnik,2002,0,,266,76242
Litnik,2002,0,,267,76242
Litnik,2002,0,,268,76242
Litnik,2002,0,,269,76242
Litnik,2002,0,,270,76242
Litnik,2002,0,,271,76242
Litnik,2002,0,,272,76242
Litnik,2002,0,,273,76242
Litnik,2001,0,,174,0
Litnik,2001,0,,175,0
Litnik,2001,0,,176,0
Litnik,2001,0,,177,0
Litnik,2001,0,,178,0
Litnik,2001,0,,179,0
Litnik,2001,0,,180,0
Litnik,2001,0,,181,0
Litnik,2001,0,,182,0
Litnik,2001,0,,183,0
Litnik,2001,0,,184,0
Litnik,2001,0,,185,0
Litnik,2001,0,,186,0
Litnik,2001,0,,187,0
Litnik,2001,0,,188,0
Litnik,2001,0,,189,0
Litnik,2001,0,,190,0
Litnik,2001,0,,191,0
Litnik,2001,0,,192,0
Litnik,2001,0,,193,0
Litnik,2001,0,,194,0
Litnik,2001,0,,195,0
Litnik,2001,0,,196,0
Litnik,2001,0,,197,0
Litnik,2001,1,,198,1
Litnik,2001,0,,199,1
Litnik,2001,0,,200,1
Litnik,2001,0,,201,1
Litnik,2001,1,,202,2
Litnik,2001,0,,203,2
Litnik,2001,0,,204,2
Litnik,2001,0,,205,2
Litnik,2001,0,,206,2
Litnik,2001,0,,207,2
Litnik,2001,0,,208,2
Litnik,2001,2,,209,4
Litnik,2001,2,,210,6
Litnik,2001,0,,211,6
Litnik,2001,12,,212,18
Litnik,2001,1,,213,19
Litnik,2001,0,,214,19
Litnik,2001,19,,215,38
Litnik,2001,162,,216,200
Litnik,2001,236,,217,436
Litnik,2001,96,,218,532
Litnik,2001,69,,219,601
Litnik,2001,48,,220,649
Litnik,2001,99,,221,748
Litnik,2001,148,,222,896
Litnik,2001,16,,223,912
Litnik,2001,51,,224,963
Litnik,2001,65,,225,1028
Litnik,2001,131,,226,1159
Litnik,2001,64,,227,1223
Litnik,2001,230,,228,1453
Litnik,2001,2826,,229,4279
Litnik,2001,717,,230,4996
Litnik,2001,671,,231,5667
Litnik,2001,4605,,232,10272
Litnik,2001,297,,233,10569
Litnik,2001,432,,234,11001
Litnik,2001,92,,235,11093
Litnik,2001,55,,236,11148
Litnik,2001,404,,237,11552
Litnik,2001,305,,238,11857
Litnik,2001,3505,,239,15362
Litnik,2001,6871,,240,22233
Litnik,2001,707,,241,22940
Litnik,2001,487,,242,23427
Litnik,2001,284,,243,23711
Litnik,2001,502,,244,24213
Litnik,2001,335,,245,24548
Litnik,2001,212,,246,24760
Litnik,2001,255,,247,25015
Litnik,2001,193,,248,25208
Litnik,2001,20,,249,25228
Litnik,2001,0,,250,25228
Litnik,2001,0,,251,25228
Litnik,2001,0,,252,25228
Litnik,2001,0,,253,25228
Litnik,2001,0,,254,25228
Litnik,2001,0,,255,25228
Litnik,2001,0,,256,25228
Litnik,2001,0,,257,25228
Litnik,2001,0,,258,25228
Litnik,2001,0,,259,25228
Litnik,2001,0,,260,25228
Litnik,2001,0,,261,25228
Litnik,2001,0,,262,25228
Litnik,2001,0,,263,25228
Litnik,2001,0,,264,25228
Litnik,2001,0,,265,25228
Litnik,2001,0,,266,25228
Litnik,2001,0,,267,25228
Litnik,2001,0,,268,25228
Litnik,2001,0,,269,25228
Litnik,2001,0,,270,25228
Litnik,2001,0,,271,25228
Litnik,2001,0,,272,25228
Litnik,2001,0,,273,25228
Litnik,2000,0,,175,0
Litnik,2000,0,,176,0
Litnik,2000,0,,177,0
Litnik,2000,0,,178,0
Litnik,2000,0,,179,0
Litnik,2000,0,,180,0
Litnik,2000,0,,181,0
Litnik,2000,0,,182,0
Litnik,2000,0,,183,0
Litnik,2000,0,,184,0
Litnik,2000,0,,185,0
Litnik,2000,0,,186,0
Litnik,2000,0,,187,0
Litnik,2000,0,,188,0
Litnik,2000,0,,189,0
Litnik,2000,0,,190,0
Litnik,2000,0,,191,0
Litnik,2000,0,,192,0
Litnik,2000,0,,193,0
Litnik,2000,0,,194,0
Litnik,2000,0,,195,0
Litnik,2000,0,,196,0
Litnik,2000,0,,197,0
Litnik,2000,0,,198,0
Litnik,2000,2,,199,2
Litnik,2000,0,,200,2
Litnik,2000,0,,201,2
Litnik,2000,0,,202,2
Litnik,2000,0,,203,2
Litnik,2000,0,,204,2
Litnik,2000,0,,205,2
Litnik,2000,1,,206,3
Litnik,2000,0,,207,3
Litnik,2000,0,,208,3
Litnik,2000,4,,209,7
Litnik,2000,4,,210,11
Litnik,2000,0,,211,11
Litnik,2000,3,,212,14
Litnik,2000,108,,213,122
Litnik,2000,1525,,214,1647
Litnik,2000,1160,,215,2807
Litnik,2000,34,,216,2841
Litnik,2000,43,,217,2884
Litnik,2000,271,,218,3155
Litnik,2000,41,,219,3196
Litnik,2000,22,,220,3218
Litnik,2000,62,,221,3280
Litnik,2000,69,,222,3349
Litnik,2000,120,,223,3469
Litnik,2000,93,,224,3562
Litnik,2000,104,,225,3666
Litnik,2000,182,,226,3848
Litnik,2000,246,,227,4094
Litnik,2000,495,,228,4589
Litnik,2000,340,,229,4929
Litnik,2000,830,,230,5759
Litnik,2000,610,,231,6369
Litnik,2000,1002,,232,7371
Litnik,2000,1050,,233,8421
Litnik,2000,700,,234,9121
Litnik,2000,528,,235,9649
Litnik,2000,1470,,236,11119
Litnik,2000,6578,,237,17697
Litnik,2000,4620,,238,22317
Litnik,2000,5780,,239,28097
Litnik,2000,4788,,240,32885
Litnik,2000,1210,,241,34095
Litnik,2000,2337,,242,36432
Litnik,2000,1495,,243,37927
Litnik,2000,1303,,244,39230
Litnik,2000,2437,,245,41667
Litnik,2000,1517,,246,43184
Litnik,2000,1913,,247,45097
Litnik,2000,2131,,248,47228
Litnik,2000,2870,,249,50098
Litnik,2000,3811,,250,53909
Litnik,2000,1763,,251,55672
Litnik,2000,2117,,252,57789
Litnik,2000,1411,,253,59200
Litnik,2000,6847,,254,66047
Litnik,2000,956,,255,67003
Litnik,2000,0,,256,67003
Litnik,2000,0,,257,67003
Litnik,2000,0,,258,67003
Litnik,2000,0,,259,67003
Litnik,2000,0,,260,67003
Litnik,2000,0,,261,67003
Litnik,2000,0,,262,67003
Litnik,2000,0,,263,67003
Litnik,2000,0,,264,67003
Litnik,2000,0,,265,67003
Litnik,2000,0,,266,67003
Litnik,2000,0,,267,67003
Litnik,2000,0,,268,67003
Litnik,2000,0,,269,67003
Litnik,2000,0,,270,67003
Litnik,2000,0,,271,67003
Litnik,2000,0,,272,67003
Litnik,2000,0,,273,67003
Litnik,2000,0,,274,67003
Litnik,1999,0,,174,0
Litnik,1999,0,,175,0
Litnik,1999,0,,176,0
Litnik,1999,0,,177,0
Litnik,1999,0,,178,0
Litnik,1999,0,,179,0
Litnik,1999,0,,180,0
Litnik,1999,0,,181,0
Litnik,1999,0,,182,0
Litnik,1999,0,,183,0
Litnik,1999,0,,184,0
Litnik,1999,0,,185,0
Litnik,1999,0,,186,0
Litnik,1999,0,,187,0
Litnik,1999,0,,188,0
Litnik,1999,0,,189,0
Litnik,1999,0,,190,0
Litnik,1999,0,,191,0
Litnik,1999,0,,192,0
Litnik,1999,0,,193,0
Litnik,1999,0,,194,0
Litnik,1999,1,,195,1
Litnik,1999,0,,196,1
Litnik,1999,0,,197,1
Litnik,1999,0,,198,1
Litnik,1999,1,,199,2
Litnik,1999,0,,200,2
Litnik,1999,0,,201,2
Litnik,1999,0,,202,2
Litnik,1999,0,,203,2
Litnik,1999,0,,204,2
Litnik,1999,0,,205,2
Litnik,1999,0,,206,2
Litnik,1999,0,,207,2
Litnik,1999,0,,208,2
Litnik,1999,0,,209,2
Litnik,1999,0,,210,2
Litnik,1999,0,,211,2
Litnik,1999,0,,212,2
Litnik,1999,1,,213,3
Litnik,1999,1,,214,4
Litnik,1999,10,,215,14
Litnik,1999,68,,216,82
Litnik,1999,25,,217,107
Litnik,1999,14,,218,121
Litnik,1999,3,,219,124
Litnik,1999,0,,220,124
Litnik,1999,21,,221,145
Litnik,1999,16,,222,161
Litnik,1999,28,,223,189
Litnik,1999,74,,224,263
Litnik,1999,76,,225,339
Litnik,1999,48,,226,387
Litnik,1999,42,,227,429
Litnik,1999,25,,228,454
Litnik,1999,31,,229,485
Litnik,1999,39,,230,524
Litnik,1999,97,,231,621
Litnik,1999,1169,,232,1790
Litnik,1999,3073,,233,4863
Litnik,1999,3847,,234,8710
Litnik,1999,1455,,235,10165
Litnik,1999,254,,236,10419
Litnik,1999,128,,237,10547
Litnik,1999,127,,238,10674
Litnik,1999,267,,239,10941
Litnik,1999,59,,240,11000
Litnik,1999,173,,241,11173
Litnik,1999,272,,242,11445
Litnik,1999,107,,243,11552
Litnik,1999,536,,244,12088
Litnik,1999,600,,245,12688
Litnik,1999,1017,,246,13705
Litnik,1999,587,,247,14292
Litnik,1999,1239,,248,15531
Litnik,1999,1056,,249,16587
Litnik,1999,444,,250,17031
Litnik,1999,338,,251,17369
Litnik,1999,1079,,252,18448
Litnik,1999,6756,,253,25204
Litnik,1999,755,,254,25959
Litnik,1999,5000,,255,30959
Litnik,1999,0,,256,30959
Litnik,1999,0,,257,30959
Litnik,1999,0,,258,30959
Litnik,1999,0,,259,30959
Litnik,1999,0,,260,30959
Litnik,1999,0,,261,30959
Litnik,1999,0,,262,30959
Litnik,1999,0,,263,30959
Litnik,1999,0,,264,30959
Litnik,1999,0,,265,30959
Litnik,1999,0,,266,30959
Litnik,1999,0,,267,30959
Litnik,1999,0,,268,30959
Litnik,1999,0,,269,30959
Litnik,1999,0,,270,30959
Litnik,1999,0,,271,30959
Litnik,1999,0,,272,30959
Litnik,1999,0,,273,30959
Litnik,1998,0,,174,0
Litnik,1998,0,,175,0
Litnik,1998,0,,176,0
Litnik,1998,0,,177,0
Litnik,1998,0,,178,0
Litnik,1998,0,,179,0
Litnik,1998,0,,180,0
Litnik,1998,0,,181,0
Litnik,1998,0,,182,0
Litnik,1998,0,,183,0
Litnik,1998,0,,184,0
Litnik,1998,0,,185,0
Litnik,1998,0,,186,0
Litnik,1998,0,,187,0
Litnik,1998,0,,188,0
Litnik,1998,0,,189,0
Litnik,1998,0,,190,0
Litnik,1998,0,,191,0
Litnik,1998,0,,192,0
Litnik,1998,0,,193,0
Litnik,1998,0,,194,0
Litnik,1998,0,,195,0
Litnik,1998,0,,196,0
Litnik,1998,1,,197,1
Litnik,1998,2,,198,3
Litnik,1998,0,,199,3
Litnik,1998,0,,200,3
Litnik,1998,467,,201,470
Litnik,1998,5235,,202,5705
Litnik,1998,1614,,203,7319
Litnik,1998,1112,,204,8431
Litnik,1998,1848,,205,10279
Litnik,1998,1570,,206,11849
Litnik,1998,626,,207,12475
Litnik,1998,735,,208,13210
Litnik,1998,1823,,209,15033
Litnik,1998,331,,210,15364
Litnik,1998,394,,211,15758
Litnik,1998,185,,212,15943
Litnik,1998,113,,213,16056
Litnik,1998,202,,214,16258
Litnik,1998,923,,215,17181
Litnik,1998,265,,216,17446
Litnik,1998,3363,,217,20809
Litnik,1998,2227,,218,23036
Litnik,1998,1944,,219,24980
Litnik,1998,2645,,220,27625
Litnik,1998,736,,221,28361
Litnik,1998,286,,222,28647
Litnik,1998,537,,223,29184
Litnik,1998,402,,224,29586
Litnik,1998,690,,225,30276
Litnik,1998,1298,,226,31574
Litnik,1998,2283,,227,33857
Litnik,1998,3186,,228,37043
Litnik,1998,1844,,229,38887
Litnik,1998,2494,,230,41381
Litnik,1998,1754,,231,43135
Litnik,1998,1644,,232,44779
Litnik,1998,3494,,233,48273
Litnik,1998,1842,,234,50115
Litnik,1998,3242,,235,53357
Litnik,1998,3732,,236,57089
Litnik,1998,1286,,237,58375
Litnik,1998,1609,,238,59984
Litnik,1998,1171,,239,61155
Litnik,1998,1842,,240,62997
Litnik,1998,1549,,241,64546
Litnik,1998,4295,,242,68841
Litnik,1998,22916,,243,91757
Litnik,1998,2583,,244,94340
Litnik,1998,2231,,245,96571
Litnik,1998,1105,,246,97676
Litnik,1998,269,,247,97945
Litnik,1998,295,,248,98240
Litnik,1998,380,,249,98620
Litnik,1998,405,,250,99025
Litnik,1998,152,,251,99177
Litnik,1998,2000,,252,101177
Litnik,1998,0,,253,101177
Litnik,1998,0,,254,101177
Litnik,1998,0,,255,101177
Litnik,1998,0,,256,101177
Litnik,1998,0,,257,101177
Litnik,1998,0,,258,101177
Litnik,1998,0,,259,101177
Litnik,1998,0,,260,101177
Litnik,1998,0,,261,101177
Litnik,1998,0,,262,101177
Litnik,1998,0,,263,101177
Litnik,1998,0,,264,101177
Litnik,1998,0,,265,101177
Litnik,1998,0,,266,101177
Litnik,1998,0,,267,101177
Litnik,1998,0,,268,101177
Litnik,1998,0,,269,101177
Litnik,1998,0,,270,101177
Litnik,1998,0,,271,101177
Litnik,1998,0,,272,101177
Litnik,1998,0,,273,101177
Litnik,1997,0,,174,0
Litnik,1997,0,,175,0
Litnik,1997,0,,176,0
Litnik,1997,0,,177,0
Litnik,1997,0,,178,0
Litnik,1997,0,,179,0
Litnik,1997,0,,180,0
Litnik,1997,0,,181,0
Litnik,1997,0,,182,0
Litnik,1997,0,,183,0
Litnik,1997,0,,184,0
Litnik,1997,0,,185,0
Litnik,1997,0,,186,0
Litnik,1997,0,,187,0
Litnik,1997,0,,188,0
Litnik,1997,0,,189,0
Litnik,1997,0,,190,0
Litnik,1997,0,,191,0
Litnik,1997,0,,192,0
Litnik,1997,0,,193,0
Litnik,1997,0,,194,0
Litnik,1997,0,,195,0
Litnik,1997,0,,196,0
Litnik,1997,0,,197,0
Litnik,1997,0,,198,0
Litnik,1997,0,,199,0
Litnik,1997,0,,200,0
Litnik,1997,0,,201,0
Litnik,1997,0,,202,0
Litnik,1997,0,,203,0
Litnik,1997,0,,204,0
Litnik,1997,0,,205,0
Litnik,1997,0,,206,0
Litnik,1997,0,,207,0
Litnik,1997,0,,208,0
Litnik,1997,0,,209,0
Litnik,1997,0,,210,0
Litnik,1997,0,,211,0
Litnik,1997,0,,212,0
Litnik,1997,0,,213,0
Litnik,1997,0,,214,0
Litnik,1997,1,,215,1
Litnik,1997,0,,216,1
Litnik,1997,0,,217,1
Litnik,1997,2,,218,3
Litnik,1997,5,,219,8
Litnik,1997,31,,220,39
Litnik,1997,9,,221,48
Litnik,1997,3,,222,51
Litnik,1997,26,,223,77
Litnik,1997,13,,224,90
Litnik,1997,32,,225,122
Litnik,1997,283,,226,405
Litnik,1997,114,,227,519
Litnik,1997,55,,228,574
Litnik,1997,78,,229,652
Litnik,1997,32,,230,684
Litnik,1997,50,,231,734
Litnik,1997,313,,232,1047
Litnik,1997,512,,233,1559
Litnik,1997,682,,234,2241
Litnik,1997,410,,235,2651
Litnik,1997,284,,236,2935
Litnik,1997,193,,237,3128
Litnik,1997,216,,238,3344
Litnik,1997,206,,239,3550
Litnik,1997,477,,240,4027
Litnik,1997,570,,241,4597
Litnik,1997,606,,242,5203
Litnik,1997,1127,,243,6330
Litnik,1997,1003,,244,7333
Litnik,1997,666,,245,7999
Litnik,1997,1427,,246,9426
Litnik,1997,1359,,247,10785
Litnik,1997,1831,,248,12616
Litnik,1997,918,,249,13534
Litnik,1997,3174,,250,16708
Litnik,1997,689,,251,17397
Litnik,1997,325,,252,17722
Litnik,1997,200,,253,17922
Litnik,1997,100,,254,18022
Litnik,1997,100,,255,18122
Litnik,1997,1000,,256,19122
Litnik,1997,0,,257,19122
Litnik,1997,0,,258,19122
Litnik,1997,0,,259,19122
Litnik,1997,0,,260,19122
Litnik,1997,0,,261,19122
Litnik,1997,0,,262,19122
Litnik,1997,0,,263,19122
Litnik,1997,0,,264,19122
Litnik,1997,0,,265,19122
Litnik,1997,0,,266,19122
Litnik,1997,0,,267,19122
Litnik,1997,0,,268,19122
Litnik,1997,0,,269,19122
Litnik,1997,0,,270,19122
Litnik,1997,0,,271,19122
Litnik,1997,0,,272,19122
Litnik,1997,0,,273,19122
Litnik,1996,0,,175,0
Litnik,1996,0,,176,0
Litnik,1996,0,,177,0
Litnik,1996,0,,178,0
Litnik,1996,0,,179,0
Litnik,1996,0,,180,0
Litnik,1996,0,,181,0
Litnik,1996,0,,182,0
Litnik,1996,0,,183,0
Litnik,1996,0,,184,0
Litnik,1996,1,,185,1
Litnik,1996,0,,186,1
Litnik,1996,0,,187,1
Litnik,1996,0,,188,1
Litnik,1996,1,,189,2
Litnik,1996,0,,190,2
Litnik,1996,0,,191,2
Litnik,1996,0,,192,2
Litnik,1996,0,,193,2
Litnik,1996,0,,194,2
Litnik,1996,0,,195,2
Litnik,1996,0,,196,2
Litnik,1996,0,,197,2
Litnik,1996,0,,198,2
Litnik,1996,0,,199,2
Litnik,1996,0,,200,2
Litnik,1996,0,,201,2
Litnik,1996,0,,202,2
Litnik,1996,0,,203,2
Litnik,1996,0,,204,2
Litnik,1996,2,,205,4
Litnik,1996,139,,206,143
Litnik,1996,21,,207,164
Litnik,1996,2,,208,166
Litnik,1996,0,,209,166
Litnik,1996,0,,210,166
Litnik,1996,0,,211,166
Litnik,1996,0,,212,166
Litnik,1996,1,,213,167
Litnik,1996,1,,214,168
Litnik,1996,1,,215,169
Litnik,1996,11,,216,180
Litnik,1996,11,,217,191
Litnik,1996,57,,218,248
Litnik,1996,114,,219,362
Litnik,1996,97,,220,459
Litnik,1996,62,,221,521
Litnik,1996,315,,222,836
Litnik,1996,228,,223,1064
Litnik,1996,456,,224,1520
Litnik,1996,2070,,225,3590
Litnik,1996,487,,226,4077
Litnik,1996,289,,227,4366
Litnik,1996,330,,228,4696
Litnik,1996,278,,229,4974
Litnik,1996,238,,230,5212
Litnik,1996,81,,231,5293
Litnik,1996,334,,232,5627
Litnik,1996,294,,233,5921
Litnik,1996,622,,234,6543
Litnik,1996,311,,235,6854
Litnik,1996,470,,236,7324
Litnik,1996,887,,237,8211
Litnik,1996,198,,238,8409
Litnik,1996,323,,239,8732
Litnik,1996,107,,240,8839
Litnik,1996,189,,241,9028
Litnik,1996,60,,242,9088
Litnik,1996,152,,243,9240
Litnik,1996,58,,244,9298
Litnik,1996,20,,245,9318
Litnik,1996,142,,246,9460
Litnik,1996,22,,247,9482
Litnik,1996,14,,248,9496
Litnik,1996,29,,249,9525
Litnik,1996,1312,,250,10837
Litnik,1996,379,,251,11216
Litnik,1996,67,,252,11283
Litnik,1996,19,,253,11302
Litnik,1996,5,,254,11307
Litnik,1996,0,,255,11307
Litnik,1996,0,,256,11307
Litnik,1996,0,,257,11307
Litnik,1996,0,,258,11307
Litnik,1996,0,,259,11307
Litnik,1996,0,,260,11307
Litnik,1996,0,,261,11307
Litnik,1996,0,,262,11307
Litnik,1996,0,,263,11307
Litnik,1996,0,,264,11307
Litnik,1996,0,,265,11307
Litnik,1996,0,,266,11307
Litnik,1996,0,,267,11307
Litnik,1996,0,,268,11307
Litnik,1996,0,,269,11307
Litnik,1996,0,,270,11307
Litnik,1996,0,,271,11307
Litnik,1996,0,,272,11307
Litnik,1996,0,,273,11307
Litnik,1996,0,,274,11307
Litnik,1995,0,,174,0
Litnik,1995,0,,175,0
Litnik,1995,0,,176,0
Litnik,1995,0,,177,0
Litnik,1995,0,,178,0
Litnik,1995,0,,179,0
Litnik,1995,0,,180,0
Litnik,1995,0,,181,0
Litnik,1995,0,,182,0
Litnik,1995,0,,183,0
Litnik,1995,0,,184,0
Litnik,1995,0,,185,0
Litnik,1995,0,,186,0
Litnik,1995,0,,187,0
Litnik,1995,0,,188,0
Litnik,1995,0,,189,0
Litnik,1995,0,,190,0
Litnik,1995,0,,191,0
Litnik,1995,0,,192,0
Litnik,1995,0,,193,0
Litnik,1995,1,,194,1
Litnik,1995,1,,195,2
Litnik,1995,9,,196,11
Litnik,1995,12,,197,23
Litnik,1995,22,,198,45
Litnik,1995,5,,199,50
Litnik,1995,3,,200,53
Litnik,1995,11,,201,64
Litnik,1995,0,,202,64
Litnik,1995,2,,203,66
Litnik,1995,1,,204,67
Litnik,1995,0,,205,67
Litnik,1995,2,,206,69
Litnik,1995,0,,207,69
Litnik,1995,2,,208,71
Litnik,1995,5,,209,76
Litnik,1995,171,,210,247
Litnik,1995,110,,211,357
Litnik,1995,111,,212,468
Litnik,1995,290,,213,758
Litnik,1995,414,,214,1172
Litnik,1995,606,,215,1778
Litnik,1995,266,,216,2044
Litnik,1995,99,,217,2143
Litnik,1995,185,,218,2328
Litnik,1995,284,,219,2612
Litnik,1995,151,,220,2763
Litnik,1995,212,,221,2975
Litnik,1995,130,,222,3105
Litnik,1995,150,,223,3255
Litnik,1995,3583,,224,6838
Litnik,1995,473,,225,7311
Litnik,1995,75,,226,7386
Litnik,1995,62,,227,7448
Litnik,1995,107,,228,7555
Litnik,1995,37,,229,7592
Litnik,1995,9,,230,7601
Litnik,1995,29,,231,7630
Litnik,1995,26,,232,7656
Litnik,1995,58,,233,7714
Litnik,1995,62,,234,7776
Litnik,1995,43,,235,7819
Litnik,1995,297,,236,8116
Litnik,1995,198,,237,8314
Litnik,1995,551,,238,8865
Litnik,1995,706,,239,9571
Litnik,1995,1102,,240,10673
Litnik,1995,962,,241,11635
Litnik,1995,892,,242,12527
Litnik,1995,2233,,243,14760
Litnik,1995,1379,,244,16139
Litnik,1995,400,,245,16539
Litnik,1995,636,,246,17175
Litnik,1995,798,,247,17973
Litnik,1995,8796,,248,26769
Litnik,1995,1960,,249,28729
Litnik,1995,1560,,250,30289
Litnik,1995,2000,,251,32289
Litnik,1995,248,,252,32537
Litnik,1995,88,,253,32625
Litnik,1995,113,,254,32738
Litnik,1995,10000,,255,42738
Litnik,1995,0,,256,42738
Litnik,1995,0,,257,42738
Litnik,1995,0,,258,42738
Litnik,1995,0,,259,42738
Litnik,1995,0,,260,42738
Litnik,1995,0,,261,42738
Litnik,1995,0,,262,42738
Litnik,1995,0,,263,42738
Litnik,1995,0,,264,42738
Litnik,1995,0,,265,42738
Litnik,1995,0,,266,42738
Litnik,1995,0,,267,42738
Litnik,1995,0,,268,42738
Litnik,1995,0,,269,42738
Litnik,1995,0,,270,42738
Litnik,1995,0,,271,42738
Litnik,1995,0,,272,42738
Litnik,1995,0,,273,42738
Litnik,1994,1,,174,1
Litnik,1994,0,,175,1
Litnik,1994,0,,176,1
Litnik,1994,0,,177,1
Litnik,1994,1,,178,2
Litnik,1994,0,,179,2
Litnik,1994,0,,180,2
Litnik,1994,0,,181,2
Litnik,1994,0,,182,2
Litnik,1994,0,,183,2
Litnik,1994,0,,184,2
Litnik,1994,0,,185,2
Litnik,1994,0,,186,2
Litnik,1994,0,,187,2
Litnik,1994,0,,188,2
Litnik,1994,0,,189,2
Litnik,1994,0,,190,2
Litnik,1994,3,,191,5
Litnik,1994,0,,192,5
Litnik,1994,2,,193,7
Litnik,1994,4,,194,11
Litnik,1994,0,,195,11
Litnik,1994,0,,196,11
Litnik,1994,0,,197,11
Litnik,1994,32,,198,43
Litnik,1994,6,,199,49
Litnik,1994,11,,200,60
Litnik,1994,21,,201,81
Litnik,1994,150,,202,231
Litnik,1994,203,,203,434
Litnik,1994,16,,204,450
Litnik,1994,128,,205,578
Litnik,1994,682,,206,1260
Litnik,1994,248,,207,1508
Litnik,1994,309,,208,1817
Litnik,1994,41,,209,1858
Litnik,1994,53,,210,1911
Litnik,1994,16,,211,1927
Litnik,1994,20,,212,1947
Litnik,1994,20,,213,1967
Litnik,1994,51,,214,2018
Litnik,1994,1610,,215,3628
Litnik,1994,4757,,216,8385
Litnik,1994,2221,,217,10606
Litnik,1994,2171,,218,12777
Litnik,1994,3363,,219,16140
Litnik,1994,524,,220,16664
Litnik,1994,391,,221,17055
Litnik,1994,104,,222,17159
Litnik,1994,43,,223,17202
Litnik,1994,17,,224,17219
Litnik,1994,14,,225,17233
Litnik,1994,22,,226,17255
Litnik,1994,3,,227,17258
Litnik,1994,11,,228,17269
Litnik,1994,6,,229,17275
Litnik,1994,84,,230,17359
Litnik,1994,23,,231,17382
Litnik,1994,0,,232,17382
Litnik,1994,1269,,233,18651
Litnik,1994,949,,234,19600
Litnik,1994,1327,,235,20927
Litnik,1994,273,,236,21200
Litnik,1994,627,,237,21827
Litnik,1994,479,,238,22306
Litnik,1994,641,,239,22947
Litnik,1994,333,,240,23280
Litnik,1994,1007,,241,24287
Litnik,1994,1550,,242,25837
Litnik,1994,1162,,243,26999
Litnik,1994,796,,244,27795
Litnik,1994,1524,,245,29319
Litnik,1994,1285,,246,30604
Litnik,1994,1923,,247,32527
Litnik,1994,1610,,248,34137
Litnik,1994,1618,,249,35755
Litnik,1994,2277,,250,38032
Litnik,1994,472,,251,38504
Litnik,1994,357,,252,38861
Litnik,1994,7602,,253,46463
Litnik,1994,783,,254,47246
Litnik,1994,308,,255,47554
Litnik,1994,329,,256,47883
Litnik,1994,608,,257,48491
Litnik,1994,107,,258,48598
Litnik,1994,99,,259,48697
Litnik,1994,59,,260,48756
Litnik,1994,1000,,261,49756
Litnik,1994,0,,262,49756
Litnik,1994,0,,263,49756
Litnik,1994,0,,264,49756
Litnik,1994,0,,265,49756
Litnik,1994,0,,266,49756
Litnik,1994,0,,267,49756
Litnik,1994,0,,268,49756
Litnik,1994,0,,269,49756
Litnik,1994,0,,270,49756
Litnik,1994,0,,271,49756
Litnik,1994,0,,272,49756
Litnik,1994,0,,273,49756
Litnik,1993,0,,174,0
Litnik,1993,0,,175,0
Litnik,1993,0,,176,0
Litnik,1993,0,,177,0
Litnik,1993,0,,178,0
Litnik,1993,0,,179,0
Litnik,1993,0,,180,0
Litnik,1993,0,,181,0
Litnik,1993,0,,182,0
Litnik,1993,0,,183,0
Litnik,1993,0,,184,0
Litnik,1993,0,,185,0
Litnik,1993,0,,186,0
Litnik,1993,0,,187,0
Litnik,1993,0,,188,0
Litnik,1993,0,,189,0
Litnik,1993,0,,190,0
Litnik,1993,0,,191,0
Litnik,1993,0,,192,0
Litnik,1993,0,,193,0
Litnik,1993,0,,194,0
Litnik,1993,0,,195,0
Litnik,1993,0,,196,0
Litnik,1993,0,,197,0
Litnik,1993,0,,198,0
Litnik,1993,0,,199,0
Litnik,1993,0,,200,0
Litnik,1993,0,,201,0
Litnik,1993,0,,202,0
Litnik,1993,0,,203,0
Litnik,1993,0,,204,0
Litnik,1993,2,,205,2
Litnik,1993,1,,206,3
Litnik,1993,2,,207,5
Litnik,1993,2,,208,7
Litnik,1993,0,,209,7
Litnik,1993,6,,210,13
Litnik,1993,8,,211,21
Litnik,1993,6,,212,27
Litnik,1993,7,,213,34
Litnik,1993,1,,214,35
Litnik,1993,2,,215,37
Litnik,1993,2,,216,39
Litnik,1993,4,,217,43
Litnik,1993,2,,218,45
Litnik,1993,18,,219,63
Litnik,1993,17,,220,80
Litnik,1993,1,,221,81
Litnik,1993,33,,222,114
Litnik,1993,131,,223,245
Litnik,1993,40,,224,285
Litnik,1993,60,,225,345
Litnik,1993,1502,,226,1847
Litnik,1993,427,,227,2274
Litnik,1993,139,,228,2413
Litnik,1993,220,,229,2633
Litnik,1993,1737,,230,4370
Litnik,1993,1686,,231,6056
Litnik,1993,593,,232,6649
Litnik,1993,389,,233,7038
Litnik,1993,640,,234,7678
Litnik,1993,283,,235,7961
Litnik,1993,99,,236,8060
Litnik,1993,6133,,237,14193
Litnik,1993,1776,,238,15969
Litnik,1993,587,,239,16556
Litnik,1993,594,,240,17150
Litnik,1993,875,,241,18025
Litnik,1993,221,,242,18246
Litnik,1993,296,,243,18542
Litnik,1993,106,,244,18648
Litnik,1993,215,,245,18863
Litnik,1993,82,,246,18945
Litnik,1993,151,,247,19096
Litnik,1993,354,,248,19450
Litnik,1993,140,,249,19590
Litnik,1993,79,,250,19669
Litnik,1993,67,,251,19736
Litnik,1993,41,,252,19777
Litnik,1993,33,,253,19810
Litnik,1993,20,,254,19830
Litnik,1993,2000,,255,21830
Litnik,1993,0,,256,21830
Litnik,1993,0,,257,21830
Litnik,1993,0,,258,21830
Litnik,1993,0,,259,21830
Litnik,1993,0,,260,21830
Litnik,1993,0,,261,21830
Litnik,1993,0,,262,21830
Litnik,1993,0,,263,21830
Litnik,1993,0,,264,21830
Litnik,1993,0,,265,21830
Litnik,1993,0,,266,21830
Litnik,1993,0,,267,21830
Litnik,1993,0,,268,21830
Litnik,1993,0,,269,21830
Litnik,1993,0,,270,21830
Litnik,1993,0,,271,21830
Litnik,1993,0,,272,21830
Litnik,1993,0,,273,21830
Litnik,1992,0,,175,0
Litnik,1992,0,,176,0
Litnik,1992,0,,177,0
Litnik,1992,0,,178,0
Litnik,1992,0,,179,0
Litnik,1992,0,,180,0
Litnik,1992,0,,181,0
Litnik,1992,0,,182,0
Litnik,1992,0,,183,0
Litnik,1992,0,,184,0
Litnik,1992,0,,185,0
Litnik,1992,0,,186,0
Litnik,1992,0,,187,0
Litnik,1992,0,,188,0
Litnik,1992,0,,189,0
Litnik,1992,0,,190,0
Litnik,1992,0,,191,0
Litnik,1992,2,,192,2
Litnik,1992,0,,193,2
Litnik,1992,0,,194,2
Litnik,1992,0,,195,2
Litnik,1992,2,,196,4
Litnik,1992,0,,197,4
Litnik,1992,2,,198,6
Litnik,1992,3,,199,9
Litnik,1992,1,,200,10
Litnik,1992,0,,201,10
Litnik,1992,0,,202,10
Litnik,1992,0,,203,10
Litnik,1992,23,,204,33
Litnik,1992,5,,205,38
Litnik,1992,4,,206,42
Litnik,1992,1,,207,43
Litnik,1992,18,,208,61
Litnik,1992,2,,209,63
Litnik,1992,750,,210,813
Litnik,1992,94,,211,907
Litnik,1992,24,,212,931
Litnik,1992,12,,213,943
Litnik,1992,95,,214,1038
Litnik,1992,62,,215,1100
Litnik,1992,4734,,216,5834
Litnik,1992,1271,,217,7105
Litnik,1992,305,,218,7410
Litnik,1992,113,,219,7523
Litnik,1992,143,,220,7666
Litnik,1992,58,,221,7724
Litnik,1992,132,,222,7856
Litnik,1992,42,,223,7898
Litnik,1992,136,,224,8034
Litnik,1992,385,,225,8419
Litnik,1992,547,,226,8966
Litnik,1992,959,,227,9925
Litnik,1992,5261,,228,15186
Litnik,1992,4283,,229,19469
Litnik,1992,218,,230,19687
Litnik,1992,150,,231,19837
Litnik,1992,188,,232,20025
Litnik,1992,342,,233,20367
Litnik,1992,196,,234,20563
Litnik,1992,32,,235,20595
Litnik,1992,887,,236,21482
Litnik,1992,461,,237,21943
Litnik,1992,18,,238,21961
Litnik,1992,117,,239,22078
Litnik,1992,214,,240,22292
Litnik,1992,264,,241,22556
Litnik,1992,545,,242,23101
Litnik,1992,545,,243,23646
Litnik,1992,143,,244,23789
Litnik,1992,237,,245,24026
Litnik,1992,641,,246,24667
Litnik,1992,209,,247,24876
Litnik,1992,514,,248,25390
Litnik,1992,315,,249,25705
Litnik,1992,300,,250,26005
Litnik,1992,428,,251,26433
Litnik,1992,580,,252,27013
Litnik,1992,158,,253,27171
Litnik,1992,114,,254,27285
Litnik,1992,262,,255,27547
Litnik,1992,244,,256,27791
Litnik,1992,67,,257,27858
Litnik,1992,87,,258,27945
Litnik,1992,1000,,259,28945
Litnik,1992,0,,260,28945
Litnik,1992,0,,261,28945
Litnik,1992,0,,262,28945
Litnik,1992,0,,263,28945
Litnik,1992,0,,264,28945
Litnik,1992,0,,265,28945
Litnik,1992,0,,266,28945
Litnik,1992,0,,267,28945
Litnik,1992,0,,268,28945
Litnik,1992,0,,269,28945
Litnik,1992,0,,270,28945
Litnik,1992,0,,271,28945
Litnik,1992,0,,272,28945
Litnik,1992,0,,273,28945
Litnik,1992,0,,274,28945
Litnik,1991,0,,174,0
Litnik,1991,0,,175,0
Litnik,1991,0,,176,0
Litnik,1991,0,,177,0
Litnik,1991,0,,178,0
Litnik,1991,0,,179,0
Litnik,1991,0,,180,0
Litnik,1991,0,,181,0
Litnik,1991,0,,182,0
Litnik,1991,0,,183,0
Litnik,1991,1,,184,1
Litnik,1991,0,,185,1
Litnik,1991,0,,186,1
Litnik,1991,1,,187,2
Litnik,1991,0,,188,2
Litnik,1991,0,,189,2
Litnik,1991,0,,190,2
Litnik,1991,0,,191,2
Litnik,1991,0,,192,2
Litnik,1991,0,,193,2
Litnik,1991,0,,194,2
Litnik,1991,1,,195,3
Litnik,1991,1,,196,4
Litnik,1991,1,,197,5
Litnik,1991,0,,198,5
Litnik,1991,2,,199,7
Litnik,1991,5,,200,12
Litnik,1991,2,,201,14
Litnik,1991,0,,202,14
Litnik,1991,2,,203,16
Litnik,1991,3,,204,19
Litnik,1991,8,,205,27
Litnik,1991,11,,206,38
Litnik,1991,0,,207,38
Litnik,1991,1,,208,39
Litnik,1991,11,,209,50
Litnik,1991,2,,210,52
Litnik,1991,8,,211,60
Litnik,1991,97,,212,157
Litnik,1991,0,,213,157
Litnik,1991,2,,214,159
Litnik,1991,13,,215,172
Litnik,1991,14,,216,186
Litnik,1991,11,,217,197
Litnik,1991,33,,218,230
Litnik,1991,2,,219,232
Litnik,1991,9,,220,241
Litnik,1991,4,,221,245
Litnik,1991,62,,222,307
Litnik,1991,58,,223,365
Litnik,1991,26,,224,391
Litnik,1991,1165,,225,1556
Litnik,1991,58,,226,1614
Litnik,1991,581,,227,2195
Litnik,1991,16,,228,2211
Litnik,1991,83,,229,2294
Litnik,1991,129,,230,2423
Litnik,1991,1576,,231,3999
Litnik,1991,751,,232,4750
Litnik,1991,153,,233,4903
Litnik,1991,139,,234,5042
Litnik,1991,202,,235,5244
Litnik,1991,108,,236,5352
Litnik,1991,530,,237,5882
Litnik,1991,1067,,238,6949
Litnik,1991,587,,239,7536
Litnik,1991,209,,240,7745
Litnik,1991,549,,241,8294
Litnik,1991,328,,242,8622
Litnik,1991,129,,243,8751
Litnik,1991,588,,244,9339
Litnik,1991,50,,245,9389
Litnik,1991,1680,,246,11069
Litnik,1991,110,,247,11179
Litnik,1991,80,,248,11259
Litnik,1991,111,,249,11370
Litnik,1991,115,,250,11485
Litnik,1991,2500,,251,13985
Litnik,1991,0,,252,13985
Litnik,1991,0,,253,13985
Litnik,1991,0,,254,13985
Litnik,1991,0,,255,13985
Litnik,1991,0,,256,13985
Litnik,1991,0,,257,13985
Litnik,1991,0,,258,13985
Litnik,1991,0,,259,13985
Litnik,1991,0,,260,13985
Litnik,1991,0,,261,13985
Litnik,1991,0,,262,13985
Litnik,1991,0,,263,13985
Litnik,1991,0,,264,13985
Litnik,1991,0,,265,13985
Litnik,1991,0,,266,13985
Litnik,1991,0,,267,13985
Litnik,1991,0,,268,13985
Litnik,1991,0,,269,13985
Litnik,1991,0,,270,13985
Litnik,1991,0,,271,13985
Litnik,1991,0,,272,13985
Litnik,1991,0,,273,13985
Litnik,1990,0,,174,0
Litnik,1990,0,,175,0
Litnik,1990,0,,176,0
Litnik,1990,0,,177,0
Litnik,1990,0,,178,0
Litnik,1990,0,,179,0
Litnik,1990,0,,180,0
Litnik,1990,0,,181,0
Litnik,1990,0,,182,0
Litnik,1990,0,,183,0
Litnik,1990,0,,184,0
Litnik,1990,0,,185,0
Litnik,1990,0,,186,0
Litnik,1990,0,,187,0
Litnik,1990,0,,188,0
Litnik,1990,0,,189,0
Litnik,1990,0,,190,0
Litnik,1990,1,,191,1
Litnik,1990,0,,192,1
Litnik,1990,0,,193,1
Litnik,1990,0,,194,1
Litnik,1990,2,,195,3
Litnik,1990,0,,196,3
Litnik,1990,0,,197,3
Litnik,1990,0,,198,3
Litnik,1990,2,,199,5
Litnik,1990,0,,200,5
Litnik,1990,1,,201,6
Litnik,1990,0,,202,6
Litnik,1990,16,,203,22
Litnik,1990,5,,204,27
Litnik,1990,0,,205,27
Litnik,1990,0,,206,27
Litnik,1990,1,,207,28
Litnik,1990,63,,208,91
Litnik,1990,370,,209,461
Litnik,1990,88,,210,549
Litnik,1990,13,,211,562
Litnik,1990,93,,212,655
Litnik,1990,689,,213,1344
Litnik,1990,150,,214,1494
Litnik,1990,323,,215,1817
Litnik,1990,313,,216,2130
Litnik,1990,125,,217,2255
Litnik,1990,123,,218,2378
Litnik,1990,1124,,219,3502
Litnik,1990,1995,,220,5497
Litnik,1990,1472,,221,6969
Litnik,1990,295,,222,7264
Litnik,1990,1635,,223,8899
Litnik,1990,654,,224,9553
Litnik,1990,770,,225,10323
Litnik,1990,935,,226,11258
Litnik,1990,1181,,227,12439
Litnik,1990,3287,,228,15726
Litnik,1990,2966,,229,18692
Litnik,1990,304,,230,18996
Litnik,1990,1447,,231,20443
Litnik,1990,1216,,232,21659
Litnik,1990,500,,233,22159
Litnik,1990,246,,234,22405
Litnik,1990,255,,235,22660
Litnik,1990,317,,236,22977
Litnik,1990,182,,237,23159
Litnik,1990,60,,238,23219
Litnik,1990,102,,239,23321
Litnik,1990,68,,240,23389
Litnik,1990,10,,241,23399
Litnik,1990,14,,242,23413
Litnik,1990,92,,243,23505
Litnik,1990,155,,244,23660
Litnik,1990,99,,245,23759
Litnik,1990,671,,246,24430
Litnik,1990,267,,247,24697
Litnik,1990,141,,248,24838
Litnik,1990,96,,249,24934
Litnik,1990,374,,250,25308
Litnik,1990,582,,251,25890
Litnik,1990,366,,252,26256
Litnik,1990,76,,253,26332
Litnik,1990,395,,254,26727
Litnik,1990,531,,255,27258
Litnik,1990,55,,256,27313
Litnik,1990,377,,257,27690
Litnik,1990,6,,258,27696
Litnik,1990,112,,259,27808
Litnik,1990,0,,260,27808
Litnik,1990,0,,261,27808
Litnik,1990,0,,262,27808
Litnik,1990,0,,263,27808
Litnik,1990,0,,264,27808
Litnik,1990,0,,265,27808
Litnik,1990,0,,266,27808
Litnik,1990,0,,267,27808
Litnik,1990,0,,268,27808
Litnik,1990,0,,269,27808
Litnik,1990,0,,270,27808
Litnik,1990,0,,271,27808
Litnik,1990,0,,272,27808
Litnik,1990,0,,273,27808
Litnik,1989,0,,174,0
Litnik,1989,0,,175,0
Litnik,1989,0,,176,0
Litnik,1989,0,,177,0
Litnik,1989,0,,178,0
Litnik,1989,0,,179,0
Litnik,1989,0,,180,0
Litnik,1989,0,,181,0
Litnik,1989,0,,182,0
Litnik,1989,0,,183,0
Litnik,1989,0,,184,0
Litnik,1989,0,,185,0
Litnik,1989,0,,186,0
Litnik,1989,0,,187,0
Litnik,1989,0,,188,0
Litnik,1989,0,,189,0
Litnik,1989,0,,190,0
Litnik,1989,0,,191,0
Litnik,1989,0,,192,0
Litnik,1989,0,,193,0
Litnik,1989,1,,194,1
Litnik,1989,20,,195,21
Litnik,1989,40,,196,61
Litnik,1989,7,,197,68
Litnik,1989,4,,198,72
Litnik,1989,1,,199,73
Litnik,1989,0,,200,73
Litnik,1989,0,,201,73
Litnik,1989,0,,202,73
Litnik,1989,1,,203,74
Litnik,1989,21,,204,95
Litnik,1989,11,,205,106
Litnik,1989,18,,206,124
Litnik,1989,35,,207,159
Litnik,1989,18,,208,177
Litnik,1989,33,,209,210
Litnik,1989,109,,210,319
Litnik,1989,63,,211,382
Litnik,1989,13,,212,395
Litnik,1989,25,,213,420
Litnik,1989,112,,214,532
Litnik,1989,198,,215,730
Litnik,1989,100,,216,830
Litnik,1989,34,,217,864
Litnik,1989,92,,218,956
Litnik,1989,111,,219,1067
Litnik,1989,947,,220,2014
Litnik,1989,72,,221,2086
Litnik,1989,97,,222,2183
Litnik,1989,25,,223,2208
Litnik,1989,70,,224,2278
Litnik,1989,85,,225,2363
Litnik,1989,154,,226,2517
Litnik,1989,284,,227,2801
Litnik,1989,3335,,228,6136
Litnik,1989,6700,,229,12836
Litnik,1989,10788,,230,23624
Litnik,1989,1847,,231,25471
Litnik,1989,808,,232,26279
Litnik,1989,515,,233,26794
Litnik,1989,353,,234,27147
Litnik,1989,242,,235,27389
Litnik,1989,212,,236,27601
Litnik,1989,2752,,237,30353
Litnik,1989,903,,238,31256
Litnik,1989,797,,239,32053
Litnik,1989,1196,,240,33249
Litnik,1989,656,,241,33905
Litnik,1989,679,,242,34584
Litnik,1989,1423,,243,36007
Litnik,1989,2455,,244,38462
Litnik,1989,402,,245,38864
Litnik,1989,324,,246,39188
Litnik,1989,438,,247,39626
Litnik,1989,393,,248,40019
Litnik,1989,275,,249,40294
Litnik,1989,197,,250,40491
Litnik,1989,99,,251,40590
Litnik,1989,182,,252,40772
Litnik,1989,65,,253,40837
Litnik,1989,120,,254,40957
Litnik,1989,120,,255,41077
Litnik,1989,23,,256,41100
Litnik,1989,46,,257,41146
Litnik,1989,85,,258,41231
Litnik,1989,35,,259,41266
Litnik,1989,206,,260,41472
Litnik,1989,80,,261,41552
Litnik,1989,34,,262,41586
Litnik,1989,25,,263,41611
Litnik,1989,0,,264,41611
Litnik,1989,0,,265,41611
Litnik,1989,0,,266,41611
Litnik,1989,0,,267,41611
Litnik,1989,0,,268,41611
Litnik,1989,0,,269,41611
Litnik,1989,0,,270,41611
Litnik,1989,0,,271,41611
Litnik,1989,0,,272,41611
Litnik,1989,0,,273,41611
Litnik,1988,0,,175,0
Litnik,1988,0,,176,0
Litnik,1988,0,,177,0
Litnik,1988,0,,178,0
Litnik,1988,0,,179,0
Litnik,1988,1,,180,1
Litnik,1988,0,,181,1
Litnik,1988,0,,182,1
Litnik,1988,0,,183,1
Litnik,1988,0,,184,1
Litnik,1988,0,,185,1
Litnik,1988,0,,186,1
Litnik,1988,0,,187,1
Litnik,1988,0,,188,1
Litnik,1988,0,,189,1
Litnik,1988,0,,190,1
Litnik,1988,0,,191,1
Litnik,1988,0,,192,1
Litnik,1988,0,,193,1
Litnik,1988,0,,194,1
Litnik,1988,0,,195,1
Litnik,1988,0,,196,1
Litnik,1988,0,,197,1
Litnik,1988,0,,198,1
Litnik,1988,0,,199,1
Litnik,1988,0,,200,1
Litnik,1988,0,,201,1
Litnik,1988,0,,202,1
Litnik,1988,1,,203,2
Litnik,1988,0,,204,2
Litnik,1988,0,,205,2
Litnik,1988,1,,206,3
Litnik,1988,0,,207,3
Litnik,1988,0,,208,3
Litnik,1988,0,,209,3
Litnik,1988,0,,210,3
Litnik,1988,1,,211,4
Litnik,1988,0,,212,4
Litnik,1988,0,,213,4
Litnik,1988,12,,214,16
Litnik,1988,5,,215,21
Litnik,1988,0,,216,21
Litnik,1988,8,,217,29
Litnik,1988,3,,218,32
Litnik,1988,74,,219,106
Litnik,1988,129,,220,235
Litnik,1988,551,,221,786
Litnik,1988,110,,222,896
Litnik,1988,812,,223,1708
Litnik,1988,333,,224,2041
Litnik,1988,565,,225,2606
Litnik,1988,378,,226,2984
Litnik,1988,136,,227,3120
Litnik,1988,141,,228,3261
Litnik,1988,127,,229,3388
Litnik,1988,8393,,230,11781
Litnik,1988,2140,,231,13921
Litnik,1988,316,,232,14237
Litnik,1988,884,,233,15121
Litnik,1988,11153,,234,26274
Litnik,1988,3545,,235,29819
Litnik,1988,1635,,236,31454
Litnik,1988,417,,237,31871
Litnik,1988,47541,,238,79412
Litnik,1988,8538,,239,87950
Litnik,1988,3518,,240,91468
Litnik,1988,28495,,241,119963
Litnik,1988,1435,,242,121398
Litnik,1988,1771,,243,123169
Litnik,1988,867,,244,124036
Litnik,1988,125,,245,124161
Litnik,1988,329,,246,124490
Litnik,1988,278,,247,124768
Litnik,1988,191,,248,124959
Litnik,1988,641,,249,125600
Litnik,1988,1219,,250,126819
Litnik,1988,801,,251,127620
Litnik,1988,586,,252,128206
Litnik,1988,20000,,253,148206
Litnik,1988,0,,254,148206
Litnik,1988,0,,255,148206
Litnik,1988,0,,256,148206
Litnik,1988,0,,257,148206
Litnik,1988,0,,258,148206
Litnik,1988,0,,259,148206
Litnik,1988,0,,260,148206
Litnik,1988,0,,261,148206
Litnik,1988,0,,262,148206
Litnik,1988,0,,263,148206
Litnik,1988,0,,264,148206
Litnik,1988,0,,265,148206
Litnik,1988,0,,266,148206
Litnik,1988,0,,267,148206
Litnik,1988,0,,268,148206
Litnik,1988,0,,269,148206
Litnik,1988,0,,270,148206
Litnik,1988,0,,271,148206
Litnik,1988,0,,272,148206
Litnik,1988,0,,273,148206
Litnik,1988,0,,274,148206
Litnik,1987,0,,174,0
Litnik,1987,0,,175,0
Litnik,1987,0,,176,0
Litnik,1987,0,,177,0
Litnik,1987,0,,178,0
Litnik,1987,0,,179,0
Litnik,1987,0,,180,0
Litnik,1987,0,,181,0
Litnik,1987,0,,182,0
Litnik,1987,0,,183,0
Litnik,1987,0,,184,0
Litnik,1987,0,,185,0
Litnik,1987,0,,186,0
Litnik,1987,0,,187,0
Litnik,1987,0,,188,0
Litnik,1987,0,,189,0
Litnik,1987,0,,190,0
Litnik,1987,0,,191,0
Litnik,1987,2,,192,2
Litnik,1987,4,,193,6
Litnik,1987,5,,194,11
Litnik,1987,1,,195,12
Litnik,1987,8,,196,20
Litnik,1987,17,,197,37
Litnik,1987,3,,198,40
Litnik,1987,10,,199,50
Litnik,1987,11,,200,61
Litnik,1987,2,,201,63
Litnik,1987,7,,202,70
Litnik,1987,5,,203,75
Litnik,1987,1,,204,76
Litnik,1987,1,,205,77
Litnik,1987,0,,206,77
Litnik,1987,0,,207,77
Litnik,1987,0,,208,77
Litnik,1987,9,,209,86
Litnik,1987,9,,210,95
Litnik,1987,13,,211,108
Litnik,1987,4,,212,112
Litnik,1987,10,,213,122
Litnik,1987,0,,214,122
Litnik,1987,11,,215,133
Litnik,1987,18,,216,151
Litnik,1987,12,,217,163
Litnik,1987,7,,218,170
Litnik,1987,13,,219,183
Litnik,1987,6,,220,189
Litnik,1987,127,,221,316
Litnik,1987,38,,222,354
Litnik,1987,348,,223,702
Litnik,1987,36,,224,738
Litnik,1987,3,,225,741
Litnik,1987,7,,226,748
Litnik,1987,1,,227,749
Litnik,1987,10,,228,759
Litnik,1987,39,,229,798
Litnik,1987,12,,230,810
Litnik,1987,86,,231,896
Litnik,1987,58,,232,954
Litnik,1987,60,,233,1014
Litnik,1987,61,,234,1075
Litnik,1987,298,,235,1373
Litnik,1987,463,,236,1836
Litnik,1987,47,,237,1883
Litnik,1987,17,,238,1900
Litnik,1987,13,,239,1913
Litnik,1987,47,,240,1960
Litnik,1987,178,,241,2138
Litnik,1987,207,,242,2345
Litnik,1987,612,,243,2957
Litnik,1987,663,,244,3620
Litnik,1987,531,,245,4151
Litnik,1987,500,,246,4651
Litnik,1987,550,,247,5201
Litnik,1987,482,,248,5683
Litnik,1987,1008,,249,6691
Litnik,1987,594,,250,7285
Litnik,1987,251,,251,7536
Litnik,1987,512,,252,8048
Litnik,1987,300,,253,8348
Litnik,1987,120,,254,8468
Litnik,1987,43,,255,8511
Litnik,1987,27,,256,8538
Litnik,1987,27,,257,8565
Litnik,1987,93,,258,8658
Litnik,1987,73,,259,8731
Litnik,1987,13,,260,8744
Litnik,1987,3,,261,8747
Litnik,1987,2,,262,8749
Litnik,1987,12,,263,8761
Litnik,1987,2,,264,8763
Litnik,1987,12,,265,8775
Litnik,1987,5,,266,8780
Litnik,1987,0,,267,8780
Litnik,1987,0,,268,8780
Litnik,1987,0,,269,8780
Litnik,1987,0,,270,8780
Litnik,1987,0,,271,8780
Litnik,1987,0,,272,8780
Litnik,1987,0,,273,8780
Litnik,1986,0,,174,0
Litnik,1986,0,,175,0
Litnik,1986,0,,176,0
Litnik,1986,0,,177,0
Litnik,1986,0,,178,0
Litnik,1986,0,,179,0
Litnik,1986,0,,180,0
Litnik,1986,0,,181,0
Litnik,1986,0,,182,0
Litnik,1986,0,,183,0
Litnik,1986,2,,184,2
Litnik,1986,0,,185,2
Litnik,1986,0,,186,2
Litnik,1986,0,,187,2
Litnik,1986,19,,188,21
Litnik,1986,0,,189,21
Litnik,1986,0,,190,21
Litnik,1986,0,,191,21
Litnik,1986,27,,192,48
Litnik,1986,0,,193,48
Litnik,1986,0,,194,48
Litnik,1986,0,,195,48
Litnik,1986,0,,196,48
Litnik,1986,0,,197,48
Litnik,1986,0,,198,48
Litnik,1986,0,,199,48
Litnik,1986,0,,200,48
Litnik,1986,0,,201,48
Litnik,1986,0,,202,48
Litnik,1986,0,,203,48
Litnik,1986,0,,204,48
Litnik,1986,0,,205,48
Litnik,1986,0,,206,48
Litnik,1986,0,,207,48
Litnik,1986,0,,208,48
Litnik,1986,0,,209,48
Litnik,1986,0,,210,48
Litnik,1986,0,,211,48
Litnik,1986,0,,212,48
Litnik,1986,0,,213,48
Litnik,1986,0,,214,48
Litnik,1986,0,,215,48
Litnik,1986,0,,216,48
Litnik,1986,0,,217,48
Litnik,1986,0,,218,48
Litnik,1986,0,,219,48
Litnik,1986,1359,,220,1407
Litnik,1986,1252,,221,2659
Litnik,1986,2520,,222,5179
Litnik,1986,0,,223,5179
Litnik,1986,834,,224,6013
Litnik,1986,16,,225,6029
Litnik,1986,179,,226,6208
Litnik,1986,57,,227,6265
Litnik,1986,0,,228,6265
Litnik,1986,0,,229,6265
Litnik,1986,351,,230,6616
Litnik,1986,0,,231,6616
Litnik,1986,1,,232,6617
Litnik,1986,0,,233,6617
Litnik,1986,6300,,234,12917
Litnik,1986,0,,235,12917
Litnik,1986,5,,236,12922
Litnik,1986,13,,237,12935
Litnik,1986,2334,,238,15269
Litnik,1986,1015,,239,16284
Litnik,1986,15,,240,16299
Litnik,1986,10,,241,16309
Litnik,1986,5505,,242,21814
Litnik,1986,3413,,243,25227
Litnik,1986,2750,,244,27977
Litnik,1986,1011,,245,28988
Litnik,1986,634,,246,29622
Litnik,1986,3502,,247,33124
Litnik,1986,221,,248,33345
Litnik,1986,5122,,249,38467
Litnik,1986,8614,,250,47081
Litnik,1986,13021,,251,60102
Litnik,1986,806,,252,60908
Litnik,1986,219,,253,61127
Litnik,1986,1471,,254,62598
Litnik,1986,373,,255,62971
Litnik,1986,1021,,256,63992
Litnik,1986,772,,257,64764
Litnik,1986,1956,,258,66720
Litnik,1986,126,,259,66846
Litnik,1986,217,,260,67063
Litnik,1986,816,,261,67879
Litnik,1986,33,,262,67912
Litnik,1986,42,,263,67954
Litnik,1986,47,,264,68001
Litnik,1986,40,,265,68041
Litnik,1986,0,,266,68041
Litnik,1986,5,,267,68046
Litnik,1986,3,,268,68049
Litnik,1986,0,,269,68049
Litnik,1986,3,,270,68052
Litnik,1986,0,,271,68052
Litnik,1986,0,,272,68052
Litnik,1986,0,,273,68052
Litnik,1985,0,,174,0
Litnik,1985,0,,175,0
Litnik,1985,0,,176,0
Litnik,1985,0,,177,0
Litnik,1985,0,,178,0
Litnik,1985,0,,179,0
Litnik,1985,0,,180,0
Litnik,1985,0,,181,0
Litnik,1985,0,,182,0
Litnik,1985,0,,183,0
Litnik,1985,1,,184,1
Litnik,1985,2,,185,3
Litnik,1985,0,,186,3
Litnik,1985,1,,187,4
Litnik,1985,1,,188,5
Litnik,1985,0,,189,5
Litnik,1985,6,,190,11
Litnik,1985,0,,191,11
Litnik,1985,1,,192,12
Litnik,1985,0,,193,12
Litnik,1985,1,,194,13
Litnik,1985,0,,195,13
Litnik,1985,2,,196,15
Litnik,1985,1,,197,16
Litnik,1985,0,,198,16
Litnik,1985,4,,199,20
Litnik,1985,21,,200,41
Litnik,1985,0,,201,41
Litnik,1985,1,,202,42
Litnik,1985,4,,203,46
Litnik,1985,4,,204,50
Litnik,1985,28,,205,78
Litnik,1985,0,,206,78
Litnik,1985,3,,207,81
Litnik,1985,7,,208,88
Litnik,1985,14,,209,102
Litnik,1985,7,,210,109
Litnik,1985,39,,211,148
Litnik,1985,13,,212,161
Litnik,1985,26,,213,187
Litnik,1985,15,,214,202
Litnik,1985,10,,215,212
Litnik,1985,3,,216,215
Litnik,1985,5,,217,220
Litnik,1985,11,,218,231
Litnik,1985,14,,219,245
Litnik,1985,0,,220,245
Litnik,1985,6,,221,251
Litnik,1985,11,,222,262
Litnik,1985,8,,223,270
Litnik,1985,20,,224,290
Litnik,1985,15,,225,305
Litnik,1985,17,,226,322
Litnik,1985,52,,227,374
Litnik,1985,73,,228,447
Litnik,1985,13,,229,460
Litnik,1985,30,,230,490
Litnik,1985,49,,231,539
Litnik,1985,48,,232,587
Litnik,1985,14,,233,601
Litnik,1985,53,,234,654
Litnik,1985,87,,235,741
Litnik,1985,43,,236,784
Litnik,1985,58,,237,842
Litnik,1985,46,,238,888
Litnik,1985,50,,239,938
Litnik,1985,186,,240,1124
Litnik,1985,27,,241,1151
Litnik,1985,268,,242,1419
Litnik,1985,309,,243,1728
Litnik,1985,246,,244,1974
Litnik,1985,67,,245,2041
Litnik,1985,51,,246,2092
Litnik,1985,12,,247,2104
Litnik,1985,42,,248,2146
Litnik,1985,23,,249,2169
Litnik,1985,3,,250,2172
Litnik,1985,8,,251,2180
Litnik,1985,4,,252,2184
Litnik,1985,3,,253,2187
Litnik,1985,10,,254,2197
Litnik,1985,8,,255,2205
Litnik,1985,0,,256,2205
Litnik,1985,0,,257,2205
Litnik,1985,6,,258,2211
Litnik,1985,0,,259,2211
Litnik,1985,0,,260,2211
Litnik,1985,0,,261,2211
Litnik,1985,0,,262,2211
Litnik,1985,0,,263,2211
Litnik,1985,0,,264,2211
Litnik,1985,1,,265,2212
Litnik,1985,0,,266,2212
Litnik,1985,2,,267,2214
Litnik,1985,0,,268,2214
Litnik,1985,0,,269,2214
Litnik,1985,1,,270,2215
Litnik,1985,0,,271,2215
Litnik,1985,0,,272,2215
Litnik,1985,0,,273,2215
Litnik,1984,0,,175,0
Litnik,1984,0,,176,0
Litnik,1984,0,,177,0
Litnik,1984,0,,178,0
Litnik,1984,0,,179,0
Litnik,1984,0,,180,0
Litnik,1984,0,,181,0
Litnik,1984,0,,182,0
Litnik,1984,0,,183,0
Litnik,1984,0,,184,0
Litnik,1984,0,,185,0
Litnik,1984,0,,186,0
Litnik,1984,1,,187,1
Litnik,1984,0,,188,1
Litnik,1984,0,,189,1
Litnik,1984,0,,190,1
Litnik,1984,0,,191,1
Litnik,1984,0,,192,1
Litnik,1984,0,,193,1
Litnik,1984,0,,194,1
Litnik,1984,0,,195,1
Litnik,1984,0,,196,1
Litnik,1984,1,,197,2
Litnik,1984,0,,198,2
Litnik,1984,0,,199,2
Litnik,1984,0,,200,2
Litnik,1984,7,,201,9
Litnik,1984,0,,202,9
Litnik,1984,1,,203,10
Litnik,1984,1,,204,11
Litnik,1984,7,,205,18
Litnik,1984,125,,206,143
Litnik,1984,148,,207,291
Litnik,1984,0,,208,291
Litnik,1984,7,,209,298
Litnik,1984,34,,210,332
Litnik,1984,16,,211,348
Litnik,1984,7,,212,355
Litnik,1984,37,,213,392
Litnik,1984,17,,214,409
Litnik,1984,11,,215,420
Litnik,1984,21,,216,441
Litnik,1984,35,,217,476
Litnik,1984,17,,218,493
Litnik,1984,279,,219,772
Litnik,1984,275,,220,1047
Litnik,1984,160,,221,1207
Litnik,1984,172,,222,1379
Litnik,1984,222,,223,1601
Litnik,1984,201,,224,1802
Litnik,1984,170,,225,1972
Litnik,1984,27,,226,1999
Litnik,1984,68,,227,2067
Litnik,1984,23,,228,2090
Litnik,1984,12,,229,2102
Litnik,1984,29,,230,2131
Litnik,1984,310,,231,2441
Litnik,1984,2288,,232,4729
Litnik,1984,194,,233,4923
Litnik,1984,454,,234,5377
Litnik,1984,357,,235,5734
Litnik,1984,826,,236,6560
Litnik,1984,2602,,237,9162
Litnik,1984,2734,,238,11896
Litnik,1984,611,,239,12507
Litnik,1984,314,,240,12821
Litnik,1984,160,,241,12981
Litnik,1984,80,,242,13061
Litnik,1984,276,,243,13337
Litnik,1984,145,,244,13482
Litnik,1984,343,,245,13825
Litnik,1984,252,,246,14077
Litnik,1984,294,,247,14371
Litnik,1984,509,,248,14880
Litnik,1984,380,,249,15260
Litnik,1984,700,,250,15960
Litnik,1984,919,,251,16879
Litnik,1984,3142,,252,20021
Litnik,1984,4009,,253,24030
Litnik,1984,1801,,254,25831
Litnik,1984,1257,,255,27088
Litnik,1984,477,,256,27565
Litnik,1984,322,,257,27887
Litnik,1984,1236,,258,29123
Litnik,1984,903,,259,30026
Litnik,1984,223,,260,30249
Litnik,1984,112,,261,30361
Litnik,1984,36,,262,30397
Litnik,1984,36,,263,30433
Litnik,1984,10,,264,30443
Litnik,1984,20,,265,30463
Litnik,1984,0,,266,30463
Litnik,1984,0,,267,30463
Litnik,1984,0,,268,30463
Litnik,1984,0,,269,30463
Litnik,1984,0,,270,30463
Litnik,1984,0,,271,30463
Litnik,1984,0,,272,30463
Litnik,1984,0,,273,30463
Litnik,1984,0,,274,30463
Litnik,1983,0,,174,0
Litnik,1983,0,,175,0
Litnik,1983,0,,176,0
Litnik,1983,0,,177,0
Litnik,1983,0,,178,0
Litnik,1983,0,,179,0
Litnik,1983,0,,180,0
Litnik,1983,0,,181,0
Litnik,1983,0,,182,0
Litnik,1983,0,,183,0
Litnik,1983,0,,184,0
Litnik,1983,0,,185,0
Litnik,1983,0,,186,0
Litnik,1983,0,,187,0
Litnik,1983,0,,188,0
Litnik,1983,0,,189,0
Litnik,1983,1,,190,1
Litnik,1983,0,,191,1
Litnik,1983,1,,192,2
Litnik,1983,0,,193,2
Litnik,1983,0,,194,2
Litnik,1983,0,,195,2
Litnik,1983,0,,196,2
Litnik,1983,2,,197,4
Litnik,1983,4,,198,8
Litnik,1983,1,,199,9
Litnik,1983,1,,200,10
Litnik,1983,4,,201,14
Litnik,1983,0,,202,14
Litnik,1983,0,,203,14
Litnik,1983,2,,204,16
Litnik,1983,0,,205,16
Litnik,1983,0,,206,16
Litnik,1983,0,,207,16
Litnik,1983,0,,208,16
Litnik,1983,1,,209,17
Litnik,1983,2,,210,19
Litnik,1983,15,,211,34
Litnik,1983,1,,212,35
Litnik,1983,5,,213,40
Litnik,1983,4,,214,44
Litnik,1983,15,,215,59
Litnik,1983,14,,216,73
Litnik,1983,30,,217,103
Litnik,1983,34,,218,137
Litnik,1983,10,,219,147
Litnik,1983,23,,220,170
Litnik,1983,31,,221,201
Litnik,1983,38,,222,239
Litnik,1983,5000,,223,5239
Litnik,1983,0,,224,5239
Litnik,1983,0,,225,5239
Litnik,1983,0,,226,5239
Litnik,1983,0,,227,5239
Litnik,1983,0,,228,5239
Litnik,1983,0,,229,5239
Litnik,1983,0,,230,5239
Litnik,1983,0,,231,5239
Litnik,1983,0,,232,5239
Litnik,1983,0,,233,5239
Litnik,1983,0,,234,5239
Litnik,1983,0,,235,5239
Litnik,1983,0,,236,5239
Litnik,1983,0,,237,5239
Litnik,1983,0,,238,5239
Litnik,1983,0,,239,5239
Litnik,1983,0,,240,5239
Litnik,1983,0,,241,5239
Litnik,1983,0,,242,5239
Litnik,1983,0,,243,5239
Litnik,1983,0,,244,5239
Litnik,1983,0,,245,5239
Litnik,1983,0,,246,5239
Litnik,1983,0,,247,5239
Litnik,1983,0,,248,5239
Litnik,1983,0,,249,5239
Litnik,1983,0,,250,5239
Litnik,1983,0,,251,5239
Litnik,1983,0,,252,5239
Litnik,1983,0,,253,5239
Litnik,1983,0,,254,5239
Litnik,1983,0,,255,5239
Litnik,1983,0,,256,5239
Litnik,1983,0,,257,5239
Litnik,1983,0,,258,5239
Litnik,1983,0,,259,5239
Litnik,1983,0,,260,5239
Litnik,1983,0,,261,5239
Litnik,1983,0,,262,5239
Litnik,1983,0,,263,5239
Litnik,1983,0,,264,5239
Litnik,1983,0,,265,5239
Litnik,1983,0,,266,5239
Litnik,1983,0,,267,5239
Litnik,1983,0,,268,5239
Litnik,1983,0,,269,5239
Litnik,1983,0,,270,5239
Litnik,1983,0,,271,5239
Litnik,1983,0,,272,5239
Litnik,1983,0,,273,5239
Litnik,1982,0,,174,0
Litnik,1982,0,,175,0
Litnik,1982,0,,176,0
Litnik,1982,0,,177,0
Litnik,1982,0,,178,0
Litnik,1982,0,,179,0
Litnik,1982,0,,180,0
Litnik,1982,0,,181,0
Litnik,1982,0,,182,0
Litnik,1982,0,,183,0
Litnik,1982,0,,184,0
Litnik,1982,0,,185,0
Litnik,1982,0,,186,0
Litnik,1982,0,,187,0
Litnik,1982,0,,188,0
Litnik,1982,0,,189,0
Litnik,1982,0,,190,0
Litnik,1982,0,,191,0
Litnik,1982,0,,192,0
Litnik,1982,0,,193,0
Litnik,1982,8,,194,8
Litnik,1982,19,,195,27
Litnik,1982,6,,196,33
Litnik,1982,33,,197,66
Litnik,1982,18,,198,84
Litnik,1982,20,,199,104
Litnik,1982,20,,200,124
Litnik,1982,82,,201,206
Litnik,1982,3,,202,209
Litnik,1982,22,,203,231
Litnik,1982,14,,204,245
Litnik,1982,18,,205,263
Litnik,1982,6,,206,269
Litnik,1982,6,,207,275
Litnik,1982,7,,208,282
Litnik,1982,2,,209,284
Litnik,1982,0,,210,284
Litnik,1982,8,,211,292
Litnik,1982,8,,212,300
Litnik,1982,10,,213,310
Litnik,1982,8,,214,318
Litnik,1982,58,,215,376
Litnik,1982,17,,216,393
Litnik,1982,13,,217,406
Litnik,1982,69,,218,475
Litnik,1982,203,,219,678
Litnik,1982,25,,220,703
Litnik,1982,316,,221,1019
Litnik,1982,127,,222,1146
Litnik,1982,201,,223,1347
Litnik,1982,55,,224,1402
Litnik,1982,103,,225,1505
Litnik,1982,93,,226,1598
Litnik,1982,314,,227,1912
Litnik,1982,36,,228,1948
Litnik,1982,295,,229,2243
Litnik,1982,292,,230,2535
Litnik,1982,234,,231,2769
Litnik,1982,158,,232,2927
Litnik,1982,194,,233,3121
Litnik,1982,292,,234,3413
Litnik,1982,308,,235,3721
Litnik,1982,81,,236,3802
Litnik,1982,39,,237,3841
Litnik,1982,0,,238,3841
Litnik,1982,0,,239,3841
Litnik,1982,0,,240,3841
Litnik,1982,0,,241,3841
Litnik,1982,0,,242,3841
Litnik,1982,0,,243,3841
Litnik,1982,0,,244,3841
Litnik,1982,0,,245,3841
Litnik,1982,0,,246,3841
Litnik,1982,0,,247,3841
Litnik,1982,0,,248,3841
Litnik,1982,0,,249,3841
Litnik,1982,0,,250,3841
Litnik,1982,0,,251,3841
Litnik,1982,0,,252,3841
Litnik,1982,0,,253,3841
Litnik,1982,0,,254,3841
Litnik,1982,0,,255,3841
Litnik,1982,0,,256,3841
Litnik,1982,0,,257,3841
Litnik,1982,0,,258,3841
Litnik,1982,0,,259,3841
Litnik,1982,0,,260,3841
Litnik,1982,0,,261,3841
Litnik,1982,0,,262,3841
Litnik,1982,0,,263,3841
Litnik,1982,0,,264,3841
Litnik,1982,0,,265,3841
Litnik,1982,0,,266,3841
Litnik,1982,0,,267,3841
Litnik,1982,0,,268,3841
Litnik,1982,0,,269,3841
Litnik,1982,0,,270,3841
Litnik,1982,0,,271,3841
Litnik,1982,0,,272,3841
Litnik,1982,0,,273,3841
Litnik,1981,0,,174,0
Litnik,1981,0,,175,0
Litnik,1981,0,,176,0
Litnik,1981,0,,177,0
Litnik,1981,0,,178,0
Litnik,1981,0,,179,0
Litnik,1981,0,,180,0
Litnik,1981,0,,181,0
Litnik,1981,0,,182,0
Litnik,1981,0,,183,0
Litnik,1981,0,,184,0
Litnik,1981,0,,185,0
Litnik,1981,0,,186,0
Litnik,1981,0,,187,0
Litnik,1981,0,,188,0
Litnik,1981,0,,189,0
Litnik,1981,0,,190,0
Litnik,1981,0,,191,0
Litnik,1981,0,,192,0
Litnik,1981,0,,193,0
Litnik,1981,0,,194,0
Litnik,1981,0,,195,0
Litnik,1981,0,,196,0
Litnik,1981,0,,197,0
Litnik,1981,0,,198,0
Litnik,1981,0,,199,0
Litnik,1981,0,,200,0
Litnik,1981,0,,201,0
Litnik,1981,0,,202,0
Litnik,1981,0,,203,0
Litnik,1981,0,,204,0
Litnik,1981,20,,205,20
Litnik,1981,40,,206,60
Litnik,1981,0,,207,60
Litnik,1981,0,,208,60
Litnik,1981,25,,209,85
Litnik,1981,5,,210,90
Litnik,1981,10,,211,100
Litnik,1981,2,,212,102
Litnik,1981,1,,213,103
Litnik,1981,5,,214,108
Litnik,1981,1,,215,109
Litnik,1981,1,,216,110
Litnik,1981,5,,217,115
Litnik,1981,1,,218,116
Litnik,1981,3,,219,119
Litnik,1981,3,,220,122
Litnik,1981,15,,221,137
Litnik,1981,8,,222,145
Litnik,1981,10,,223,155
Litnik,1981,30,,224,185
Litnik,1981,10,,225,195
Litnik,1981,20,,226,215
Litnik,1981,54,,227,269
Litnik,1981,30,,228,299
Litnik,1981,280,,229,579
Litnik,1981,252,,230,831
Litnik,1981,35,,231,866
Litnik,1981,650,,232,1516
Litnik,1981,2116,,233,3632
Litnik,1981,503,,234,4135
Litnik,1981,0,,235,4135
Litnik,1981,0,,236,4135
Litnik,1981,0,,237,4135
Litnik,1981,0,,238,4135
Litnik,1981,0,,239,4135
Litnik,1981,0,,240,4135
Litnik,1981,0,,241,4135
Litnik,1981,0,,242,4135
Litnik,1981,0,,243,4135
Litnik,1981,0,,244,4135
Litnik,1981,0,,245,4135
Litnik,1981,0,,246,4135
Litnik,1981,0,,247,4135
Litnik,1981,0,,248,4135
Litnik,1981,0,,249,4135
Litnik,1981,0,,250,4135
Litnik,1981,0,,251,4135
Litnik,1981,0,,252,4135
Litnik,1981,0,,253,4135
Litnik,1981,0,,254,4135
Litnik,1981,0,,255,4135
Litnik,1981,0,,256,4135
Litnik,1981,0,,257,4135
Litnik,1981,0,,258,4135
Litnik,1981,0,,259,4135
Litnik,1981,0,,260,4135
Litnik,1981,0,,261,4135
Litnik,1981,0,,262,4135
Litnik,1981,0,,263,4135
Litnik,1981,0,,264,4135
Litnik,1981,0,,265,4135
Litnik,1981,0,,266,4135
Litnik,1981,0,,267,4135
Litnik,1981,0,,268,4135
Litnik,1981,0,,269,4135
Litnik,1981,0,,270,4135
Litnik,1981,0,,271,4135
Litnik,1981,0,,272,4135
Litnik,1981,0,,273,4135
Litnik,1980,0,,175,0
Litnik,1980,0,,176,0
Litnik,1980,0,,177,0
Litnik,1980,0,,178,0
Litnik,1980,0,,179,0
Litnik,1980,0,,180,0
Litnik,1980,0,,181,0
Litnik,1980,0,,182,0
Litnik,1980,0,,183,0
Litnik,1980,0,,184,0
Litnik,1980,0,,185,0
Litnik,1980,0,,186,0
Litnik,1980,0,,187,0
Litnik,1980,0,,188,0
Litnik,1980,0,,189,0
Litnik,1980,0,,190,0
Litnik,1980,0,,191,0
Litnik,1980,0,,192,0
Litnik,1980,0,,193,0
Litnik,1980,20,,194,20
Litnik,1980,30,,195,50
Litnik,1980,30,,196,80
Litnik,1980,0,,197,80
Litnik,1980,0,,198,80
Litnik,1980,0,,199,80
Litnik,1980,0,,200,80
Litnik,1980,0,,201,80
Litnik,1980,30,,202,110
Litnik,1980,50,,203,160
Litnik,1980,20,,204,180
Litnik,1980,10,,205,190
Litnik,1980,10,,206,200
Litnik,1980,20,,207,220
Litnik,1980,9,,208,229
Litnik,1980,0,,209,229
Litnik,1980,0,,210,229
Litnik,1980,11,,211,240
Litnik,1980,10,,212,250
Litnik,1980,0,,213,250
Litnik,1980,0,,214,250
Litnik,1980,20,,215,270
Litnik,1980,10,,216,280
Litnik,1980,10,,217,290
Litnik,1980,14,,218,304
Litnik,1980,9,,219,313
Litnik,1980,54,,220,367
Litnik,1980,162,,221,529
Litnik,1980,635,,222,1164
Litnik,1980,472,,223,1636
Litnik,1980,300,,224,1936
Litnik,1980,194,,225,2130
Litnik,1980,128,,226,2258
Litnik,1980,280,,227,2538
Litnik,1980,882,,228,3420
Litnik,1980,701,,229,4121
Litnik,1980,135,,230,4256
Litnik,1980,1000,,231,5256
Litnik,1980,349,,232,5605
Litnik,1980,385,,233,5990
Litnik,1980,53,,234,6043
Litnik,1980,46,,235,6089
Litnik,1980,0,,236,6089
Litnik,1980,80,,237,6169
Litnik,1980,67,,238,6236
Litnik,1980,24,,239,6260
Litnik,1980,41,,240,6301
Litnik,1980,90,,241,6391
Litnik,1980,1824,,242,8215
Litnik,1980,1293,,243,9508
Litnik,1980,2000,,244,11508
Litnik,1980,0,,245,11508
Litnik,1980,0,,246,11508
Litnik,1980,0,,247,11508
Litnik,1980,0,,248,11508
Litnik,1980,0,,249,11508
Litnik,1980,0,,250,11508
Litnik,1980,0,,251,11508
Litnik,1980,0,,252,11508
Litnik,1980,0,,253,11508
Litnik,1980,0,,254,11508
Litnik,1980,0,,255,11508
Litnik,1980,0,,256,11508
Litnik,1980,0,,257,11508
Litnik,1980,0,,258,11508
Litnik,1980,0,,259,11508
Litnik,1980,0,,260,11508
Litnik,1980,0,,261,11508
Litnik,1980,0,,262,11508
Litnik,1980,0,,263,11508
Litnik,1980,0,,264,11508
Litnik,1980,0,,265,11508
Litnik,1980,0,,266,11508
Litnik,1980,0,,267,11508
Litnik,1980,0,,268,11508
Litnik,1980,0,,269,11508
Litnik,1980,0,,270,11508
Litnik,1980,0,,271,11508
Litnik,1980,0,,272,11508
Litnik,1980,0,,273,11508
Litnik,1980,0,,274,11508
Litnik,1979,0,,174,0
Litnik,1979,0,,175,0
Litnik,1979,0,,176,0
Litnik,1979,0,,177,0
Litnik,1979,0,,178,0
Litnik,1979,0,,179,0
Litnik,1979,0,,180,0
Litnik,1979,0,,181,0
Litnik,1979,0,,182,0
Litnik,1979,0,,183,0
Litnik,1979,0,,184,0
Litnik,1979,0,,185,0
Litnik,1979,0,,186,0
Litnik,1979,0,,187,0
Litnik,1979,0,,188,0
Litnik,1979,0,,189,0
Litnik,1979,0,,190,0
Litnik,1979,0,,191,0
Litnik,1979,0,,192,0
Litnik,1979,0,,193,0
Litnik,1979,0,,194,0
Litnik,1979,0,,195,0
Litnik,1979,0,,196,0
Litnik,1979,0,,197,0
Litnik,1979,0,,198,0
Litnik,1979,0,,199,0
Litnik,1979,0,,200,0
Litnik,1979,0,,201,0
Litnik,1979,0,,202,0
Litnik,1979,0,,203,0
Litnik,1979,7,,204,7
Litnik,1979,88,,205,95
Litnik,1979,8,,206,103
Litnik,1979,8,,207,111
Litnik,1979,3,,208,114
Litnik,1979,13,,209,127
Litnik,1979,10,,210,137
Litnik,1979,5,,211,142
Litnik,1979,13,,212,155
Litnik,1979,2,,213,157
Litnik,1979,3,,214,160
Litnik,1979,6,,215,166
Litnik,1979,4,,216,170
Litnik,1979,0,,217,170
Litnik,1979,6,,218,176
Litnik,1979,17,,219,193
Litnik,1979,63,,220,256
Litnik,1979,623,,221,879
Litnik,1979,776,,222,1655
Litnik,1979,209,,223,1864
Litnik,1979,25,,224,1889
Litnik,1979,1621,,225,3510
Litnik,1979,163,,226,3673
Litnik,1979,8,,227,3681
Litnik,1979,777,,228,4458
Litnik,1979,140,,229,4598
Litnik,1979,157,,230,4755
Litnik,1979,229,,231,4984
Litnik,1979,98,,232,5082
Litnik,1979,0,,233,5082
Litnik,1979,0,,234,5082
Litnik,1979,0,,235,5082
Litnik,1979,0,,236,5082
Litnik,1979,0,,237,5082
Litnik,1979,0,,238,5082
Litnik,1979,0,,239,5082
Litnik,1979,0,,240,5082
Litnik,1979,0,,241,5082
Litnik,1979,0,,242,5082
Litnik,1979,0,,243,5082
Litnik,1979,0,,244,5082
Litnik,1979,0,,245,5082
Litnik,1979,0,,246,5082
Litnik,1979,0,,247,5082
Litnik,1979,0,,248,5082
Litnik,1979,0,,249,5082
Litnik,1979,0,,250,5082
Litnik,1979,0,,251,5082
Litnik,1979,0,,252,5082
Litnik,1979,0,,253,5082
Litnik,1979,0,,254,5082
Litnik,1979,0,,255,5082
Litnik,1979,0,,256,5082
Litnik,1979,0,,257,5082
Litnik,1979,0,,258,5082
Litnik,1979,0,,259,5082
Litnik,1979,0,,260,5082
Litnik,1979,0,,261,5082
Litnik,1979,0,,262,5082
Litnik,1979,0,,263,5082
Litnik,1979,0,,264,5082
Litnik,1979,0,,265,5082
Litnik,1979,0,,266,5082
Litnik,1979,0,,267,5082
Litnik,1979,0,,268,5082
Litnik,1979,0,,269,5082
Litnik,1979,0,,270,5082
Litnik,1979,0,,271,5082
Litnik,1979,0,,272,5082
Litnik,1979,0,,273,5082
Litnik,1978,0,,174,0
Litnik,1978,0,,175,0
Litnik,1978,0,,176,0
Litnik,1978,0,,177,0
Litnik,1978,0,,178,0
Litnik,1978,0,,179,0
Litnik,1978,0,,180,0
Litnik,1978,0,,181,0
Litnik,1978,0,,182,0
Litnik,1978,0,,183,0
Litnik,1978,0,,184,0
Litnik,1978,0,,185,0
Litnik,1978,0,,186,0
Litnik,1978,0,,187,0
Litnik,1978,0,,188,0
Litnik,1978,0,,189,0
Litnik,1978,0,,190,0
Litnik,1978,0,,191,0
Litnik,1978,0,,192,0
Litnik,1978,0,,193,0
Litnik,1978,0,,194,0
Litnik,1978,0,,195,0
Litnik,1978,0,,196,0
Litnik,1978,0,,197,0
Litnik,1978,0,,198,0
Litnik,1978,0,,199,0
Litnik,1978,7,,200,7
Litnik,1978,6,,201,13
Litnik,1978,2,,202,15
Litnik,1978,2,,203,17
Litnik,1978,8,,204,25
Litnik,1978,11,,205,36
Litnik,1978,68,,206,104
Litnik,1978,11,,207,115
Litnik,1978,20,,208,135
Litnik,1978,7,,209,142
Litnik,1978,28,,210,170
Litnik,1978,16,,211,186
Litnik,1978,19,,212,205
Litnik,1978,55,,213,260
Litnik,1978,50,,214,310
Litnik,1978,17,,215,327
Litnik,1978,8,,216,335
Litnik,1978,1,,217,336
Litnik,1978,18,,218,354
Litnik,1978,9,,219,363
Litnik,1978,6,,220,369
Litnik,1978,941,,221,1310
Litnik,1978,1870,,222,3180
Litnik,1978,980,,223,4160
Litnik,1978,2374,,224,6534
Litnik,1978,187,,225,6721
Litnik,1978,628,,226,7349
Litnik,1978,703,,227,8052
Litnik,1978,732,,228,8784
Litnik,1978,2341,,229,11125
Litnik,1978,520,,230,11645
Litnik,1978,321,,231,11966
Litnik,1978,469,,232,12435
Litnik,1978,499,,233,12934
Litnik,1978,411,,234,13345
Litnik,1978,603,,235,13948
Litnik,1978,414,,236,14362
Litnik,1978,514,,237,14876
Litnik,1978,299,,238,15175
Litnik,1978,323,,239,15498
Litnik,1978,236,,240,15734
Litnik,1978,805,,241,16539
Litnik,1978,6801,,242,23340
Litnik,1978,5082,,243,28422
Litnik,1978,2405,,244,30827
Litnik,1978,2012,,245,32839
Litnik,1978,1465,,246,34304
Litnik,1978,1054,,247,35358
Litnik,1978,1621,,248,36979
Litnik,1978,1567,,249,38546
Litnik,1978,892,,250,39438
Litnik,1978,2155,,251,41593
Litnik,1978,1606,,252,43199
Litnik,1978,1019,,253,44218
Litnik,1978,435,,254,44653
Litnik,1978,2695,,255,47348
Litnik,1978,901,,256,48249
Litnik,1978,1000,,257,49249
Litnik,1978,7500,,258,56749
Litnik,1978,0,,259,56749
Litnik,1978,0,,260,56749
Litnik,1978,0,,261,56749
Litnik,1978,0,,262,56749
Litnik,1978,0,,263,56749
Litnik,1978,0,,264,56749
Litnik,1978,0,,265,56749
Litnik,1978,0,,266,56749
Litnik,1978,0,,267,56749
Litnik,1978,0,,268,56749
Litnik,1978,0,,269,56749
Litnik,1978,0,,270,56749
Litnik,1978,0,,271,56749
Litnik,1978,0,,272,56749
Litnik,1978,0,,273,56749
Litnik,1932,0,,175,0
Litnik,1932,0,,176,0
Litnik,1932,0,,177,0
Litnik,1932,0,,178,0
Litnik,1932,0,,179,0
Litnik,1932,0,,180,0
Litnik,1932,0,,181,0
Litnik,1932,0,,182,0
Litnik,1932,0,,183,0
Litnik,1932,0,,184,0
Litnik,1932,0,,185,0
Litnik,1932,0,,186,0
Litnik,1932,0,,187,0
Litnik,1932,0,,188,0
Litnik,1932,0,,189,0
Litnik,1932,0,,190,0
Litnik,1932,0,,191,0
Litnik,1932,0,,192,0
Litnik,1932,0,,193,0
Litnik,1932,0,,194,0
Litnik,1932,0,,195,0
Litnik,1932,0,,196,0
Litnik,1932,0,,197,0
Litnik,1932,5,,198,5
Litnik,1932,0,,199,5
Litnik,1932,0,,200,5
Litnik,1932,0,,201,5
Litnik,1932,0,,202,5
Litnik,1932,0,,203,5
Litnik,1932,0,,204,5
Litnik,1932,0,,205,5
Litnik,1932,0,,206,5
Litnik,1932,0,,207,5
Litnik,1932,0,,208,5
Litnik,1932,0,,209,5
Litnik,1932,0,,210,5
Litnik,1932,0,,211,5
Litnik,1932,0,,212,5
Litnik,1932,0,,213,5
Litnik,1932,0,,214,5
Litnik,1932,7,,215,12
Litnik,1932,10,,216,22
Litnik,1932,7,,217,29
Litnik,1932,0,,218,29
Litnik,1932,50,,219,79
Litnik,1932,0,,220,79
Litnik,1932,0,,221,79
Litnik,1932,20,,222,99
Litnik,1932,0,,223,99
Litnik,1932,0,,224,99
Litnik,1932,0,,225,99
Litnik,1932,0,,226,99
Litnik,1932,0,,227,99
Litnik,1932,333,,228,432
Litnik,1932,75,,229,507
Litnik,1932,0,,230,507
Litnik,1932,0,,231,507
Litnik,1932,0,,232,507
Litnik,1932,0,,233,507
Litnik,1932,0,,234,507
Litnik,1932,3300,,235,3807
Litnik,1932,150,,236,3957
Litnik,1932,611,,237,4568
Litnik,1932,475,,238,5043
Litnik,1932,509,,239,5552
Litnik,1932,0,,240,5552
Litnik,1932,0,,241,5552
Litnik,1932,0,,242,5552
Litnik,1932,0,,243,5552
Litnik,1932,0,,244,5552
Litnik,1932,0,,245,5552
Litnik,1932,0,,246,5552
Litnik,1932,0,,247,5552
Litnik,1932,0,,248,5552
Litnik,1932,0,,249,5552
Litnik,1932,0,,250,5552
Litnik,1932,0,,251,5552
Litnik,1932,0,,252,5552
Litnik,1932,0,,253,5552
Litnik,1932,0,,254,5552
Litnik,1932,0,,255,5552
Litnik,1932,0,,256,5552
Litnik,1932,0,,257,5552
Litnik,1932,0,,258,5552
Litnik,1932,0,,259,5552
Litnik,1932,0,,260,5552
Litnik,1932,0,,261,5552
Litnik,1932,0,,262,5552
Litnik,1932,0,,263,5552
Litnik,1932,0,,264,5552
Litnik,1932,0,,265,5552
Litnik,1932,0,,266,5552
Litnik,1932,0,,267,5552
Litnik,1932,0,,268,5552
Litnik,1932,0,,269,5552
Litnik,1932,0,,270,5552
Litnik,1932,0,,271,5552
Litnik,1932,0,,272,5552
Litnik,1932,0,,273,5552
Litnik,1932,0,,274,5552
Litnik,1931,0,,174,0
Litnik,1931,0,,175,0
Litnik,1931,0,,176,0
Litnik,1931,0,,177,0
Litnik,1931,0,,178,0
Litnik,1931,0,,179,0
Litnik,1931,0,,180,0
Litnik,1931,0,,181,0
Litnik,1931,0,,182,0
Litnik,1931,0,,183,0
Litnik,1931,0,,184,0
Litnik,1931,0,,185,0
Litnik,1931,0,,186,0
Litnik,1931,0,,187,0
Litnik,1931,0,,188,0
Litnik,1931,0,,189,0
Litnik,1931,0,,190,0
Litnik,1931,0,,191,0
Litnik,1931,0,,192,0
Litnik,1931,0,,193,0
Litnik,1931,0,,194,0
Litnik,1931,0,,195,0
Litnik,1931,0,,196,0
Litnik,1931,0,,197,0
Litnik,1931,0,,198,0
Litnik,1931,0,,199,0
Litnik,1931,0,,200,0
Litnik,1931,0,,201,0
Litnik,1931,0,,202,0
Litnik,1931,0,,203,0
Litnik,1931,0,,204,0
Litnik,1931,0,,205,0
Litnik,1931,0,,206,0
Litnik,1931,0,,207,0
Litnik,1931,0,,208,0
Litnik,1931,0,,209,0
Litnik,1931,0,,210,0
Litnik,1931,0,,211,0
Litnik,1931,0,,212,0
Litnik,1931,0,,213,0
Litnik,1931,0,,214,0
Litnik,1931,0,,215,0
Litnik,1931,0,,216,0
Litnik,1931,0,,217,0
Litnik,1931,0,,218,0
Litnik,1931,0,,219,0
Litnik,1931,0,,220,0
Litnik,1931,0,,221,0
Litnik,1931,0,,222,0
Litnik,1931,0,,223,0
Litnik,1931,0,,224,0
Litnik,1931,0,,225,0
Litnik,1931,0,,226,0
Litnik,1931,0,,227,0
Litnik,1931,0,,228,0
Litnik,1931,0,,229,0
Litnik,1931,0,,230,0
Litnik,1931,0,,231,0
Litnik,1931,0,,232,0
Litnik,1931,0,,233,0
Litnik,1931,0,,234,0
Litnik,1931,0,,235,0
Litnik,1931,0,,236,0
Litnik,1931,0,,237,0
Litnik,1931,0,,238,0
Litnik,1931,0,,239,0
Litnik,1931,0,,240,0
Litnik,1931,0,,241,0
Litnik,1931,0,,242,0
Litnik,1931,0,,243,0
Litnik,1931,116,,244,116
Litnik,1931,87,,245,203
Litnik,1931,0,,246,203
Litnik,1931,0,,247,203
Litnik,1931,0,,248,203
Litnik,1931,0,,249,203
Litnik,1931,0,,250,203
Litnik,1931,0,,251,203
Litnik,1931,0,,252,203
Litnik,1931,0,,253,203
Litnik,1931,0,,254,203
Litnik,1931,0,,255,203
Litnik,1931,15,,256,218
Litnik,1931,0,,257,218
Litnik,1931,0,,258,218
Litnik,1931,0,,259,218
Litnik,1931,0,,260,218
Litnik,1931,16,,261,234
Litnik,1931,0,,262,234
Litnik,1931,0,,263,234
Litnik,1931,0,,264,234
Litnik,1931,0,,265,234
Litnik,1931,0,,266,234
Litnik,1931,0,,267,234
Litnik,1931,0,,268,234
Litnik,1931,0,,269,234
Litnik,1931,0,,270,234
Litnik,1931,0,,271,234
Litnik,1931,0,,272,234
Litnik,1931,0,,273,234
Litnik,1930,0,,174,0
Litnik,1930,0,,175,0
Litnik,1930,0,,176,0
Litnik,1930,0,,177,0
Litnik,1930,0,,178,0
Litnik,1930,0,,179,0
Litnik,1930,0,,180,0
Litnik,1930,0,,181,0
Litnik,1930,0,,182,0
Litnik,1930,0,,183,0
Litnik,1930,0,,184,0
Litnik,1930,0,,185,0
Litnik,1930,0,,186,0
Litnik,1930,0,,187,0
Litnik,1930,0,,188,0
Litnik,1930,0,,189,0
Litnik,1930,0,,190,0
Litnik,1930,0,,191,0
Litnik,1930,0,,192,0
Litnik,1930,0,,193,0
Litnik,1930,0,,194,0
Litnik,1930,0,,195,0
Litnik,1930,0,,196,0
Litnik,1930,0,,197,0
Litnik,1930,0,,198,0
Litnik,1930,0,,199,0
Litnik,1930,0,,200,0
Litnik,1930,0,,201,0
Litnik,1930,0,,202,0
Litnik,1930,0,,203,0
Litnik,1930,0,,204,0
Litnik,1930,0,,205,0
Litnik,1930,0,,206,0
Litnik,1930,0,,207,0
Litnik,1930,0,,208,0
Litnik,1930,0,,209,0
Litnik,1930,0,,210,0
Litnik,1930,0,,211,0
Litnik,1930,0,,212,0
Litnik,1930,0,,213,0
Litnik,1930,0,,214,0
Litnik,1930,0,,215,0
Litnik,1930,0,,216,0
Litnik,1930,0,,217,0
Litnik,1930,0,,218,0
Litnik,1930,989,,219,989
Litnik,1930,0,,220,989
Litnik,1930,0,,221,989
Litnik,1930,59,,222,1048
Litnik,1930,76,,223,1124
Litnik,1930,0,,224,1124
Litnik,1930,1026,,225,2150
Litnik,1930,0,,226,2150
Litnik,1930,0,,227,2150
Litnik,1930,0,,228,2150
Litnik,1930,546,,229,2696
Litnik,1930,650,,230,3346
Litnik,1930,45,,231,3391
Litnik,1930,555,,232,3946
Litnik,1930,424,,233,4370
Litnik,1930,64,,234,4434
Litnik,1930,861,,235,5295
Litnik,1930,0,,236,5295
Litnik,1930,0,,237,5295
Litnik,1930,720,,238,6015
Litnik,1930,0,,239,6015
Litnik,1930,0,,240,6015
Litnik,1930,0,,241,6015
Litnik,1930,0,,242,6015
Litnik,1930,0,,243,6015
Litnik,1930,0,,244,6015
Litnik,1930,0,,245,6015
Litnik,1930,0,,246,6015
Litnik,1930,0,,247,6015
Litnik,1930,0,,248,6015
Litnik,1930,0,,249,6015
Litnik,1930,0,,250,6015
Litnik,1930,0,,251,6015
Litnik,1930,0,,252,6015
Litnik,1930,0,,253,6015
Litnik,1930,0,,254,6015
Litnik,1930,0,,255,6015
Litnik,1930,0,,256,6015
Litnik,1930,0,,257,6015
Litnik,1930,0,,258,6015
Litnik,1930,0,,259,6015
Litnik,1930,0,,260,6015
Litnik,1930,0,,261,6015
Litnik,1930,0,,262,6015
Litnik,1930,0,,263,6015
Litnik,1930,0,,264,6015
Litnik,1930,0,,265,6015
Litnik,1930,0,,266,6015
Litnik,1930,0,,267,6015
Litnik,1930,0,,268,6015
Litnik,1930,0,,269,6015
Litnik,1930,0,,270,6015
Litnik,1930,0,,271,6015
Litnik,1930,0,,272,6015
Litnik,1930,0,,273,6015
Litnik,1929,0,,174,0
Litnik,1929,0,,175,0
Litnik,1929,0,,176,0
Litnik,1929,0,,177,0
Litnik,1929,0,,178,0
Litnik,1929,0,,179,0
Litnik,1929,0,,180,0
Litnik,1929,0,,181,0
Litnik,1929,0,,182,0
Litnik,1929,0,,183,0
Litnik,1929,0,,184,0
Litnik,1929,0,,185,0
Litnik,1929,0,,186,0
Litnik,1929,0,,187,0
Litnik,1929,0,,188,0
Litnik,1929,0,,189,0
Litnik,1929,0,,190,0
Litnik,1929,0,,191,0
Litnik,1929,0,,192,0
Litnik,1929,0,,193,0
Litnik,1929,0,,194,0
Litnik,1929,0,,195,0
Litnik,1929,0,,196,0
Litnik,1929,0,,197,0
Litnik,1929,0,,198,0
Litnik,1929,0,,199,0
Litnik,1929,0,,200,0
Litnik,1929,0,,201,0
Litnik,1929,0,,202,0
Litnik,1929,0,,203,0
Litnik,1929,0,,204,0
Litnik,1929,0,,205,0
Litnik,1929,0,,206,0
Litnik,1929,0,,207,0
Litnik,1929,0,,208,0
Litnik,1929,2,,209,2
Litnik,1929,7,,210,9
Litnik,1929,14,,211,23
Litnik,1929,11,,212,34
Litnik,1929,5,,213,39
Litnik,1929,7,,214,46
Litnik,1929,9,,215,55
Litnik,1929,0,,216,55
Litnik,1929,11,,217,66
Litnik,1929,8,,218,74
Litnik,1929,0,,219,74
Litnik,1929,0,,220,74
Litnik,1929,0,,221,74
Litnik,1929,0,,222,74
Litnik,1929,0,,223,74
Litnik,1929,17,,224,91
Litnik,1929,0,,225,91
Litnik,1929,0,,226,91
Litnik,1929,0,,227,91
Litnik,1929,0,,228,91
Litnik,1929,0,,229,91
Litnik,1929,0,,230,91
Litnik,1929,22,,231,113
Litnik,1929,14,,232,127
Litnik,1929,0,,233,127
Litnik,1929,0,,234,127
Litnik,1929,0,,235,127
Litnik,1929,0,,236,127
Litnik,1929,0,,237,127
Litnik,1929,20,,238,147
Litnik,1929,0,,239,147
Litnik,1929,14,,240,161
Litnik,1929,12,,241,173
Litnik,1929,0,,242,173
Litnik,1929,7,,243,180
Litnik,1929,0,,244,180
Litnik,1929,0,,245,180
Litnik,1929,0,,246,180
Litnik,1929,0,,247,180
Litnik,1929,0,,248,180
Litnik,1929,0,,249,180
Litnik,1929,0,,250,180
Litnik,1929,0,,251,180
Litnik,1929,0,,252,180
Litnik,1929,0,,253,180
Litnik,1929,0,,254,180
Litnik,1929,0,,255,180
Litnik,1929,0,,256,180
Litnik,1929,0,,257,180
Litnik,1929,0,,258,180
Litnik,1929,0,,259,180
Litnik,1929,0,,260,180
Litnik,1929,0,,261,180
Litnik,1929,0,,262,180
Litnik,1929,0,,263,180
Litnik,1929,0,,264,180
Litnik,1929,0,,265,180
Litnik,1929,0,,266,180
Litnik,1929,0,,267,180
Litnik,1929,0,,268,180
Litnik,1929,0,,269,180
Litnik,1929,0,,270,180
Litnik,1929,0,,271,180
Litnik,1929,0,,272,180
Litnik,1929,0,,273,180
Litnik,1928,0,,175,0
Litnik,1928,0,,176,0
Litnik,1928,0,,177,0
Litnik,1928,0,,178,0
Litnik,1928,0,,179,0
Litnik,1928,0,,180,0
Litnik,1928,0,,181,0
Litnik,1928,0,,182,0
Litnik,1928,0,,183,0
Litnik,1928,0,,184,0
Litnik,1928,0,,185,0
Litnik,1928,0,,186,0
Litnik,1928,0,,187,0
Litnik,1928,0,,188,0
Litnik,1928,0,,189,0
Litnik,1928,0,,190,0
Litnik,1928,0,,191,0
Litnik,1928,0,,192,0
Litnik,1928,0,,193,0
Litnik,1928,0,,194,0
Litnik,1928,0,,195,0
Litnik,1928,0,,196,0
Litnik,1928,0,,197,0
Litnik,1928,0,,198,0
Litnik,1928,0,,199,0
Litnik,1928,0,,200,0
Litnik,1928,0,,201,0
Litnik,1928,0,,202,0
Litnik,1928,0,,203,0
Litnik,1928,0,,204,0
Litnik,1928,0,,205,0
Litnik,1928,0,,206,0
Litnik,1928,0,,207,0
Litnik,1928,0,,208,0
Litnik,1928,0,,209,0
Litnik,1928,0,,210,0
Litnik,1928,0,,211,0
Litnik,1928,0,,212,0
Litnik,1928,0,,213,0
Litnik,1928,0,,214,0
Litnik,1928,0,,215,0
Litnik,1928,0,,216,0
Litnik,1928,0,,217,0
Litnik,1928,23,,218,23
Litnik,1928,34,,219,57
Litnik,1928,13,,220,70
Litnik,1928,48,,221,118
Litnik,1928,0,,222,118
Litnik,1928,0,,223,118
Litnik,1928,16,,224,134
Litnik,1928,0,,225,134
Litnik,1928,0,,226,134
Litnik,1928,10,,227,144
Litnik,1928,0,,228,144
Litnik,1928,0,,229,144
Litnik,1928,0,,230,144
Litnik,1928,0,,231,144
Litnik,1928,0,,232,144
Litnik,1928,0,,233,144
Litnik,1928,0,,234,144
Litnik,1928,0,,235,144
Litnik,1928,0,,236,144
Litnik,1928,0,,237,144
Litnik,1928,0,,238,144
Litnik,1928,0,,239,144
Litnik,1928,0,,240,144
Litnik,1928,0,,241,144
Litnik,1928,0,,242,144
Litnik,1928,0,,243,144
Litnik,1928,0,,244,144
Litnik,1928,0,,245,144
Litnik,1928,0,,246,144
Litnik,1928,0,,247,144
Litnik,1928,0,,248,144
Litnik,1928,0,,249,144
Litnik,1928,0,,250,144
Litnik,1928,0,,251,144
Litnik,1928,0,,252,144
Litnik,1928,0,,253,144
Litnik,1928,0,,254,144
Litnik,1928,0,,255,144
Litnik,1928,0,,256,144
Litnik,1928,0,,257,144
Litnik,1928,0,,258,144
Litnik,1928,0,,259,144
Litnik,1928,0,,260,144
Litnik,1928,0,,261,144
Litnik,1928,0,,262,144
Litnik,1928,0,,263,144
Litnik,1928,0,,264,144
Litnik,1928,0,,265,144
Litnik,1928,0,,266,144
Litnik,1928,0,,267,144
Litnik,1928,0,,268,144
Litnik,1928,0,,269,144
Litnik,1928,0,,270,144
Litnik,1928,0,,271,144
Litnik,1928,0,,272,144
Litnik,1928,0,,273,144
Litnik,1928,0,,274,144
Litnik,1927,0,,174,0
Litnik,1927,0,,175,0
Litnik,1927,0,,176,0
Litnik,1927,0,,177,0
Litnik,1927,0,,178,0
Litnik,1927,0,,179,0
Litnik,1927,0,,180,0
Litnik,1927,0,,181,0
Litnik,1927,0,,182,0
Litnik,1927,0,,183,0
Litnik,1927,0,,184,0
Litnik,1927,0,,185,0
Litnik,1927,0,,186,0
Litnik,1927,0,,187,0
Litnik,1927,0,,188,0
Litnik,1927,0,,189,0
Litnik,1927,0,,190,0
Litnik,1927,0,,191,0
Litnik,1927,0,,192,0
Litnik,1927,0,,193,0
Litnik,1927,0,,194,0
Litnik,1927,0,,195,0
Litnik,1927,109,,196,109
Litnik,1927,37,,197,146
Litnik,1927,21,,198,167
Litnik,1927,40,,199,207
Litnik,1927,7,,200,214
Litnik,1927,3,,201,217
Litnik,1927,24,,202,241
Litnik,1927,1,,203,242
Litnik,1927,0,,204,242
Litnik,1927,0,,205,242
Litnik,1927,0,,206,242
Litnik,1927,0,,207,242
Litnik,1927,0,,208,242
Litnik,1927,28,,209,270
Litnik,1927,0,,210,270
Litnik,1927,0,,211,270
Litnik,1927,0,,212,270
Litnik,1927,0,,213,270
Litnik,1927,0,,214,270
Litnik,1927,0,,215,270
Litnik,1927,0,,216,270
Litnik,1927,169,,217,439
Litnik,1927,116,,218,555
Litnik,1927,2,,219,557
Litnik,1927,115,,220,672
Litnik,1927,32,,221,704
Litnik,1927,13,,222,717
Litnik,1927,11,,223,728
Litnik,1927,0,,224,728
Litnik,1927,20,,225,748
Litnik,1927,0,,226,748
Litnik,1927,35,,227,783
Litnik,1927,36,,228,819
Litnik,1927,0,,229,819
Litnik,1927,50,,230,869
Litnik,1927,81,,231,950
Litnik,1927,53,,232,1003
Litnik,1927,17,,233,1020
Litnik,1927,10,,234,1030
Litnik,1927,10,,235,1040
Litnik,1927,0,,236,1040
Litnik,1927,0,,237,1040
Litnik,1927,0,,238,1040
Litnik,1927,0,,239,1040
Litnik,1927,0,,240,1040
Litnik,1927,0,,241,1040
Litnik,1927,0,,242,1040
Litnik,1927,0,,243,1040
Litnik,1927,0,,244,1040
Litnik,1927,0,,245,1040
Litnik,1927,0,,246,1040
Litnik,1927,0,,247,1040
Litnik,1927,0,,248,1040
Litnik,1927,0,,249,1040
Litnik,1927,0,,250,1040
Litnik,1927,0,,251,1040
Litnik,1927,0,,252,1040
Litnik,1927,0,,253,1040
Litnik,1927,0,,254,1040
Litnik,1927,0,,255,1040
Litnik,1927,0,,256,1040
Litnik,1927,0,,257,1040
Litnik,1927,0,,258,1040
Litnik,1927,0,,259,1040
Litnik,1927,0,,260,1040
Litnik,1927,0,,261,1040
Litnik,1927,0,,262,1040
Litnik,1927,0,,263,1040
Litnik,1927,0,,264,1040
Litnik,1927,0,,265,1040
Litnik,1927,0,,266,1040
Litnik,1927,0,,267,1040
Litnik,1927,0,,268,1040
Litnik,1927,0,,269,1040
Litnik,1927,0,,270,1040
Litnik,1927,0,,271,1040
Litnik,1927,0,,272,1040
Litnik,1927,0,,273,1040
Litnik,1926,0,,174,0
Litnik,1926,0,,175,0
Litnik,1926,0,,176,0
Litnik,1926,0,,177,0
Litnik,1926,0,,178,0
Litnik,1926,0,,179,0
Litnik,1926,0,,180,0
Litnik,1926,0,,181,0
Litnik,1926,0,,182,0
Litnik,1926,0,,183,0
Litnik,1926,0,,184,0
Litnik,1926,0,,185,0
Litnik,1926,0,,186,0
Litnik,1926,0,,187,0
Litnik,1926,0,,188,0
Litnik,1926,0,,189,0
Litnik,1926,0,,190,0
Litnik,1926,0,,191,0
Litnik,1926,0,,192,0
Litnik,1926,0,,193,0
Litnik,1926,0,,194,0
Litnik,1926,0,,195,0
Litnik,1926,0,,196,0
Litnik,1926,0,,197,0
Litnik,1926,0,,198,0
Litnik,1926,0,,199,0
Litnik,1926,0,,200,0
Litnik,1926,0,,201,0
Litnik,1926,0,,202,0
Litnik,1926,0,,203,0
Litnik,1926,0,,204,0
Litnik,1926,0,,205,0
Litnik,1926,0,,206,0
Litnik,1926,0,,207,0
Litnik,1926,0,,208,0
Litnik,1926,0,,209,0
Litnik,1926,0,,210,0
Litnik,1926,0,,211,0
Litnik,1926,0,,212,0
Litnik,1926,0,,213,0
Litnik,1926,0,,214,0
Litnik,1926,0,,215,0
Litnik,1926,0,,216,0
Litnik,1926,0,,217,0
Litnik,1926,20,,218,20
Litnik,1926,0,,219,20
Litnik,1926,0,,220,20
Litnik,1926,253,,221,273
Litnik,1926,653,,222,926
Litnik,1926,753,,223,1679
Litnik,1926,0,,224,1679
Litnik,1926,0,,225,1679
Litnik,1926,0,,226,1679
Litnik,1926,0,,227,1679
Litnik,1926,228,,228,1907
Litnik,1926,0,,229,1907
Litnik,1926,343,,230,2250
Litnik,1926,641,,231,2891
Litnik,1926,207,,232,3098
Litnik,1926,0,,233,3098
Litnik,1926,489,,234,3587
Litnik,1926,0,,235,3587
Litnik,1926,437,,236,4024
Litnik,1926,0,,237,4024
Litnik,1926,328,,238,4352
Litnik,1926,0,,239,4352
Litnik,1926,281,,240,4633
Litnik,1926,0,,241,4633
Litnik,1926,0,,242,4633
Litnik,1926,0,,243,4633
Litnik,1926,0,,244,4633
Litnik,1926,0,,245,4633
Litnik,1926,0,,246,4633
Litnik,1926,0,,247,4633
Litnik,1926,0,,248,4633
Litnik,1926,0,,249,4633
Litnik,1926,0,,250,4633
Litnik,1926,0,,251,4633
Litnik,1926,0,,252,4633
Litnik,1926,0,,253,4633
Litnik,1926,0,,254,4633
Litnik,1926,0,,255,4633
Litnik,1926,0,,256,4633
Litnik,1926,0,,257,4633
Litnik,1926,0,,258,4633
Litnik,1926,0,,259,4633
Litnik,1926,0,,260,4633
Litnik,1926,0,,261,4633
Litnik,1926,0,,262,4633
Litnik,1926,0,,263,4633
Litnik,1926,0,,264,4633
Litnik,1926,0,,265,4633
Litnik,1926,0,,266,4633
Litnik,1926,0,,267,4633
Litnik,1926,0,,268,4633
Litnik,1926,0,,269,4633
Litnik,1926,0,,270,4633
Litnik,1926,0,,271,4633
Litnik,1926,0,,272,4633
Litnik,1926,0,,273,4633
Buskin,2012,0,,174,0
Buskin,2012,0,,175,0
Buskin,2012,0,,176,0
Buskin,2012,0,,177,0
Buskin,2012,0,,178,0
Buskin,2012,0,,179,0
Buskin,2012,0,,180,0
Buskin,2012,0,,181,0
Buskin,2012,0,,182,0
Buskin,2012,0,,183,0
Buskin,2012,0,,184,0
Buskin,2012,0,,185,0
Buskin,2012,0,,186,0
Buskin,2012,1,,187,1
Buskin,2012,0,,188,1
Buskin,2012,0,,189,1
Buskin,2012,0,,190,1
Buskin,2012,0,,191,1
Buskin,2012,0,,192,1
Buskin,2012,0,,193,1
Buskin,2012,0,,194,1
Buskin,2012,0,,195,1
Buskin,2012,0,,196,1
Buskin,2012,0,,197,1
Buskin,2012,2,,198,3
Buskin,2012,1,,199,4
Buskin,2012,2,,200,6
Buskin,2012,3,,201,9
Buskin,2012,11,,202,20
Buskin,2012,0,,203,20
Buskin,2012,3,,204,23
Buskin,2012,114,,205,137
Buskin,2012,89,,206,226
Buskin,2012,70,,207,296
Buskin,2012,105,,208,401
Buskin,2012,159,,209,560
Buskin,2012,197,,210,757
Buskin,2012,26,,211,783
Buskin,2012,56,,212,839
Buskin,2012,83,,213,922
Buskin,2012,8,,214,930
Buskin,2012,12,,215,942
Buskin,2012,28,,216,970
Buskin,2012,75,,217,1045
Buskin,2012,142,,218,1187
Buskin,2012,59,,219,1246
Buskin,2012,34,,220,1280
Buskin,2012,21,,221,1301
Buskin,2012,69,,222,1370
Buskin,2012,81,,223,1451
Buskin,2012,1408,,224,2859
Buskin,2012,2881,,225,5740
Buskin,2012,811,,226,6551
Buskin,2012,785,,227,7336
Buskin,2012,57602,,228,64938
Buskin,2012,151,,229,65089
Buskin,2012,339,,230,65428
Buskin,2012,46,,231,65474
Buskin,2012,736,,232,66210
Buskin,2012,231,,233,66441
Buskin,2012,99,,234,66540
Buskin,2012,51,,235,66591
Buskin,2012,20,,236,66611
Buskin,2012,100,,237,66711
Buskin,2012,70,,238,66781
Buskin,2012,207,,239,66988
Buskin,2012,361,,240,67349
Buskin,2012,373,,241,67722
Buskin,2012,451,,242,68173
Buskin,2012,2044,,243,70217
Buskin,2012,522,,244,70739
Buskin,2012,921,,245,71660
Buskin,2012,167,,246,71827
Buskin,2012,989,,247,72816
Buskin,2012,903,,248,73719
Buskin,2012,597,,249,74316
Buskin,2012,425,,250,74741
Buskin,2012,381,,251,75122
Buskin,2012,245,,252,75367
Buskin,2012,533,,253,75900
Buskin,2012,376,,254,76276
Buskin,2012,1739,,255,78015
Buskin,2012,840,,256,78855
Buskin,2012,75,,257,78930
Buskin,2012,101,,258,79031
Buskin,2012,1538,,259,80569
Buskin,2012,195,,260,80764
Buskin,2012,63,,261,80827
Buskin,2012,154,,262,80981
Buskin,2012,193,,263,81174
Buskin,2012,48,,264,81222
Buskin,2012,12,,265,81234
Buskin,2012,0,,266,81234
Buskin,2012,0,,267,81234
Buskin,2012,0,,268,81234
Buskin,2012,0,,269,81234
Buskin,2012,0,,270,81234
Buskin,2012,0,,271,81234
Buskin,2012,0,,272,81234
Buskin,2012,0,,273,81234
Buskin,2012,0,,274,81234
Buskin,2012,0,,275,81234
Buskin,2012,0,,276,81234
Buskin,2012,0,,277,81234
Buskin,2012,0,,278,81234
Buskin,2012,0,,279,81234
Buskin,2012,0,,280,81234
Buskin,2012,0,,281,81234
Buskin,2012,0,,282,81234
Buskin,2011,0,,173,0
Buskin,2011,0,,174,0
Buskin,2011,0,,175,0
Buskin,2011,0,,176,0
Buskin,2011,0,,177,0
Buskin,2011,0,,178,0
Buskin,2011,0,,179,0
Buskin,2011,0,,180,0
Buskin,2011,0,,181,0
Buskin,2011,0,,182,0
Buskin,2011,0,,183,0
Buskin,2011,0,,184,0
Buskin,2011,0,,185,0
Buskin,2011,0,,186,0
Buskin,2011,0,,187,0
Buskin,2011,0,,188,0
Buskin,2011,0,,189,0
Buskin,2011,0,,190,0
Buskin,2011,0,,191,0
Buskin,2011,0,,192,0
Buskin,2011,0,,193,0
Buskin,2011,0,,194,0
Buskin,2011,0,,195,0
Buskin,2011,0,,196,0
Buskin,2011,1,,197,1
Buskin,2011,0,,198,1
Buskin,2011,0,,199,1
Buskin,2011,1,,200,2
Buskin,2011,0,,201,2
Buskin,2011,0,,202,2
Buskin,2011,3,,203,5
Buskin,2011,0,,204,5
Buskin,2011,0,,205,5
Buskin,2011,2,,206,7
Buskin,2011,3,,207,10
Buskin,2011,1,,208,11
Buskin,2011,1,,209,12
Buskin,2011,0,,210,12
Buskin,2011,2,,211,14
Buskin,2011,5,,212,19
Buskin,2011,13,,213,32
Buskin,2011,34,,214,66
Buskin,2011,11,,215,77
Buskin,2011,11,,216,88
Buskin,2011,14,,217,102
Buskin,2011,3,,218,105
Buskin,2011,1,,219,106
Buskin,2011,17,,220,123
Buskin,2011,7,,221,130
Buskin,2011,12,,222,142
Buskin,2011,4,,223,146
Buskin,2011,8,,224,154
Buskin,2011,9,,225,163
Buskin,2011,78,,226,241
Buskin,2011,36,,227,277
Buskin,2011,32,,228,309
Buskin,2011,49,,229,358
Buskin,2011,4024,,230,4382
Buskin,2011,511,,231,4893
Buskin,2011,232,,232,5125
Buskin,2011,52,,233,5177
Buskin,2011,198,,234,5375
Buskin,2011,75,,235,5450
Buskin,2011,83,,236,5533
Buskin,2011,1415,,237,6948
Buskin,2011,916,,238,7864
Buskin,2011,163,,239,8027
Buskin,2011,469,,240,8496
Buskin,2011,78,,241,8574
Buskin,2011,190,,242,8764
Buskin,2011,128,,243,8892
Buskin,2011,183,,244,9075
Buskin,2011,4,,245,9079
Buskin,2011,7,,246,9086
Buskin,2011,123,,247,9209
Buskin,2011,9,,248,9218
Buskin,2011,0,,249,9218
Buskin,2011,141,,250,9359
Buskin,2011,70,,251,9429
Buskin,2011,48,,252,9477
Buskin,2011,55,,253,9532
Buskin,2011,22,,254,9554
Buskin,2011,0,,255,9554
Buskin,2011,0,,256,9554
Buskin,2011,18,,257,9572
Buskin,2011,0,,258,9572
Buskin,2011,0,,259,9572
Buskin,2011,0,,260,9572
Buskin,2011,0,,261,9572
Buskin,2011,0,,262,9572
Buskin,2011,0,,263,9572
Buskin,2011,0,,264,9572
Buskin,2011,0,,265,9572
Buskin,2011,0,,266,9572
Buskin,2011,0,,267,9572
Buskin,2011,0,,268,9572
Buskin,2011,0,,269,9572
Buskin,2011,0,,270,9572
Buskin,2011,0,,271,9572
Buskin,2011,0,,272,9572
Buskin,2011,0,,273,9572
Buskin,2011,0,,274,9572
Buskin,2011,0,,275,9572
Buskin,2011,0,,276,9572
Buskin,2011,0,,277,9572
Buskin,2011,0,,278,9572
Buskin,2011,0,,279,9572
Buskin,2011,0,,280,9572
Buskin,2011,0,,281,9572
Buskin,2010,0,,173,0
Buskin,2010,0,,174,0
Buskin,2010,0,,175,0
Buskin,2010,0,,176,0
Buskin,2010,0,,177,0
Buskin,2010,0,,178,0
Buskin,2010,0,,179,0
Buskin,2010,0,,180,0
Buskin,2010,0,,181,0
Buskin,2010,0,,182,0
Buskin,2010,0,,183,0
Buskin,2010,0,,184,0
Buskin,2010,0,,185,0
Buskin,2010,0,,186,0
Buskin,2010,0,,187,0
Buskin,2010,0,,188,0
Buskin,2010,0,,189,0
Buskin,2010,0,,190,0
Buskin,2010,0,,191,0
Buskin,2010,0,,192,0
Buskin,2010,0,,193,0
Buskin,2010,0,,194,0
Buskin,2010,0,,195,0
Buskin,2010,0,,196,0
Buskin,2010,0,,197,0
Buskin,2010,1,,198,1
Buskin,2010,0,,199,1
Buskin,2010,0,,200,1
Buskin,2010,0,,201,1
Buskin,2010,0,,202,1
Buskin,2010,23,,203,24
Buskin,2010,1,,204,25
Buskin,2010,0,,205,25
Buskin,2010,0,,206,25
Buskin,2010,35,,207,60
Buskin,2010,7,,208,67
Buskin,2010,0,,209,67
Buskin,2010,1,,210,68
Buskin,2010,52,,211,120
Buskin,2010,517,,212,637
Buskin,2010,289,,213,926
Buskin,2010,452,,214,1378
Buskin,2010,119,,215,1497
Buskin,2010,145,,216,1642
Buskin,2010,240,,217,1882
Buskin,2010,268,,218,2150
Buskin,2010,670,,219,2820
Buskin,2010,142,,220,2962
Buskin,2010,774,,221,3736
Buskin,2010,1175,,222,4911
Buskin,2010,295,,223,5206
Buskin,2010,274,,224,5480
Buskin,2010,295,,225,5775
Buskin,2010,301,,226,6076
Buskin,2010,0,,227,6076
Buskin,2010,0,,228,6076
Buskin,2010,171,,229,6247
Buskin,2010,137,,230,6384
Buskin,2010,112,,231,6496
Buskin,2010,50,,232,6546
Buskin,2010,71,,233,6617
Buskin,2010,260,,234,6877
Buskin,2010,50,,235,6927
Buskin,2010,240,,236,7167
Buskin,2010,195,,237,7362
Buskin,2010,356,,238,7718
Buskin,2010,261,,239,7979
Buskin,2010,388,,240,8367
Buskin,2010,498,,241,8865
Buskin,2010,635,,242,9500
Buskin,2010,1053,,243,10553
Buskin,2010,881,,244,11434
Buskin,2010,715,,245,12149
Buskin,2010,506,,246,12655
Buskin,2010,1732,,247,14387
Buskin,2010,617,,248,15004
Buskin,2010,154,,249,15158
Buskin,2010,238,,250,15396
Buskin,2010,75,,251,15471
Buskin,2010,173,,252,15644
Buskin,2010,37,,253,15681
Buskin,2010,32,,254,15713
Buskin,2010,18,,255,15731
Buskin,2010,7,,256,15738
Buskin,2010,22,,257,15760
Buskin,2010,3,,258,15763
Buskin,2010,8,,259,15771
Buskin,2010,0,,260,15771
Buskin,2010,3,,261,15774
Buskin,2010,5,,262,15779
Buskin,2010,0,,263,15779
Buskin,2010,0,,264,15779
Buskin,2010,0,,265,15779
Buskin,2010,0,,266,15779
Buskin,2010,2,,267,15781
Buskin,2010,0,,268,15781
Buskin,2010,0,,269,15781
Buskin,2010,0,,270,15781
Buskin,2010,0,,271,15781
Buskin,2010,0,,272,15781
Buskin,2010,0,,273,15781
Buskin,2010,0,,274,15781
Buskin,2010,0,,275,15781
Buskin,2010,0,,276,15781
Buskin,2010,0,,277,15781
Buskin,2010,0,,278,15781
Buskin,2010,0,,279,15781
Buskin,2010,0,,280,15781
Buskin,2010,0,,281,15781
Buskin,2009,0,,173,0
Buskin,2009,0,,174,0
Buskin,2009,0,,175,0
Buskin,2009,0,,176,0
Buskin,2009,0,,177,0
Buskin,2009,0,,178,0
Buskin,2009,0,,179,0
Buskin,2009,0,,180,0
Buskin,2009,0,,181,0
Buskin,2009,0,,182,0
Buskin,2009,0,,183,0
Buskin,2009,0,,184,0
Buskin,2009,0,,185,0
Buskin,2009,0,,186,0
Buskin,2009,0,,187,0
Buskin,2009,0,,188,0
Buskin,2009,0,,189,0
Buskin,2009,0,,190,0
Buskin,2009,0,,191,0
Buskin,2009,0,,192,0
Buskin,2009,0,,193,0
Buskin,2009,0,,194,0
Buskin,2009,0,,195,0
Buskin,2009,0,,196,0
Buskin,2009,0,,197,0
Buskin,2009,0,,198,0
Buskin,2009,0,,199,0
Buskin,2009,0,,200,0
Buskin,2009,0,,201,0
Buskin,2009,4,,202,4
Buskin,2009,5,,203,9
Buskin,2009,1,,204,10
Buskin,2009,0,,205,10
Buskin,2009,14,,206,24
Buskin,2009,17,,207,41
Buskin,2009,11,,208,52
Buskin,2009,36,,209,88
Buskin,2009,80,,210,168
Buskin,2009,115,,211,283
Buskin,2009,720,,212,1003
Buskin,2009,220,,213,1223
Buskin,2009,8,,214,1231
Buskin,2009,7130,,215,8361
Buskin,2009,368,,216,8729
Buskin,2009,197,,217,8926
Buskin,2009,2088,,218,11014
Buskin,2009,11986,,219,23000
Buskin,2009,6919,,220,29919
Buskin,2009,7286,,221,37205
Buskin,2009,1819,,222,39024
Buskin,2009,4238,,223,43262
Buskin,2009,5300,,224,48562
Buskin,2009,1853,,225,50415
Buskin,2009,2213,,226,52628
Buskin,2009,2581,,227,55209
Buskin,2009,2154,,228,57363
Buskin,2009,2210,,229,59573
Buskin,2009,1871,,230,61444
Buskin,2009,2189,,231,63633
Buskin,2009,1308,,232,64941
Buskin,2009,1206,,233,66147
Buskin,2009,1025,,234,67172
Buskin,2009,1510,,235,68682
Buskin,2009,422,,236,69104
Buskin,2009,1171,,237,70275
Buskin,2009,2409,,238,72684
Buskin,2009,6958,,239,79642
Buskin,2009,0,,240,79642
Buskin,2009,0,,241,79642
Buskin,2009,626,,242,80268
Buskin,2009,1589,,243,81857
Buskin,2009,1107,,244,82964
Buskin,2009,1210,,245,84174
Buskin,2009,1662,,246,85836
Buskin,2009,1843,,247,87679
Buskin,2009,579,,248,88258
Buskin,2009,526,,249,88784
Buskin,2009,458,,250,89242
Buskin,2009,459,,251,89701
Buskin,2009,0,,252,89701
Buskin,2009,0,,253,89701
Buskin,2009,0,,254,89701
Buskin,2009,0,,255,89701
Buskin,2009,30,,256,89731
Buskin,2009,34,,257,89765
Buskin,2009,79,,258,89844
Buskin,2009,0,,259,89844
Buskin,2009,0,,260,89844
Buskin,2009,0,,261,89844
Buskin,2009,0,,262,89844
Buskin,2009,0,,263,89844
Buskin,2009,0,,264,89844
Buskin,2009,0,,265,89844
Buskin,2009,0,,266,89844
Buskin,2009,0,,267,89844
Buskin,2009,0,,268,89844
Buskin,2009,0,,269,89844
Buskin,2009,0,,270,89844
Buskin,2009,0,,271,89844
Buskin,2009,0,,272,89844
Buskin,2009,0,,273,89844
Buskin,2009,0,,274,89844
Buskin,2009,0,,275,89844
Buskin,2009,0,,276,89844
Buskin,2009,0,,277,89844
Buskin,2009,0,,278,89844
Buskin,2009,0,,279,89844
Buskin,2009,0,,280,89844
Buskin,2009,0,,281,89844
Buskin,2008,0,,174,0
Buskin,2008,0,,175,0
Buskin,2008,0,,176,0
Buskin,2008,0,,177,0
Buskin,2008,0,,178,0
Buskin,2008,0,,179,0
Buskin,2008,0,,180,0
Buskin,2008,0,,181,0
Buskin,2008,0,,182,0
Buskin,2008,0,,183,0
Buskin,2008,0,,184,0
Buskin,2008,0,,185,0
Buskin,2008,0,,186,0
Buskin,2008,0,,187,0
Buskin,2008,0,,188,0
Buskin,2008,0,,189,0
Buskin,2008,0,,190,0
Buskin,2008,0,,191,0
Buskin,2008,0,,192,0
Buskin,2008,0,,193,0
Buskin,2008,0,,194,0
Buskin,2008,0,,195,0
Buskin,2008,0,,196,0
Buskin,2008,0,,197,0
Buskin,2008,0,,198,0
Buskin,2008,0,,199,0
Buskin,2008,0,,200,0
Buskin,2008,0,,201,0
Buskin,2008,0,,202,0
Buskin,2008,0,,203,0
Buskin,2008,0,,204,0
Buskin,2008,0,,205,0
Buskin,2008,17,,206,17
Buskin,2008,9,,207,26
Buskin,2008,5,,208,31
Buskin,2008,2,,209,33
Buskin,2008,1,,210,34
Buskin,2008,1887,,211,1921
Buskin,2008,332,,212,2253
Buskin,2008,1520,,213,3773
Buskin,2008,1004,,214,4777
Buskin,2008,1066,,215,5843
Buskin,2008,1376,,216,7219
Buskin,2008,1847,,217,9066
Buskin,2008,3047,,218,12113
Buskin,2008,1982,,219,14095
Buskin,2008,1164,,220,15259
Buskin,2008,1387,,221,16646
Buskin,2008,339,,222,16985
Buskin,2008,933,,223,17918
Buskin,2008,2932,,224,20850
Buskin,2008,2720,,225,23570
Buskin,2008,29,,226,23599
Buskin,2008,5843,,227,29442
Buskin,2008,758,,228,30200
Buskin,2008,1632,,229,31832
Buskin,2008,371,,230,32203
Buskin,2008,179,,231,32382
Buskin,2008,0,,232,32382
Buskin,2008,0,,233,32382
Buskin,2008,312,,234,32694
Buskin,2008,154,,235,32848
Buskin,2008,791,,236,33639
Buskin,2008,294,,237,33933
Buskin,2008,497,,238,34430
Buskin,2008,356,,239,34786
Buskin,2008,411,,240,35197
Buskin,2008,347,,241,35544
Buskin,2008,372,,242,35916
Buskin,2008,538,,243,36454
Buskin,2008,2362,,244,38816
Buskin,2008,1848,,245,40664
Buskin,2008,820,,246,41484
Buskin,2008,568,,247,42052
Buskin,2008,342,,248,42394
Buskin,2008,201,,249,42595
Buskin,2008,72,,250,42667
Buskin,2008,0,,251,42667
Buskin,2008,0,,252,42667
Buskin,2008,87,,253,42754
Buskin,2008,81,,254,42835
Buskin,2008,59,,255,42894
Buskin,2008,61,,256,42955
Buskin,2008,88,,257,43043
Buskin,2008,38,,258,43081
Buskin,2008,9,,259,43090
Buskin,2008,20,,260,43110
Buskin,2008,3,,261,43113
Buskin,2008,26,,262,43139
Buskin,2008,5,,263,43144
Buskin,2008,7,,264,43151
Buskin,2008,4,,265,43155
Buskin,2008,4,,266,43159
Buskin,2008,7,,267,43166
Buskin,2008,1,,268,43167
Buskin,2008,0,,269,43167
Buskin,2008,0,,270,43167
Buskin,2008,0,,271,43167
Buskin,2008,0,,272,43167
Buskin,2008,0,,273,43167
Buskin,2008,0,,274,43167
Buskin,2008,0,,275,43167
Buskin,2008,0,,276,43167
Buskin,2008,0,,277,43167
Buskin,2008,0,,278,43167
Buskin,2008,0,,279,43167
Buskin,2008,0,,280,43167
Buskin,2008,0,,281,43167
Buskin,2008,0,,282,43167
Buskin,2007,0,,173,0
Buskin,2007,0,,174,0
Buskin,2007,0,,175,0
Buskin,2007,0,,176,0
Buskin,2007,0,,177,0
Buskin,2007,0,,178,0
Buskin,2007,0,,179,0
Buskin,2007,0,,180,0
Buskin,2007,0,,181,0
Buskin,2007,0,,182,0
Buskin,2007,0,,183,0
Buskin,2007,0,,184,0
Buskin,2007,0,,185,0
Buskin,2007,0,,186,0
Buskin,2007,0,,187,0
Buskin,2007,1,,188,1
Buskin,2007,0,,189,1
Buskin,2007,2,,190,3
Buskin,2007,0,,191,3
Buskin,2007,2,,192,5
Buskin,2007,4,,193,9
Buskin,2007,0,,194,9
Buskin,2007,0,,195,9
Buskin,2007,0,,196,9
Buskin,2007,2,,197,11
Buskin,2007,0,,198,11
Buskin,2007,1,,199,12
Buskin,2007,0,,200,12
Buskin,2007,1,,201,13
Buskin,2007,11,,202,24
Buskin,2007,43,,203,67
Buskin,2007,22,,204,89
Buskin,2007,7,,205,96
Buskin,2007,0,,206,96
Buskin,2007,0,,207,96
Buskin,2007,0,,208,96
Buskin,2007,12,,209,108
Buskin,2007,86,,210,194
Buskin,2007,22,,211,216
Buskin,2007,40,,212,256
Buskin,2007,6,,213,262
Buskin,2007,135,,214,397
Buskin,2007,9766,,215,10163
Buskin,2007,2905,,216,13068
Buskin,2007,4003,,217,17071
Buskin,2007,4956,,218,22027
Buskin,2007,3100,,219,25127
Buskin,2007,3781,,220,28908
Buskin,2007,4743,,221,33651
Buskin,2007,5766,,222,39417
Buskin,2007,3269,,223,42686
Buskin,2007,3882,,224,46568
Buskin,2007,2290,,225,48858
Buskin,2007,3435,,226,52293
Buskin,2007,1934,,227,54227
Buskin,2007,597,,228,54824
Buskin,2007,1112,,229,55936
Buskin,2007,3759,,230,59695
Buskin,2007,2282,,231,61977
Buskin,2007,457,,232,62434
Buskin,2007,849,,233,63283
Buskin,2007,533,,234,63816
Buskin,2007,900,,235,64716
Buskin,2007,815,,236,65531
Buskin,2007,1081,,237,66612
Buskin,2007,825,,238,67437
Buskin,2007,5004,,239,72441
Buskin,2007,0,,240,72441
Buskin,2007,0,,241,72441
Buskin,2007,1127,,242,73568
Buskin,2007,1107,,243,74675
Buskin,2007,1702,,244,76377
Buskin,2007,534,,245,76911
Buskin,2007,1557,,246,78468
Buskin,2007,1912,,247,80380
Buskin,2007,1168,,248,81548
Buskin,2007,1211,,249,82759
Buskin,2007,763,,250,83522
Buskin,2007,1210,,251,84732
Buskin,2007,531,,252,85263
Buskin,2007,505,,253,85768
Buskin,2007,903,,254,86671
Buskin,2007,844,,255,87515
Buskin,2007,242,,256,87757
Buskin,2007,239,,257,87996
Buskin,2007,197,,258,88193
Buskin,2007,167,,259,88360
Buskin,2007,72,,260,88432
Buskin,2007,96,,261,88528
Buskin,2007,84,,262,88612
Buskin,2007,36,,263,88648
Buskin,2007,29,,264,88677
Buskin,2007,18,,265,88695
Buskin,2007,76,,266,88771
Buskin,2007,37,,267,88808
Buskin,2007,21,,268,88829
Buskin,2007,22,,269,88851
Buskin,2007,27,,270,88878
Buskin,2007,11,,271,88889
Buskin,2007,5,,272,88894
Buskin,2007,0,,273,88894
Buskin,2007,0,,274,88894
Buskin,2007,0,,275,88894
Buskin,2007,0,,276,88894
Buskin,2007,0,,277,88894
Buskin,2007,0,,278,88894
Buskin,2007,0,,279,88894
Buskin,2007,0,,280,88894
Buskin,2007,0,,281,88894
Buskin,2006,0,,173,0
Buskin,2006,0,,174,0
Buskin,2006,0,,175,0
Buskin,2006,0,,176,0
Buskin,2006,0,,177,0
Buskin,2006,0,,178,0
Buskin,2006,0,,179,0
Buskin,2006,0,,180,0
Buskin,2006,0,,181,0
Buskin,2006,0,,182,0
Buskin,2006,0,,183,0
Buskin,2006,0,,184,0
Buskin,2006,0,,185,0
Buskin,2006,0,,186,0
Buskin,2006,0,,187,0
Buskin,2006,0,,188,0
Buskin,2006,1,,189,1
Buskin,2006,1,,190,2
Buskin,2006,0,,191,2
Buskin,2006,0,,192,2
Buskin,2006,0,,193,2
Buskin,2006,0,,194,2
Buskin,2006,0,,195,2
Buskin,2006,0,,196,2
Buskin,2006,0,,197,2
Buskin,2006,0,,198,2
Buskin,2006,0,,199,2
Buskin,2006,1,,200,3
Buskin,2006,5,,201,8
Buskin,2006,0,,202,8
Buskin,2006,0,,203,8
Buskin,2006,0,,204,8
Buskin,2006,0,,205,8
Buskin,2006,0,,206,8
Buskin,2006,1,,207,9
Buskin,2006,12,,208,21
Buskin,2006,87,,209,108
Buskin,2006,186,,210,294
Buskin,2006,29,,211,323
Buskin,2006,542,,212,865
Buskin,2006,1101,,213,1966
Buskin,2006,6882,,214,8848
Buskin,2006,1063,,215,9911
Buskin,2006,2899,,216,12810
Buskin,2006,6512,,217,19322
Buskin,2006,6048,,218,25370
Buskin,2006,8165,,219,33535
Buskin,2006,7708,,220,41243
Buskin,2006,9963,,221,51206
Buskin,2006,6915,,222,58121
Buskin,2006,7512,,223,65633
Buskin,2006,7355,,224,72988
Buskin,2006,4680,,225,77668
Buskin,2006,7407,,226,85075
Buskin,2006,5800,,227,90875
Buskin,2006,4042,,228,94917
Buskin,2006,4471,,229,99388
Buskin,2006,3704,,230,103092
Buskin,2006,4381,,231,107473
Buskin,2006,5930,,232,113403
Buskin,2006,2827,,233,116230
Buskin,2006,1587,,234,117817
Buskin,2006,1728,,235,119545
Buskin,2006,26076,,236,145621
Buskin,2006,2895,,237,148516
Buskin,2006,4607,,238,153123
Buskin,2006,3415,,239,156538
Buskin,2006,1324,,240,157862
Buskin,2006,2414,,241,160276
Buskin,2006,19068,,242,179344
Buskin,2006,6423,,243,185767
Buskin,2006,5163,,244,190930
Buskin,2006,2553,,245,193483
Buskin,2006,3658,,246,197141
Buskin,2006,3147,,247,200288
Buskin,2006,2530,,248,202818
Buskin,2006,4253,,249,207071
Buskin,2006,2104,,250,209175
Buskin,2006,2793,,251,211968
Buskin,2006,2338,,252,214306
Buskin,2006,2110,,253,216416
Buskin,2006,1421,,254,217837
Buskin,2006,545,,255,218382
Buskin,2006,757,,256,219139
Buskin,2006,969,,257,220108
Buskin,2006,0,,258,220108
Buskin,2006,295,,259,220403
Buskin,2006,0,,260,220403
Buskin,2006,0,,261,220403
Buskin,2006,0,,262,220403
Buskin,2006,27,,263,220430
Buskin,2006,8,,264,220438
Buskin,2006,0,,265,220438
Buskin,2006,0,,266,220438
Buskin,2006,0,,267,220438
Buskin,2006,0,,268,220438
Buskin,2006,0,,269,220438
Buskin,2006,0,,270,220438
Buskin,2006,0,,271,220438
Buskin,2006,0,,272,220438
Buskin,2006,0,,273,220438
Buskin,2006,0,,274,220438
Buskin,2006,0,,275,220438
Buskin,2006,0,,276,220438
Buskin,2006,0,,277,220438
Buskin,2006,0,,278,220438
Buskin,2006,0,,279,220438
Buskin,2006,0,,280,220438
Buskin,2006,0,,281,220438
Buskin,2005,0,,173,0
Buskin,2005,0,,174,0
Buskin,2005,0,,175,0
Buskin,2005,0,,176,0
Buskin,2005,0,,177,0
Buskin,2005,0,,178,0
Buskin,2005,0,,179,0
Buskin,2005,0,,180,0
Buskin,2005,0,,181,0
Buskin,2005,0,,182,0
Buskin,2005,0,,183,0
Buskin,2005,0,,184,0
Buskin,2005,0,,185,0
Buskin,2005,0,,186,0
Buskin,2005,0,,187,0
Buskin,2005,0,,188,0
Buskin,2005,0,,189,0
Buskin,2005,0,,190,0
Buskin,2005,0,,191,0
Buskin,2005,0,,192,0
Buskin,2005,0,,193,0
Buskin,2005,0,,194,0
Buskin,2005,0,,195,0
Buskin,2005,0,,196,0
Buskin,2005,0,,197,0
Buskin,2005,8,,198,8
Buskin,2005,2,,199,10
Buskin,2005,0,,200,10
Buskin,2005,2,,201,12
Buskin,2005,14,,202,26
Buskin,2005,0,,203,26
Buskin,2005,3,,204,29
Buskin,2005,1,,205,30
Buskin,2005,65,,206,95
Buskin,2005,33,,207,128
Buskin,2005,866,,208,994
Buskin,2005,295,,209,1289
Buskin,2005,268,,210,1557
Buskin,2005,215,,211,1772
Buskin,2005,3117,,212,4889
Buskin,2005,851,,213,5740
Buskin,2005,1926,,214,7666
Buskin,2005,0,,215,7666
Buskin,2005,0,,216,7666
Buskin,2005,0,,217,7666
Buskin,2005,0,,218,7666
Buskin,2005,9864,,219,17530
Buskin,2005,97712,,220,115242
Buskin,2005,5345,,221,120587
Buskin,2005,3789,,222,124376
Buskin,2005,7658,,223,132034
Buskin,2005,5231,,224,137265
Buskin,2005,5553,,225,142818
Buskin,2005,2934,,226,145752
Buskin,2005,3116,,227,148868
Buskin,2005,4437,,228,153305
Buskin,2005,10481,,229,163786
Buskin,2005,8318,,230,172104
Buskin,2005,4274,,231,176378
Buskin,2005,8050,,232,184428
Buskin,2005,4989,,233,189417
Buskin,2005,4427,,234,193844
Buskin,2005,5089,,235,198933
Buskin,2005,1253,,236,200186
Buskin,2005,2594,,237,202780
Buskin,2005,2361,,238,205141
Buskin,2005,1716,,239,206857
Buskin,2005,2562,,240,209419
Buskin,2005,2549,,241,211968
Buskin,2005,1497,,242,213465
Buskin,2005,2170,,243,215635
Buskin,2005,2077,,244,217712
Buskin,2005,1453,,245,219165
Buskin,2005,3718,,246,222883
Buskin,2005,2244,,247,225127
Buskin,2005,2324,,248,227451
Buskin,2005,1656,,249,229107
Buskin,2005,1535,,250,230642
Buskin,2005,1039,,251,231681
Buskin,2005,2523,,252,234204
Buskin,2005,949,,253,235153
Buskin,2005,985,,254,236138
Buskin,2005,1128,,255,237266
Buskin,2005,821,,256,238087
Buskin,2005,399,,257,238486
Buskin,2005,1021,,258,239507
Buskin,2005,550,,259,240057
Buskin,2005,816,,260,240873
Buskin,2005,714,,261,241587
Buskin,2005,178,,262,241765
Buskin,2005,119,,263,241884
Buskin,2005,127,,264,242011
Buskin,2005,146,,265,242157
Buskin,2005,69,,266,242226
Buskin,2005,42,,267,242268
Buskin,2005,27,,268,242295
Buskin,2005,36,,269,242331
Buskin,2005,167,,270,242498
Buskin,2005,44,,271,242542
Buskin,2005,14,,272,242556
Buskin,2005,2,,273,242558
Buskin,2005,4,,274,242562
Buskin,2005,0,,275,242562
Buskin,2005,0,,276,242562
Buskin,2005,1,,277,242563
Buskin,2005,0,,278,242563
Buskin,2005,0,,279,242563
Buskin,2005,0,,280,242563
Buskin,2005,0,,281,242563
Buskin,2004,0,,174,0
Buskin,2004,0,,175,0
Buskin,2004,0,,176,0
Buskin,2004,0,,177,0
Buskin,2004,0,,178,0
Buskin,2004,0,,179,0
Buskin,2004,0,,180,0
Buskin,2004,0,,181,0
Buskin,2004,0,,182,0
Buskin,2004,0,,183,0
Buskin,2004,0,,184,0
Buskin,2004,0,,185,0
Buskin,2004,0,,186,0
Buskin,2004,0,,187,0
Buskin,2004,0,,188,0
Buskin,2004,0,,189,0
Buskin,2004,0,,190,0
Buskin,2004,0,,191,0
Buskin,2004,1,,192,1
Buskin,2004,0,,193,1
Buskin,2004,0,,194,1
Buskin,2004,2,,195,3
Buskin,2004,0,,196,3
Buskin,2004,3,,197,6
Buskin,2004,2,,198,8
Buskin,2004,0,,199,8
Buskin,2004,0,,200,8
Buskin,2004,1,,201,9
Buskin,2004,9,,202,18
Buskin,2004,0,,203,18
Buskin,2004,18,,204,36
Buskin,2004,2,,205,38
Buskin,2004,1,,206,39
Buskin,2004,9,,207,48
Buskin,2004,19,,208,67
Buskin,2004,2,,209,69
Buskin,2004,174,,210,243
Buskin,2004,65,,211,308
Buskin,2004,5699,,212,6007
Buskin,2004,2595,,213,8602
Buskin,2004,2403,,214,11005
Buskin,2004,2026,,215,13031
Buskin,2004,6049,,216,19080
Buskin,2004,8694,,217,27774
Buskin,2004,7098,,218,34872
Buskin,2004,8973,,219,43845
Buskin,2004,10196,,220,54041
Buskin,2004,8221,,221,62262
Buskin,2004,2916,,222,65178
Buskin,2004,3279,,223,68457
Buskin,2004,4230,,224,72687
Buskin,2004,2990,,225,75677
Buskin,2004,7421,,226,83098
Buskin,2004,15191,,227,98289
Buskin,2004,6707,,228,104996
Buskin,2004,2233,,229,107229
Buskin,2004,1523,,230,108752
Buskin,2004,1877,,231,110629
Buskin,2004,5079,,232,115708
Buskin,2004,1560,,233,117268
Buskin,2004,805,,234,118073
Buskin,2004,514,,235,118587
Buskin,2004,2125,,236,120712
Buskin,2004,2980,,237,123692
Buskin,2004,2305,,238,125997
Buskin,2004,2256,,239,128253
Buskin,2004,1326,,240,129579
Buskin,2004,1302,,241,130881
Buskin,2004,3013,,242,133894
Buskin,2004,1743,,243,135637
Buskin,2004,4571,,244,140208
Buskin,2004,3448,,245,143656
Buskin,2004,4185,,246,147841
Buskin,2004,6194,,247,154035
Buskin,2004,1229,,248,155264
Buskin,2004,3025,,249,158289
Buskin,2004,3253,,250,161542
Buskin,2004,2622,,251,164164
Buskin,2004,3681,,252,167845
Buskin,2004,1985,,253,169830
Buskin,2004,10504,,254,180334
Buskin,2004,2991,,255,183325
Buskin,2004,1742,,256,185067
Buskin,2004,1188,,257,186255
Buskin,2004,763,,258,187018
Buskin,2004,841,,259,187859
Buskin,2004,1531,,260,189390
Buskin,2004,969,,261,190359
Buskin,2004,1608,,262,191967
Buskin,2004,4769,,263,196736
Buskin,2004,140,,264,196876
Buskin,2004,126,,265,197002
Buskin,2004,173,,266,197175
Buskin,2004,40,,267,197215
Buskin,2004,24,,268,197239
Buskin,2004,98,,269,197337
Buskin,2004,63,,270,197400
Buskin,2004,13,,271,197413
Buskin,2004,14,,272,197427
Buskin,2004,2,,273,197429
Buskin,2004,0,,274,197429
Buskin,2004,0,,275,197429
Buskin,2004,0,,276,197429
Buskin,2004,0,,277,197429
Buskin,2004,0,,278,197429
Buskin,2004,0,,279,197429
Buskin,2004,0,,280,197429
Buskin,2004,0,,281,197429
Buskin,2004,0,,282,197429
Buskin,2003,4,,173,4
Buskin,2003,0,,174,4
Buskin,2003,0,,175,4
Buskin,2003,7,,176,11
Buskin,2003,0,,177,11
Buskin,2003,0,,178,11
Buskin,2003,1,,179,12
Buskin,2003,0,,180,12
Buskin,2003,0,,181,12
Buskin,2003,0,,182,12
Buskin,2003,0,,183,12
Buskin,2003,0,,184,12
Buskin,2003,1,,185,13
Buskin,2003,0,,186,13
Buskin,2003,1,,187,14
Buskin,2003,0,,188,14
Buskin,2003,1,,189,15
Buskin,2003,1,,190,16
Buskin,2003,0,,191,16
Buskin,2003,0,,192,16
Buskin,2003,8,,193,24
Buskin,2003,1,,194,25
Buskin,2003,3,,195,28
Buskin,2003,0,,196,28
Buskin,2003,2,,197,30
Buskin,2003,0,,198,30
Buskin,2003,0,,199,30
Buskin,2003,1,,200,31
Buskin,2003,0,,201,31
Buskin,2003,2,,202,33
Buskin,2003,23,,203,56
Buskin,2003,62,,204,118
Buskin,2003,8,,205,126
Buskin,2003,4,,206,130
Buskin,2003,28,,207,158
Buskin,2003,17,,208,175
Buskin,2003,24,,209,199
Buskin,2003,11,,210,210
Buskin,2003,63,,211,273
Buskin,2003,34,,212,307
Buskin,2003,88,,213,395
Buskin,2003,411,,214,806
Buskin,2003,41,,215,847
Buskin,2003,22,,216,869
Buskin,2003,292,,217,1161
Buskin,2003,458,,218,1619
Buskin,2003,131,,219,1750
Buskin,2003,1147,,220,2897
Buskin,2003,1228,,221,4125
Buskin,2003,290,,222,4415
Buskin,2003,91,,223,4506
Buskin,2003,34,,224,4540
Buskin,2003,9,,225,4549
Buskin,2003,168,,226,4717
Buskin,2003,454,,227,5171
Buskin,2003,4325,,228,9496
Buskin,2003,2045,,229,11541
Buskin,2003,3270,,230,14811
Buskin,2003,2070,,231,16881
Buskin,2003,4424,,232,21305
Buskin,2003,2954,,233,24259
Buskin,2003,3518,,234,27777
Buskin,2003,1900,,235,29677
Buskin,2003,3449,,236,33126
Buskin,2003,2585,,237,35711
Buskin,2003,6973,,238,42684
Buskin,2003,2919,,239,45603
Buskin,2003,5159,,240,50762
Buskin,2003,982,,241,51744
Buskin,2003,1829,,242,53573
Buskin,2003,1080,,243,54653
Buskin,2003,3116,,244,57769
Buskin,2003,1576,,245,59345
Buskin,2003,1021,,246,60366
Buskin,2003,1148,,247,61514
Buskin,2003,1317,,248,62831
Buskin,2003,500,,249,63331
Buskin,2003,328,,250,63659
Buskin,2003,602,,251,64261
Buskin,2003,1789,,252,66050
Buskin,2003,1045,,253,67095
Buskin,2003,332,,254,67427
Buskin,2003,231,,255,67658
Buskin,2003,119,,256,67777
Buskin,2003,115,,257,67892
Buskin,2003,102,,258,67994
Buskin,2003,86,,259,68080
Buskin,2003,78,,260,68158
Buskin,2003,37,,261,68195
Buskin,2003,26,,262,68221
Buskin,2003,24,,263,68245
Buskin,2003,19,,264,68264
Buskin,2003,12,,265,68276
Buskin,2003,30,,266,68306
Buskin,2003,77,,267,68383
Buskin,2003,22,,268,68405
Buskin,2003,14,,269,68419
Buskin,2003,13,,270,68432
Buskin,2003,7,,271,68439
Buskin,2003,6,,272,68445
Buskin,2003,0,,273,68445
Buskin,2003,0,,274,68445
Buskin,2003,0,,275,68445
Buskin,2003,0,,276,68445
Buskin,2003,0,,277,68445
Buskin,2003,0,,278,68445
Buskin,2003,0,,279,68445
Buskin,2003,0,,280,68445
Buskin,2003,0,,281,68445
Buskin,2002,0,,173,0
Buskin,2002,0,,174,0
Buskin,2002,0,,175,0
Buskin,2002,0,,176,0
Buskin,2002,0,,177,0
Buskin,2002,0,,178,0
Buskin,2002,0,,179,0
Buskin,2002,0,,180,0
Buskin,2002,0,,181,0
Buskin,2002,0,,182,0
Buskin,2002,0,,183,0
Buskin,2002,0,,184,0
Buskin,2002,0,,185,0
Buskin,2002,0,,186,0
Buskin,2002,0,,187,0
Buskin,2002,0,,188,0
Buskin,2002,0,,189,0
Buskin,2002,0,,190,0
Buskin,2002,0,,191,0
Buskin,2002,0,,192,0
Buskin,2002,0,,193,0
Buskin,2002,0,,194,0
Buskin,2002,0,,195,0
Buskin,2002,1,,196,1
Buskin,2002,0,,197,1
Buskin,2002,1,,198,2
Buskin,2002,0,,199,2
Buskin,2002,0,,200,2
Buskin,2002,0,,201,2
Buskin,2002,6,,202,8
Buskin,2002,0,,203,8
Buskin,2002,4,,204,12
Buskin,2002,1,,205,13
Buskin,2002,0,,206,13
Buskin,2002,0,,207,13
Buskin,2002,0,,208,13
Buskin,2002,0,,209,13
Buskin,2002,1,,210,14
Buskin,2002,0,,211,14
Buskin,2002,14,,212,28
Buskin,2002,29,,213,57
Buskin,2002,76,,214,133
Buskin,2002,22,,215,155
Buskin,2002,6,,216,161
Buskin,2002,3,,217,164
Buskin,2002,25,,218,189
Buskin,2002,5,,219,194
Buskin,2002,0,,220,194
Buskin,2002,0,,221,194
Buskin,2002,0,,222,194
Buskin,2002,0,,223,194
Buskin,2002,0,,224,194
Buskin,2002,24311,,225,24505
Buskin,2002,313,,226,24818
Buskin,2002,96,,227,24914
Buskin,2002,29,,228,24943
Buskin,2002,562,,229,25505
Buskin,2002,168,,230,25673
Buskin,2002,1496,,231,27169
Buskin,2002,705,,232,27874
Buskin,2002,1096,,233,28970
Buskin,2002,925,,234,29895
Buskin,2002,455,,235,30350
Buskin,2002,607,,236,30957
Buskin,2002,1358,,237,32315
Buskin,2002,327,,238,32642
Buskin,2002,1614,,239,34256
Buskin,2002,391,,240,34647
Buskin,2002,4153,,241,38800
Buskin,2002,587,,242,39387
Buskin,2002,1237,,243,40624
Buskin,2002,930,,244,41554
Buskin,2002,1982,,245,43536
Buskin,2002,1606,,246,45142
Buskin,2002,3803,,247,48945
Buskin,2002,2456,,248,51401
Buskin,2002,2039,,249,53440
Buskin,2002,1723,,250,55163
Buskin,2002,1326,,251,56489
Buskin,2002,1773,,252,58262
Buskin,2002,719,,253,58981
Buskin,2002,340,,254,59321
Buskin,2002,759,,255,60080
Buskin,2002,1037,,256,61117
Buskin,2002,1173,,257,62290
Buskin,2002,156,,258,62446
Buskin,2002,111,,259,62557
Buskin,2002,48,,260,62605
Buskin,2002,31,,261,62636
Buskin,2002,30,,262,62666
Buskin,2002,9,,263,62675
Buskin,2002,27,,264,62702
Buskin,2002,57,,265,62759
Buskin,2002,0,,266,62759
Buskin,2002,0,,267,62759
Buskin,2002,0,,268,62759
Buskin,2002,0,,269,62759
Buskin,2002,0,,270,62759
Buskin,2002,0,,271,62759
Buskin,2002,0,,272,62759
Buskin,2002,0,,273,62759
Buskin,2002,0,,274,62759
Buskin,2002,0,,275,62759
Buskin,2002,0,,276,62759
Buskin,2002,0,,277,62759
Buskin,2002,0,,278,62759
Buskin,2002,0,,279,62759
Buskin,2002,0,,280,62759
Buskin,2002,0,,281,62759
Buskin,2001,0,,173,0
Buskin,2001,0,,174,0
Buskin,2001,0,,175,0
Buskin,2001,0,,176,0
Buskin,2001,0,,177,0
Buskin,2001,0,,178,0
Buskin,2001,0,,179,0
Buskin,2001,0,,180,0
Buskin,2001,0,,181,0
Buskin,2001,0,,182,0
Buskin,2001,0,,183,0
Buskin,2001,0,,184,0
Buskin,2001,0,,185,0
Buskin,2001,0,,186,0
Buskin,2001,0,,187,0
Buskin,2001,0,,188,0
Buskin,2001,0,,189,0
Buskin,2001,0,,190,0
Buskin,2001,0,,191,0
Buskin,2001,0,,192,0
Buskin,2001,0,,193,0
Buskin,2001,0,,194,0
Buskin,2001,0,,195,0
Buskin,2001,0,,196,0
Buskin,2001,2,,197,2
Buskin,2001,0,,198,2
Buskin,2001,0,,199,2
Buskin,2001,1,,200,3
Buskin,2001,0,,201,3
Buskin,2001,0,,202,3
Buskin,2001,0,,203,3
Buskin,2001,0,,204,3
Buskin,2001,0,,205,3
Buskin,2001,1,,206,4
Buskin,2001,0,,207,4
Buskin,2001,0,,208,4
Buskin,2001,0,,209,4
Buskin,2001,0,,210,4
Buskin,2001,0,,211,4
Buskin,2001,0,,212,4
Buskin,2001,0,,213,4
Buskin,2001,0,,214,4
Buskin,2001,0,,215,4
Buskin,2001,0,,216,4
Buskin,2001,0,,217,4
Buskin,2001,0,,218,4
Buskin,2001,0,,219,4
Buskin,2001,0,,220,4
Buskin,2001,0,,221,4
Buskin,2001,0,,222,4
Buskin,2001,0,,223,4
Buskin,2001,0,,224,4
Buskin,2001,0,,225,4
Buskin,2001,0,,226,4
Buskin,2001,0,,227,4
Buskin,2001,0,,228,4
Buskin,2001,1511,,229,1515
Buskin,2001,1925,,230,3440
Buskin,2001,1981,,231,5421
Buskin,2001,99,,232,5520
Buskin,2001,3160,,233,8680
Buskin,2001,1114,,234,9794
Buskin,2001,22188,,235,31982
Buskin,2001,372,,236,32354
Buskin,2001,1248,,237,33602
Buskin,2001,757,,238,34359
Buskin,2001,2075,,239,36434
Buskin,2001,3389,,240,39823
Buskin,2001,803,,241,40626
Buskin,2001,1599,,242,42225
Buskin,2001,802,,243,43027
Buskin,2001,577,,244,43604
Buskin,2001,904,,245,44508
Buskin,2001,478,,246,44986
Buskin,2001,815,,247,45801
Buskin,2001,539,,248,46340
Buskin,2001,374,,249,46714
Buskin,2001,405,,250,47119
Buskin,2001,232,,251,47351
Buskin,2001,433,,252,47784
Buskin,2001,885,,253,48669
Buskin,2001,484,,254,49153
Buskin,2001,399,,255,49552
Buskin,2001,235,,256,49787
Buskin,2001,90,,257,49877
Buskin,2001,77,,258,49954
Buskin,2001,0,,259,49954
Buskin,2001,0,,260,49954
Buskin,2001,0,,261,49954
Buskin,2001,33,,262,49987
Buskin,2001,6,,263,49993
Buskin,2001,26,,264,50019
Buskin,2001,25,,265,50044
Buskin,2001,0,,266,50044
Buskin,2001,70,,267,50114
Buskin,2001,9,,268,50123
Buskin,2001,10,,269,50133
Buskin,2001,1,,270,50134
Buskin,2001,1,,271,50135
Buskin,2001,5,,272,50140
Buskin,2001,0,,273,50140
Buskin,2001,0,,274,50140
Buskin,2001,0,,275,50140
Buskin,2001,0,,276,50140
Buskin,2001,0,,277,50140
Buskin,2001,0,,278,50140
Buskin,2001,0,,279,50140
Buskin,2001,0,,280,50140
Buskin,2001,0,,281,50140
Buskin,2000,0,,174,0
Buskin,2000,0,,175,0
Buskin,2000,0,,176,0
Buskin,2000,0,,177,0
Buskin,2000,0,,178,0
Buskin,2000,0,,179,0
Buskin,2000,0,,180,0
Buskin,2000,0,,181,0
Buskin,2000,0,,182,0
Buskin,2000,0,,183,0
Buskin,2000,0,,184,0
Buskin,2000,0,,185,0
Buskin,2000,0,,186,0
Buskin,2000,0,,187,0
Buskin,2000,0,,188,0
Buskin,2000,0,,189,0
Buskin,2000,0,,190,0
Buskin,2000,0,,191,0
Buskin,2000,1,,192,1
Buskin,2000,0,,193,1
Buskin,2000,0,,194,1
Buskin,2000,0,,195,1
Buskin,2000,0,,196,1
Buskin,2000,0,,197,1
Buskin,2000,0,,198,1
Buskin,2000,0,,199,1
Buskin,2000,1,,200,2
Buskin,2000,2,,201,4
Buskin,2000,0,,202,4
Buskin,2000,18,,203,22
Buskin,2000,1,,204,23
Buskin,2000,2,,205,25
Buskin,2000,2,,206,27
Buskin,2000,4,,207,31
Buskin,2000,2,,208,33
Buskin,2000,3,,209,36
Buskin,2000,0,,210,36
Buskin,2000,0,,211,36
Buskin,2000,0,,212,36
Buskin,2000,0,,213,36
Buskin,2000,0,,214,36
Buskin,2000,0,,215,36
Buskin,2000,0,,216,36
Buskin,2000,0,,217,36
Buskin,2000,0,,218,36
Buskin,2000,0,,219,36
Buskin,2000,0,,220,36
Buskin,2000,0,,221,36
Buskin,2000,0,,222,36
Buskin,2000,0,,223,36
Buskin,2000,0,,224,36
Buskin,2000,0,,225,36
Buskin,2000,0,,226,36
Buskin,2000,0,,227,36
Buskin,2000,0,,228,36
Buskin,2000,0,,229,36
Buskin,2000,0,,230,36
Buskin,2000,0,,231,36
Buskin,2000,19364,,232,19400
Buskin,2000,39,,233,19439
Buskin,2000,189,,234,19628
Buskin,2000,155,,235,19783
Buskin,2000,476,,236,20259
Buskin,2000,333,,237,20592
Buskin,2000,281,,238,20873
Buskin,2000,312,,239,21185
Buskin,2000,763,,240,21948
Buskin,2000,1252,,241,23200
Buskin,2000,860,,242,24060
Buskin,2000,985,,243,25045
Buskin,2000,861,,244,25906
Buskin,2000,1632,,245,27538
Buskin,2000,816,,246,28354
Buskin,2000,1245,,247,29599
Buskin,2000,1000,,248,30599
Buskin,2000,1126,,249,31725
Buskin,2000,2515,,250,34240
Buskin,2000,1482,,251,35722
Buskin,2000,896,,252,36618
Buskin,2000,567,,253,37185
Buskin,2000,1281,,254,38466
Buskin,2000,599,,255,39065
Buskin,2000,208,,256,39273
Buskin,2000,1530,,257,40803
Buskin,2000,315,,258,41118
Buskin,2000,249,,259,41367
Buskin,2000,318,,260,41685
Buskin,2000,172,,261,41857
Buskin,2000,49,,262,41906
Buskin,2000,84,,263,41990
Buskin,2000,152,,264,42142
Buskin,2000,92,,265,42234
Buskin,2000,28,,266,42262
Buskin,2000,54,,267,42316
Buskin,2000,21,,268,42337
Buskin,2000,18,,269,42355
Buskin,2000,12,,270,42367
Buskin,2000,3,,271,42370
Buskin,2000,2,,272,42372
Buskin,2000,0,,273,42372
Buskin,2000,0,,274,42372
Buskin,2000,1,,275,42373
Buskin,2000,3,,276,42376
Buskin,2000,1,,277,42377
Buskin,2000,0,,278,42377
Buskin,2000,0,,279,42377
Buskin,2000,0,,280,42377
Buskin,2000,0,,281,42377
Buskin,2000,0,,282,42377
Buskin,1999,0,,173,0
Buskin,1999,0,,174,0
Buskin,1999,0,,175,0
Buskin,1999,0,,176,0
Buskin,1999,0,,177,0
Buskin,1999,0,,178,0
Buskin,1999,0,,179,0
Buskin,1999,0,,180,0
Buskin,1999,0,,181,0
Buskin,1999,0,,182,0
Buskin,1999,0,,183,0
Buskin,1999,0,,184,0
Buskin,1999,0,,185,0
Buskin,1999,0,,186,0
Buskin,1999,0,,187,0
Buskin,1999,0,,188,0
Buskin,1999,0,,189,0
Buskin,1999,0,,190,0
Buskin,1999,0,,191,0
Buskin,1999,0,,192,0
Buskin,1999,0,,193,0
Buskin,1999,0,,194,0
Buskin,1999,0,,195,0
Buskin,1999,0,,196,0
Buskin,1999,0,,197,0
Buskin,1999,0,,198,0
Buskin,1999,0,,199,0
Buskin,1999,0,,200,0
Buskin,1999,0,,201,0
Buskin,1999,0,,202,0
Buskin,1999,0,,203,0
Buskin,1999,0,,204,0
Buskin,1999,0,,205,0
Buskin,1999,0,,206,0
Buskin,1999,0,,207,0
Buskin,1999,0,,208,0
Buskin,1999,0,,209,0
Buskin,1999,0,,210,0
Buskin,1999,0,,211,0
Buskin,1999,0,,212,0
Buskin,1999,0,,213,0
Buskin,1999,0,,214,0
Buskin,1999,0,,215,0
Buskin,1999,0,,216,0
Buskin,1999,0,,217,0
Buskin,1999,0,,218,0
Buskin,1999,0,,219,0
Buskin,1999,0,,220,0
Buskin,1999,0,,221,0
Buskin,1999,0,,222,0
Buskin,1999,0,,223,0
Buskin,1999,0,,224,0
Buskin,1999,0,,225,0
Buskin,1999,0,,226,0
Buskin,1999,0,,227,0
Buskin,1999,0,,228,0
Buskin,1999,0,,229,0
Buskin,1999,0,,230,0
Buskin,1999,45376,,231,45376
Buskin,1999,725,,232,46101
Buskin,1999,4656,,233,50757
Buskin,1999,1806,,234,52563
Buskin,1999,3600,,235,56163
Buskin,1999,5209,,236,61372
Buskin,1999,3487,,237,64859
Buskin,1999,438,,238,65297
Buskin,1999,3925,,239,69222
Buskin,1999,695,,240,69917
Buskin,1999,627,,241,70544
Buskin,1999,2235,,242,72779
Buskin,1999,488,,243,73267
Buskin,1999,850,,244,74117
Buskin,1999,2246,,245,76363
Buskin,1999,498,,246,76861
Buskin,1999,861,,247,77722
Buskin,1999,1497,,248,79219
Buskin,1999,1135,,249,80354
Buskin,1999,1534,,250,81888
Buskin,1999,1166,,251,83054
Buskin,1999,1466,,252,84520
Buskin,1999,3510,,253,88030
Buskin,1999,2533,,254,90563
Buskin,1999,1875,,255,92438
Buskin,1999,1718,,256,94156
Buskin,1999,0,,257,94156
Buskin,1999,0,,258,94156
Buskin,1999,0,,259,94156
Buskin,1999,0,,260,94156
Buskin,1999,0,,261,94156
Buskin,1999,0,,262,94156
Buskin,1999,0,,263,94156
Buskin,1999,34,,264,94190
Buskin,1999,0,,265,94190
Buskin,1999,0,,266,94190
Buskin,1999,0,,267,94190
Buskin,1999,52,,268,94242
Buskin,1999,21,,269,94263
Buskin,1999,14,,270,94277
Buskin,1999,8,,271,94285
Buskin,1999,14,,272,94299
Buskin,1999,14,,273,94313
Buskin,1999,4,,274,94317
Buskin,1999,5,,275,94322
Buskin,1999,0,,276,94322
Buskin,1999,0,,277,94322
Buskin,1999,0,,278,94322
Buskin,1999,0,,279,94322
Buskin,1999,0,,280,94322
Buskin,1999,0,,281,94322
Buskin,1998,0,,173,0
Buskin,1998,0,,174,0
Buskin,1998,0,,175,0
Buskin,1998,0,,176,0
Buskin,1998,0,,177,0
Buskin,1998,0,,178,0
Buskin,1998,0,,179,0
Buskin,1998,0,,180,0
Buskin,1998,0,,181,0
Buskin,1998,0,,182,0
Buskin,1998,0,,183,0
Buskin,1998,0,,184,0
Buskin,1998,0,,185,0
Buskin,1998,0,,186,0
Buskin,1998,0,,187,0
Buskin,1998,0,,188,0
Buskin,1998,0,,189,0
Buskin,1998,0,,190,0
Buskin,1998,0,,191,0
Buskin,1998,0,,192,0
Buskin,1998,0,,193,0
Buskin,1998,0,,194,0
Buskin,1998,0,,195,0
Buskin,1998,0,,196,0
Buskin,1998,0,,197,0
Buskin,1998,0,,198,0
Buskin,1998,0,,199,0
Buskin,1998,1,,200,1
Buskin,1998,0,,201,1
Buskin,1998,5,,202,6
Buskin,1998,2,,203,8
Buskin,1998,2,,204,10
Buskin,1998,1,,205,11
Buskin,1998,2,,206,13
Buskin,1998,4,,207,17
Buskin,1998,5,,208,22
Buskin,1998,0,,209,22
Buskin,1998,0,,210,22
Buskin,1998,0,,211,22
Buskin,1998,0,,212,22
Buskin,1998,0,,213,22
Buskin,1998,0,,214,22
Buskin,1998,0,,215,22
Buskin,1998,0,,216,22
Buskin,1998,0,,217,22
Buskin,1998,0,,218,22
Buskin,1998,0,,219,22
Buskin,1998,0,,220,22
Buskin,1998,0,,221,22
Buskin,1998,0,,222,22
Buskin,1998,0,,223,22
Buskin,1998,0,,224,22
Buskin,1998,0,,225,22
Buskin,1998,838,,226,860
Buskin,1998,2692,,227,3552
Buskin,1998,2630,,228,6182
Buskin,1998,1016,,229,7198
Buskin,1998,1087,,230,8285
Buskin,1998,76960,,231,85245
Buskin,1998,1498,,232,86743
Buskin,1998,978,,233,87721
Buskin,1998,445,,234,88166
Buskin,1998,8080,,235,96246
Buskin,1998,815,,236,97061
Buskin,1998,778,,237,97839
Buskin,1998,5055,,238,102894
Buskin,1998,1061,,239,103955
Buskin,1998,1162,,240,105117
Buskin,1998,1163,,241,106280
Buskin,1998,9269,,242,115549
Buskin,1998,1180,,243,116729
Buskin,1998,4761,,244,121490
Buskin,1998,4271,,245,125761
Buskin,1998,2111,,246,127872
Buskin,1998,1014,,247,128886
Buskin,1998,773,,248,129659
Buskin,1998,1426,,249,131085
Buskin,1998,814,,250,131899
Buskin,1998,274,,251,132173
Buskin,1998,801,,252,132974
Buskin,1998,0,,253,132974
Buskin,1998,0,,254,132974
Buskin,1998,380,,255,133354
Buskin,1998,298,,256,133652
Buskin,1998,76,,257,133728
Buskin,1998,60,,258,133788
Buskin,1998,34,,259,133822
Buskin,1998,93,,260,133915
Buskin,1998,59,,261,133974
Buskin,1998,324,,262,134298
Buskin,1998,46,,263,134344
Buskin,1998,16,,264,134360
Buskin,1998,10,,265,134370
Buskin,1998,14,,266,134384
Buskin,1998,5,,267,134389
Buskin,1998,7,,268,134396
Buskin,1998,5,,269,134401
Buskin,1998,1,,270,134402
Buskin,1998,1,,271,134403
Buskin,1998,0,,272,134403
Buskin,1998,0,,273,134403
Buskin,1998,0,,274,134403
Buskin,1998,0,,275,134403
Buskin,1998,0,,276,134403
Buskin,1998,0,,277,134403
Buskin,1998,0,,278,134403
Buskin,1998,0,,279,134403
Buskin,1998,0,,280,134403
Buskin,1998,0,,281,134403
Buskin,1997,0,,173,0
Buskin,1997,0,,174,0
Buskin,1997,0,,175,0
Buskin,1997,0,,176,0
Buskin,1997,0,,177,0
Buskin,1997,0,,178,0
Buskin,1997,0,,179,0
Buskin,1997,0,,180,0
Buskin,1997,0,,181,0
Buskin,1997,0,,182,0
Buskin,1997,0,,183,0
Buskin,1997,0,,184,0
Buskin,1997,0,,185,0
Buskin,1997,0,,186,0
Buskin,1997,0,,187,0
Buskin,1997,0,,188,0
Buskin,1997,0,,189,0
Buskin,1997,0,,190,0
Buskin,1997,0,,191,0
Buskin,1997,0,,192,0
Buskin,1997,0,,193,0
Buskin,1997,0,,194,0
Buskin,1997,0,,195,0
Buskin,1997,0,,196,0
Buskin,1997,0,,197,0
Buskin,1997,0,,198,0
Buskin,1997,0,,199,0
Buskin,1997,2,,200,2
Buskin,1997,0,,201,2
Buskin,1997,0,,202,2
Buskin,1997,0,,203,2
Buskin,1997,0,,204,2
Buskin,1997,0,,205,2
Buskin,1997,10,,206,12
Buskin,1997,0,,207,12
Buskin,1997,1,,208,13
Buskin,1997,0,,209,13
Buskin,1997,336,,210,349
Buskin,1997,0,,211,349
Buskin,1997,0,,212,349
Buskin,1997,0,,213,349
Buskin,1997,0,,214,349
Buskin,1997,0,,215,349
Buskin,1997,0,,216,349
Buskin,1997,0,,217,349
Buskin,1997,0,,218,349
Buskin,1997,0,,219,349
Buskin,1997,0,,220,349
Buskin,1997,0,,221,349
Buskin,1997,0,,222,349
Buskin,1997,0,,223,349
Buskin,1997,0,,224,349
Buskin,1997,0,,225,349
Buskin,1997,21251,,226,21600
Buskin,1997,1065,,227,22665
Buskin,1997,270,,228,22935
Buskin,1997,689,,229,23624
Buskin,1997,383,,230,24007
Buskin,1997,628,,231,24635
Buskin,1997,466,,232,25101
Buskin,1997,849,,233,25950
Buskin,1997,2007,,234,27957
Buskin,1997,547,,235,28504
Buskin,1997,434,,236,28938
Buskin,1997,472,,237,29410
Buskin,1997,339,,238,29749
Buskin,1997,1907,,239,31656
Buskin,1997,390,,240,32046
Buskin,1997,673,,241,32719
Buskin,1997,610,,242,33329
Buskin,1997,3096,,243,36425
Buskin,1997,596,,244,37021
Buskin,1997,985,,245,38006
Buskin,1997,1581,,246,39587
Buskin,1997,1427,,247,41014
Buskin,1997,2505,,248,43519
Buskin,1997,2141,,249,45660
Buskin,1997,0,,250,45660
Buskin,1997,483,,251,46143
Buskin,1997,318,,252,46461
Buskin,1997,194,,253,46655
Buskin,1997,111,,254,46766
Buskin,1997,136,,255,46902
Buskin,1997,81,,256,46983
Buskin,1997,117,,257,47100
Buskin,1997,110,,258,47210
Buskin,1997,0,,259,47210
Buskin,1997,40,,260,47250
Buskin,1997,40,,261,47290
Buskin,1997,46,,262,47336
Buskin,1997,38,,263,47374
Buskin,1997,0,,264,47374
Buskin,1997,0,,265,47374
Buskin,1997,0,,266,47374
Buskin,1997,0,,267,47374
Buskin,1997,0,,268,47374
Buskin,1997,1,,269,47375
Buskin,1997,0,,270,47375
Buskin,1997,4,,271,47379
Buskin,1997,5,,272,47384
Buskin,1997,3,,273,47387
Buskin,1997,0,,274,47387
Buskin,1997,4,,275,47391
Buskin,1997,2,,276,47393
Buskin,1997,2,,277,47395
Buskin,1997,0,,278,47395
Buskin,1997,1,,279,47396
Buskin,1997,0,,280,47396
Buskin,1997,0,,281,47396
Buskin,1996,0,,174,0
Buskin,1996,0,,175,0
Buskin,1996,0,,176,0
Buskin,1996,0,,177,0
Buskin,1996,0,,178,0
Buskin,1996,0,,179,0
Buskin,1996,0,,180,0
Buskin,1996,0,,181,0
Buskin,1996,0,,182,0
Buskin,1996,0,,183,0
Buskin,1996,0,,184,0
Buskin,1996,0,,185,0
Buskin,1996,0,,186,0
Buskin,1996,0,,187,0
Buskin,1996,0,,188,0
Buskin,1996,0,,189,0
Buskin,1996,0,,190,0
Buskin,1996,0,,191,0
Buskin,1996,0,,192,0
Buskin,1996,0,,193,0
Buskin,1996,0,,194,0
Buskin,1996,0,,195,0
Buskin,1996,0,,196,0
Buskin,1996,0,,197,0
Buskin,1996,0,,198,0
Buskin,1996,1,,199,1
Buskin,1996,2,,200,3
Buskin,1996,0,,201,3
Buskin,1996,5,,202,8
Buskin,1996,6,,203,14
Buskin,1996,1,,204,15
Buskin,1996,1,,205,16
Buskin,1996,13,,206,29
Buskin,1996,5,,207,34
Buskin,1996,5,,208,39
Buskin,1996,67,,209,106
Buskin,1996,14,,210,120
Buskin,1996,42,,211,162
Buskin,1996,0,,212,162
Buskin,1996,0,,213,162
Buskin,1996,0,,214,162
Buskin,1996,0,,215,162
Buskin,1996,0,,216,162
Buskin,1996,0,,217,162
Buskin,1996,0,,218,162
Buskin,1996,0,,219,162
Buskin,1996,0,,220,162
Buskin,1996,0,,221,162
Buskin,1996,0,,222,162
Buskin,1996,0,,223,162
Buskin,1996,0,,224,162
Buskin,1996,0,,225,162
Buskin,1996,0,,226,162
Buskin,1996,33838,,227,34000
Buskin,1996,412,,228,34412
Buskin,1996,505,,229,34917
Buskin,1996,279,,230,35196
Buskin,1996,209,,231,35405
Buskin,1996,600,,232,36005
Buskin,1996,169,,233,36174
Buskin,1996,1668,,234,37842
Buskin,1996,331,,235,38173
Buskin,1996,408,,236,38581
Buskin,1996,132,,237,38713
Buskin,1996,254,,238,38967
Buskin,1996,266,,239,39233
Buskin,1996,560,,240,39793
Buskin,1996,959,,241,40752
Buskin,1996,622,,242,41374
Buskin,1996,1125,,243,42499
Buskin,1996,836,,244,43335
Buskin,1996,855,,245,44190
Buskin,1996,892,,246,45082
Buskin,1996,848,,247,45930
Buskin,1996,706,,248,46636
Buskin,1996,1028,,249,47664
Buskin,1996,2777,,250,50441
Buskin,1996,0,,251,50441
Buskin,1996,0,,252,50441
Buskin,1996,0,,253,50441
Buskin,1996,31,,254,50472
Buskin,1996,35,,255,50507
Buskin,1996,12,,256,50519
Buskin,1996,28,,257,50547
Buskin,1996,0,,258,50547
Buskin,1996,0,,259,50547
Buskin,1996,0,,260,50547
Buskin,1996,0,,261,50547
Buskin,1996,0,,262,50547
Buskin,1996,0,,263,50547
Buskin,1996,0,,264,50547
Buskin,1996,2,,265,50549
Buskin,1996,1,,266,50550
Buskin,1996,0,,267,50550
Buskin,1996,0,,268,50550
Buskin,1996,0,,269,50550
Buskin,1996,0,,270,50550
Buskin,1996,0,,271,50550
Buskin,1996,0,,272,50550
Buskin,1996,0,,273,50550
Buskin,1996,0,,274,50550
Buskin,1996,0,,275,50550
Buskin,1996,0,,276,50550
Buskin,1996,0,,277,50550
Buskin,1996,0,,278,50550
Buskin,1996,0,,279,50550
Buskin,1996,0,,280,50550
Buskin,1996,0,,281,50550
Buskin,1996,0,,282,50550
Buskin,1995,0,,173,0
Buskin,1995,0,,174,0
Buskin,1995,0,,175,0
Buskin,1995,0,,176,0
Buskin,1995,0,,177,0
Buskin,1995,0,,178,0
Buskin,1995,0,,179,0
Buskin,1995,0,,180,0
Buskin,1995,0,,181,0
Buskin,1995,0,,182,0
Buskin,1995,0,,183,0
Buskin,1995,0,,184,0
Buskin,1995,0,,185,0
Buskin,1995,0,,186,0
Buskin,1995,0,,187,0
Buskin,1995,2,,188,2
Buskin,1995,0,,189,2
Buskin,1995,0,,190,2
Buskin,1995,0,,191,2
Buskin,1995,0,,192,2
Buskin,1995,0,,193,2
Buskin,1995,0,,194,2
Buskin,1995,1,,195,3
Buskin,1995,0,,196,3
Buskin,1995,6,,197,9
Buskin,1995,1,,198,10
Buskin,1995,2,,199,12
Buskin,1995,1,,200,13
Buskin,1995,0,,201,13
Buskin,1995,12,,202,25
Buskin,1995,12,,203,37
Buskin,1995,6,,204,43
Buskin,1995,5,,205,48
Buskin,1995,18,,206,66
Buskin,1995,76,,207,142
Buskin,1995,44,,208,186
Buskin,1995,48,,209,234
Buskin,1995,57,,210,291
Buskin,1995,143,,211,434
Buskin,1995,322,,212,756
Buskin,1995,0,,213,756
Buskin,1995,0,,214,756
Buskin,1995,0,,215,756
Buskin,1995,0,,216,756
Buskin,1995,0,,217,756
Buskin,1995,0,,218,756
Buskin,1995,0,,219,756
Buskin,1995,0,,220,756
Buskin,1995,0,,221,756
Buskin,1995,0,,222,756
Buskin,1995,0,,223,756
Buskin,1995,0,,224,756
Buskin,1995,0,,225,756
Buskin,1995,0,,226,756
Buskin,1995,1903,,227,2659
Buskin,1995,942,,228,3601
Buskin,1995,53399,,229,57000
Buskin,1995,1408,,230,58408
Buskin,1995,358,,231,58766
Buskin,1995,275,,232,59041
Buskin,1995,1252,,233,60293
Buskin,1995,2004,,234,62297
Buskin,1995,508,,235,62805
Buskin,1995,335,,236,63140
Buskin,1995,645,,237,63785
Buskin,1995,409,,238,64194
Buskin,1995,378,,239,64572
Buskin,1995,806,,240,65378
Buskin,1995,263,,241,65641
Buskin,1995,522,,242,66163
Buskin,1995,1515,,243,67678
Buskin,1995,384,,244,68062
Buskin,1995,386,,245,68448
Buskin,1995,262,,246,68710
Buskin,1995,3092,,247,71802
Buskin,1995,0,,248,71802
Buskin,1995,0,,249,71802
Buskin,1995,0,,250,71802
Buskin,1995,0,,251,71802
Buskin,1995,0,,252,71802
Buskin,1995,123,,253,71925
Buskin,1995,259,,254,72184
Buskin,1995,119,,255,72303
Buskin,1995,193,,256,72496
Buskin,1995,90,,257,72586
Buskin,1995,140,,258,72726
Buskin,1995,100,,259,72826
Buskin,1995,0,,260,72826
Buskin,1995,0,,261,72826
Buskin,1995,0,,262,72826
Buskin,1995,0,,263,72826
Buskin,1995,0,,264,72826
Buskin,1995,0,,265,72826
Buskin,1995,0,,266,72826
Buskin,1995,0,,267,72826
Buskin,1995,0,,268,72826
Buskin,1995,0,,269,72826
Buskin,1995,0,,270,72826
Buskin,1995,0,,271,72826
Buskin,1995,0,,272,72826
Buskin,1995,0,,273,72826
Buskin,1995,0,,274,72826
Buskin,1995,0,,275,72826
Buskin,1995,0,,276,72826
Buskin,1995,0,,277,72826
Buskin,1995,0,,278,72826
Buskin,1995,0,,279,72826
Buskin,1995,0,,280,72826
Buskin,1995,0,,281,72826
Buskin,1994,0,,173,0
Buskin,1994,0,,174,0
Buskin,1994,0,,175,0
Buskin,1994,0,,176,0
Buskin,1994,0,,177,0
Buskin,1994,0,,178,0
Buskin,1994,0,,179,0
Buskin,1994,0,,180,0
Buskin,1994,0,,181,0
Buskin,1994,0,,182,0
Buskin,1994,0,,183,0
Buskin,1994,0,,184,0
Buskin,1994,0,,185,0
Buskin,1994,0,,186,0
Buskin,1994,0,,187,0
Buskin,1994,0,,188,0
Buskin,1994,0,,189,0
Buskin,1994,0,,190,0
Buskin,1994,5,,191,5
Buskin,1994,0,,192,5
Buskin,1994,0,,193,5
Buskin,1994,0,,194,5
Buskin,1994,27,,195,32
Buskin,1994,0,,196,32
Buskin,1994,5,,197,37
Buskin,1994,33,,198,70
Buskin,1994,17,,199,87
Buskin,1994,45,,200,132
Buskin,1994,1,,201,133
Buskin,1994,0,,202,133
Buskin,1994,0,,203,133
Buskin,1994,0,,204,133
Buskin,1994,0,,205,133
Buskin,1994,0,,206,133
Buskin,1994,0,,207,133
Buskin,1994,0,,208,133
Buskin,1994,0,,209,133
Buskin,1994,0,,210,133
Buskin,1994,0,,211,133
Buskin,1994,0,,212,133
Buskin,1994,0,,213,133
Buskin,1994,0,,214,133
Buskin,1994,0,,215,133
Buskin,1994,0,,216,133
Buskin,1994,0,,217,133
Buskin,1994,0,,218,133
Buskin,1994,0,,219,133
Buskin,1994,0,,220,133
Buskin,1994,0,,221,133
Buskin,1994,0,,222,133
Buskin,1994,0,,223,133
Buskin,1994,0,,224,133
Buskin,1994,0,,225,133
Buskin,1994,0,,226,133
Buskin,1994,0,,227,133
Buskin,1994,0,,228,133
Buskin,1994,79867,,229,80000
Buskin,1994,122,,230,80122
Buskin,1994,67,,231,80189
Buskin,1994,98,,232,80287
Buskin,1994,153,,233,80440
Buskin,1994,9,,234,80449
Buskin,1994,149,,235,80598
Buskin,1994,52,,236,80650
Buskin,1994,266,,237,80916
Buskin,1994,225,,238,81141
Buskin,1994,109,,239,81250
Buskin,1994,70,,240,81320
Buskin,1994,59,,241,81379
Buskin,1994,752,,242,82131
Buskin,1994,186,,243,82317
Buskin,1994,716,,244,83033
Buskin,1994,472,,245,83505
Buskin,1994,161,,246,83666
Buskin,1994,1385,,247,85051
Buskin,1994,286,,248,85337
Buskin,1994,111,,249,85448
Buskin,1994,662,,250,86110
Buskin,1994,463,,251,86573
Buskin,1994,681,,252,87254
Buskin,1994,897,,253,88151
Buskin,1994,249,,254,88400
Buskin,1994,81,,255,88481
Buskin,1994,317,,256,88798
Buskin,1994,499,,257,89297
Buskin,1994,160,,258,89457
Buskin,1994,43,,259,89500
Buskin,1994,124,,260,89624
Buskin,1994,37,,261,89661
Buskin,1994,26,,262,89687
Buskin,1994,0,,263,89687
Buskin,1994,0,,264,89687
Buskin,1994,7,,265,89694
Buskin,1994,9,,266,89703
Buskin,1994,0,,267,89703
Buskin,1994,0,,268,89703
Buskin,1994,2,,269,89705
Buskin,1994,3,,270,89708
Buskin,1994,1,,271,89709
Buskin,1994,2,,272,89711
Buskin,1994,0,,273,89711
Buskin,1994,0,,274,89711
Buskin,1994,0,,275,89711
Buskin,1994,0,,276,89711
Buskin,1994,0,,277,89711
Buskin,1994,0,,278,89711
Buskin,1994,0,,279,89711
Buskin,1994,0,,280,89711
Buskin,1994,0,,281,89711
Buskin,1993,0,,173,0
Buskin,1993,0,,174,0
Buskin,1993,0,,175,0
Buskin,1993,0,,176,0
Buskin,1993,0,,177,0
Buskin,1993,0,,178,0
Buskin,1993,0,,179,0
Buskin,1993,0,,180,0
Buskin,1993,0,,181,0
Buskin,1993,0,,182,0
Buskin,1993,0,,183,0
Buskin,1993,0,,184,0
Buskin,1993,0,,185,0
Buskin,1993,0,,186,0
Buskin,1993,0,,187,0
Buskin,1993,0,,188,0
Buskin,1993,0,,189,0
Buskin,1993,0,,190,0
Buskin,1993,0,,191,0
Buskin,1993,1,,192,1
Buskin,1993,1,,193,2
Buskin,1993,1,,194,3
Buskin,1993,0,,195,3
Buskin,1993,17,,196,20
Buskin,1993,2,,197,22
Buskin,1993,1,,198,23
Buskin,1993,3,,199,26
Buskin,1993,0,,200,26
Buskin,1993,1,,201,27
Buskin,1993,6,,202,33
Buskin,1993,3,,203,36
Buskin,1993,10,,204,46
Buskin,1993,0,,205,46
Buskin,1993,15,,206,61
Buskin,1993,56,,207,117
Buskin,1993,28,,208,145
Buskin,1993,82,,209,227
Buskin,1993,0,,210,227
Buskin,1993,45,,211,272
Buskin,1993,0,,212,272
Buskin,1993,0,,213,272
Buskin,1993,0,,214,272
Buskin,1993,0,,215,272
Buskin,1993,0,,216,272
Buskin,1993,0,,217,272
Buskin,1993,0,,218,272
Buskin,1993,0,,219,272
Buskin,1993,0,,220,272
Buskin,1993,0,,221,272
Buskin,1993,0,,222,272
Buskin,1993,0,,223,272
Buskin,1993,0,,224,272
Buskin,1993,0,,225,272
Buskin,1993,0,,226,272
Buskin,1993,0,,227,272
Buskin,1993,0,,228,272
Buskin,1993,0,,229,272
Buskin,1993,0,,230,272
Buskin,1993,0,,231,272
Buskin,1993,40222,,232,40494
Buskin,1993,452,,233,40946
Buskin,1993,604,,234,41550
Buskin,1993,725,,235,42275
Buskin,1993,541,,236,42816
Buskin,1993,623,,237,43439
Buskin,1993,623,,238,44062
Buskin,1993,623,,239,44685
Buskin,1993,601,,240,45286
Buskin,1993,601,,241,45887
Buskin,1993,601,,242,46488
Buskin,1993,601,,243,47089
Buskin,1993,952,,244,48041
Buskin,1993,414,,245,48455
Buskin,1993,436,,246,48891
Buskin,1993,768,,247,49659
Buskin,1993,423,,248,50082
Buskin,1993,423,,249,50505
Buskin,1993,423,,250,50928
Buskin,1993,295,,251,51223
Buskin,1993,192,,252,51415
Buskin,1993,145,,253,51560
Buskin,1993,184,,254,51744
Buskin,1993,217,,255,51961
Buskin,1993,96,,256,52057
Buskin,1993,93,,257,52150
Buskin,1993,68,,258,52218
Buskin,1993,45,,259,52263
Buskin,1993,40,,260,52303
Buskin,1993,23,,261,52326
Buskin,1993,27,,262,52353
Buskin,1993,52,,263,52405
Buskin,1993,18,,264,52423
Buskin,1993,7,,265,52430
Buskin,1993,8,,266,52438
Buskin,1993,1,,267,52439
Buskin,1993,28,,268,52467
Buskin,1993,12,,269,52479
Buskin,1993,4,,270,52483
Buskin,1993,1001,,271,53484
Buskin,1993,0,,272,53484
Buskin,1993,0,,273,53484
Buskin,1993,0,,274,53484
Buskin,1993,0,,275,53484
Buskin,1993,0,,276,53484
Buskin,1993,0,,277,53484
Buskin,1993,0,,278,53484
Buskin,1993,0,,279,53484
Buskin,1993,0,,280,53484
Buskin,1993,0,,281,53484
Buskin,1992,0,,174,0
Buskin,1992,0,,175,0
Buskin,1992,0,,176,0
Buskin,1992,0,,177,0
Buskin,1992,0,,178,0
Buskin,1992,0,,179,0
Buskin,1992,0,,180,0
Buskin,1992,0,,181,0
Buskin,1992,0,,182,0
Buskin,1992,0,,183,0
Buskin,1992,0,,184,0
Buskin,1992,0,,185,0
Buskin,1992,0,,186,0
Buskin,1992,0,,187,0
Buskin,1992,0,,188,0
Buskin,1992,0,,189,0
Buskin,1992,0,,190,0
Buskin,1992,0,,191,0
Buskin,1992,0,,192,0
Buskin,1992,0,,193,0
Buskin,1992,0,,194,0
Buskin,1992,0,,195,0
Buskin,1992,0,,196,0
Buskin,1992,4,,197,4
Buskin,1992,131,,198,135
Buskin,1992,131,,199,266
Buskin,1992,131,,200,397
Buskin,1992,131,,201,528
Buskin,1992,131,,202,659
Buskin,1992,131,,203,790
Buskin,1992,131,,204,921
Buskin,1992,131,,205,1052
Buskin,1992,131,,206,1183
Buskin,1992,131,,207,1314
Buskin,1992,125,,208,1439
Buskin,1992,147,,209,1586
Buskin,1992,273,,210,1859
Buskin,1992,356,,211,2215
Buskin,1992,439,,212,2654
Buskin,1992,441,,213,3095
Buskin,1992,501,,214,3596
Buskin,1992,664,,215,4260
Buskin,1992,1112,,216,5372
Buskin,1992,1006,,217,6378
Buskin,1992,963,,218,7341
Buskin,1992,965,,219,8306
Buskin,1992,1110,,220,9416
Buskin,1992,818,,221,10234
Buskin,1992,1027,,222,11261
Buskin,1992,900,,223,12161
Buskin,1992,942,,224,13103
Buskin,1992,776,,225,13879
Buskin,1992,534,,226,14413
Buskin,1992,439,,227,14852
Buskin,1992,441,,228,15293
Buskin,1992,418,,229,15711
Buskin,1992,356,,230,16067
Buskin,1992,524,,231,16591
Buskin,1992,335,,232,16926
Buskin,1992,188,,233,17114
Buskin,1992,168,,234,17282
Buskin,1992,209,,235,17491
Buskin,1992,126,,236,17617
Buskin,1992,209,,237,17826
Buskin,1992,110,,238,17936
Buskin,1992,393,,239,18329
Buskin,1992,503,,240,18832
Buskin,1992,262,,241,19094
Buskin,1992,258,,242,19352
Buskin,1992,912,,243,20264
Buskin,1992,504,,244,20768
Buskin,1992,504,,245,21272
Buskin,1992,625,,246,21897
Buskin,1992,378,,247,22275
Buskin,1992,626,,248,22901
Buskin,1992,381,,249,23282
Buskin,1992,280,,250,23562
Buskin,1992,199,,251,23761
Buskin,1992,277,,252,24038
Buskin,1992,351,,253,24389
Buskin,1992,108,,254,24497
Buskin,1992,143,,255,24640
Buskin,1992,107,,256,24747
Buskin,1992,153,,257,24900
Buskin,1992,89,,258,24989
Buskin,1992,23,,259,25012
Buskin,1992,11,,260,25023
Buskin,1992,63,,261,25086
Buskin,1992,31,,262,25117
Buskin,1992,10,,263,25127
Buskin,1992,9,,264,25136
Buskin,1992,5,,265,25141
Buskin,1992,0,,266,25141
Buskin,1992,0,,267,25141
Buskin,1992,0,,268,25141
Buskin,1992,0,,269,25141
Buskin,1992,0,,270,25141
Buskin,1992,0,,271,25141
Buskin,1992,0,,272,25141
Buskin,1992,0,,273,25141
Buskin,1992,0,,274,25141
Buskin,1992,0,,275,25141
Buskin,1992,0,,276,25141
Buskin,1992,0,,277,25141
Buskin,1992,0,,278,25141
Buskin,1992,0,,279,25141
Buskin,1992,0,,280,25141
Buskin,1992,0,,281,25141
Buskin,1992,0,,282,25141
Buskin,1991,0,,173,0
Buskin,1991,0,,174,0
Buskin,1991,0,,175,0
Buskin,1991,0,,176,0
Buskin,1991,0,,177,0
Buskin,1991,0,,178,0
Buskin,1991,0,,179,0
Buskin,1991,0,,180,0
Buskin,1991,0,,181,0
Buskin,1991,0,,182,0
Buskin,1991,0,,183,0
Buskin,1991,0,,184,0
Buskin,1991,0,,185,0
Buskin,1991,0,,186,0
Buskin,1991,0,,187,0
Buskin,1991,0,,188,0
Buskin,1991,0,,189,0
Buskin,1991,0,,190,0
Buskin,1991,0,,191,0
Buskin,1991,0,,192,0
Buskin,1991,0,,193,0
Buskin,1991,0,,194,0
Buskin,1991,0,,195,0
Buskin,1991,0,,196,0
Buskin,1991,1,,197,1
Buskin,1991,0,,198,1
Buskin,1991,3,,199,4
Buskin,1991,0,,200,4
Buskin,1991,4,,201,8
Buskin,1991,20,,202,28
Buskin,1991,77,,203,105
Buskin,1991,8,,204,113
Buskin,1991,48,,205,161
Buskin,1991,45,,206,206
Buskin,1991,0,,207,206
Buskin,1991,0,,208,206
Buskin,1991,0,,209,206
Buskin,1991,0,,210,206
Buskin,1991,0,,211,206
Buskin,1991,0,,212,206
Buskin,1991,0,,213,206
Buskin,1991,0,,214,206
Buskin,1991,0,,215,206
Buskin,1991,0,,216,206
Buskin,1991,0,,217,206
Buskin,1991,0,,218,206
Buskin,1991,0,,219,206
Buskin,1991,0,,220,206
Buskin,1991,0,,221,206
Buskin,1991,0,,222,206
Buskin,1991,0,,223,206
Buskin,1991,0,,224,206
Buskin,1991,0,,225,206
Buskin,1991,0,,226,206
Buskin,1991,0,,227,206
Buskin,1991,0,,228,206
Buskin,1991,0,,229,206
Buskin,1991,0,,230,206
Buskin,1991,0,,231,206
Buskin,1991,0,,232,206
Buskin,1991,0,,233,206
Buskin,1991,0,,234,206
Buskin,1991,27833,,235,28039
Buskin,1991,695,,236,28734
Buskin,1991,625,,237,29359
Buskin,1991,894,,238,30253
Buskin,1991,359,,239,30612
Buskin,1991,233,,240,30845
Buskin,1991,167,,241,31012
Buskin,1991,1009,,242,32021
Buskin,1991,459,,243,32480
Buskin,1991,572,,244,33052
Buskin,1991,1818,,245,34870
Buskin,1991,372,,246,35242
Buskin,1991,1165,,247,36407
Buskin,1991,379,,248,36786
Buskin,1991,195,,249,36981
Buskin,1991,168,,250,37149
Buskin,1991,300,,251,37449
Buskin,1991,0,,252,37449
Buskin,1991,44,,253,37493
Buskin,1991,25,,254,37518
Buskin,1991,31,,255,37549
Buskin,1991,31,,256,37580
Buskin,1991,23,,257,37603
Buskin,1991,23,,258,37626
Buskin,1991,23,,259,37649
Buskin,1991,22,,260,37671
Buskin,1991,10,,261,37681
Buskin,1991,23,,262,37704
Buskin,1991,10,,263,37714
Buskin,1991,8,,264,37722
Buskin,1991,8,,265,37730
Buskin,1991,0,,266,37730
Buskin,1991,0,,267,37730
Buskin,1991,2,,268,37732
Buskin,1991,3,,269,37735
Buskin,1991,0,,270,37735
Buskin,1991,1,,271,37736
Buskin,1991,0,,272,37736
Buskin,1991,0,,273,37736
Buskin,1991,0,,274,37736
Buskin,1991,0,,275,37736
Buskin,1991,0,,276,37736
Buskin,1991,0,,277,37736
Buskin,1991,0,,278,37736
Buskin,1991,0,,279,37736
Buskin,1991,0,,280,37736
Buskin,1991,0,,281,37736
Buskin,1990,0,,173,0
Buskin,1990,0,,174,0
Buskin,1990,0,,175,0
Buskin,1990,0,,176,0
Buskin,1990,0,,177,0
Buskin,1990,0,,178,0
Buskin,1990,0,,179,0
Buskin,1990,0,,180,0
Buskin,1990,0,,181,0
Buskin,1990,0,,182,0
Buskin,1990,0,,183,0
Buskin,1990,0,,184,0
Buskin,1990,0,,185,0
Buskin,1990,0,,186,0
Buskin,1990,0,,187,0
Buskin,1990,0,,188,0
Buskin,1990,0,,189,0
Buskin,1990,0,,190,0
Buskin,1990,0,,191,0
Buskin,1990,0,,192,0
Buskin,1990,0,,193,0
Buskin,1990,0,,194,0
Buskin,1990,1,,195,1
Buskin,1990,0,,196,1
Buskin,1990,0,,197,1
Buskin,1990,0,,198,1
Buskin,1990,1,,199,2
Buskin,1990,4,,200,6
Buskin,1990,38,,201,44
Buskin,1990,492,,202,536
Buskin,1990,69,,203,605
Buskin,1990,21,,204,626
Buskin,1990,52,,205,678
Buskin,1990,65,,206,743
Buskin,1990,8,,207,751
Buskin,1990,145,,208,896
Buskin,1990,937,,209,1833
Buskin,1990,758,,210,2591
Buskin,1990,729,,211,3320
Buskin,1990,297,,212,3617
Buskin,1990,731,,213,4348
Buskin,1990,1422,,214,5770
Buskin,1990,1422,,215,7192
Buskin,1990,1422,,216,8614
Buskin,1990,1422,,217,10036
Buskin,1990,1422,,218,11458
Buskin,1990,1422,,219,12880
Buskin,1990,1422,,220,14302
Buskin,1990,1422,,221,15724
Buskin,1990,1422,,222,17146
Buskin,1990,1422,,223,18568
Buskin,1990,1422,,224,19990
Buskin,1990,1422,,225,21412
Buskin,1990,1422,,226,22834
Buskin,1990,1422,,227,24256
Buskin,1990,1652,,228,25908
Buskin,1990,551,,229,26459
Buskin,1990,1151,,230,27610
Buskin,1990,1102,,231,28712
Buskin,1990,482,,232,29194
Buskin,1990,194,,233,29388
Buskin,1990,518,,234,29906
Buskin,1990,190,,235,30096
Buskin,1990,326,,236,30422
Buskin,1990,1001,,237,31423
Buskin,1990,538,,238,31961
Buskin,1990,1098,,239,33059
Buskin,1990,842,,240,33901
Buskin,1990,791,,241,34692
Buskin,1990,141,,242,34833
Buskin,1990,376,,243,35209
Buskin,1990,367,,244,35576
Buskin,1990,521,,245,36097
Buskin,1990,2653,,246,38750
Buskin,1990,638,,247,39388
Buskin,1990,377,,248,39765
Buskin,1990,226,,249,39991
Buskin,1990,147,,250,40138
Buskin,1990,832,,251,40970
Buskin,1990,441,,252,41411
Buskin,1990,35,,253,41446
Buskin,1990,599,,254,42045
Buskin,1990,360,,255,42405
Buskin,1990,239,,256,42644
Buskin,1990,124,,257,42768
Buskin,1990,84,,258,42852
Buskin,1990,0,,259,42852
Buskin,1990,0,,260,42852
Buskin,1990,0,,261,42852
Buskin,1990,0,,262,42852
Buskin,1990,0,,263,42852
Buskin,1990,0,,264,42852
Buskin,1990,0,,265,42852
Buskin,1990,11,,266,42863
Buskin,1990,15,,267,42878
Buskin,1990,7,,268,42885
Buskin,1990,4,,269,42889
Buskin,1990,9818,,270,52707
Buskin,1990,0,,271,52707
Buskin,1990,0,,272,52707
Buskin,1990,0,,273,52707
Buskin,1990,0,,274,52707
Buskin,1990,0,,275,52707
Buskin,1990,0,,276,52707
Buskin,1990,0,,277,52707
Buskin,1990,0,,278,52707
Buskin,1990,0,,279,52707
Buskin,1990,0,,280,52707
Buskin,1990,0,,281,52707
Buskin,1989,0,,173,0
Buskin,1989,0,,174,0
Buskin,1989,0,,175,0
Buskin,1989,0,,176,0
Buskin,1989,0,,177,0
Buskin,1989,0,,178,0
Buskin,1989,0,,179,0
Buskin,1989,0,,180,0
Buskin,1989,0,,181,0
Buskin,1989,0,,182,0
Buskin,1989,3,,183,3
Buskin,1989,3,,184,6
Buskin,1989,4,,185,10
Buskin,1989,3,,186,13
Buskin,1989,0,,187,13
Buskin,1989,23,,188,36
Buskin,1989,9,,189,45
Buskin,1989,31,,190,76
Buskin,1989,19,,191,95
Buskin,1989,0,,192,95
Buskin,1989,18,,193,113
Buskin,1989,14,,194,127
Buskin,1989,2,,195,129
Buskin,1989,10,,196,139
Buskin,1989,62,,197,201
Buskin,1989,91,,198,292
Buskin,1989,110,,199,402
Buskin,1989,106,,200,508
Buskin,1989,92,,201,600
Buskin,1989,284,,202,884
Buskin,1989,157,,203,1041
Buskin,1989,342,,204,1383
Buskin,1989,650,,205,2033
Buskin,1989,615,,206,2648
Buskin,1989,1967,,207,4615
Buskin,1989,1639,,208,6254
Buskin,1989,2896,,209,9150
Buskin,1989,4019,,210,13169
Buskin,1989,3387,,211,16556
Buskin,1989,2790,,212,19346
Buskin,1989,5000,,213,24346
Buskin,1989,3430,,214,27776
Buskin,1989,6797,,215,34573
Buskin,1989,4530,,216,39103
Buskin,1989,7280,,217,46383
Buskin,1989,9465,,218,55848
Buskin,1989,9280,,219,65128
Buskin,1989,8295,,220,73423
Buskin,1989,8860,,221,82283
Buskin,1989,7246,,222,89529
Buskin,1989,2204,,223,91733
Buskin,1989,4251,,224,95984
Buskin,1989,3000,,225,98984
Buskin,1989,3296,,226,102280
Buskin,1989,3332,,227,105612
Buskin,1989,5613,,228,111225
Buskin,1989,2895,,229,114120
Buskin,1989,12056,,230,126176
Buskin,1989,6374,,231,132550
Buskin,1989,2150,,232,134700
Buskin,1989,1400,,233,136100
Buskin,1989,1135,,234,137235
Buskin,1989,904,,235,138139
Buskin,1989,1454,,236,139593
Buskin,1989,4365,,237,143958
Buskin,1989,3089,,238,147047
Buskin,1989,825,,239,147872
Buskin,1989,562,,240,148434
Buskin,1989,565,,241,148999
Buskin,1989,969,,242,149968
Buskin,1989,1303,,243,151271
Buskin,1989,2124,,244,153395
Buskin,1989,1883,,245,155278
Buskin,1989,295,,246,155573
Buskin,1989,100,,247,155673
Buskin,1989,290,,248,155963
Buskin,1989,352,,249,156315
Buskin,1989,700,,250,157015
Buskin,1989,398,,251,157413
Buskin,1989,807,,252,158220
Buskin,1989,115,,253,158335
Buskin,1989,241,,254,158576
Buskin,1989,155,,255,158731
Buskin,1989,88,,256,158819
Buskin,1989,52,,257,158871
Buskin,1989,38,,258,158909
Buskin,1989,34,,259,158943
Buskin,1989,80,,260,159023
Buskin,1989,57,,261,159080
Buskin,1989,30,,262,159110
Buskin,1989,5,,263,159115
Buskin,1989,0,,264,159115
Buskin,1989,4,,265,159119
Buskin,1989,1,,266,159120
Buskin,1989,1,,267,159121
Buskin,1989,0,,268,159121
Buskin,1989,1,,269,159122
Buskin,1989,0,,270,159122
Buskin,1989,0,,271,159122
Buskin,1989,1,,272,159123
Buskin,1989,0,,273,159123
Buskin,1989,0,,274,159123
Buskin,1989,0,,275,159123
Buskin,1989,0,,276,159123
Buskin,1989,0,,277,159123
Buskin,1989,0,,278,159123
Buskin,1989,0,,279,159123
Buskin,1989,0,,280,159123
Buskin,1989,0,,281,159123
Buskin,1988,0,,174,0
Buskin,1988,0,,175,0
Buskin,1988,1,,176,1
Buskin,1988,0,,177,1
Buskin,1988,0,,178,1
Buskin,1988,0,,179,1
Buskin,1988,0,,180,1
Buskin,1988,0,,181,1
Buskin,1988,0,,182,1
Buskin,1988,0,,183,1
Buskin,1988,0,,184,1
Buskin,1988,0,,185,1
Buskin,1988,1,,186,2
Buskin,1988,0,,187,2
Buskin,1988,2,,188,4
Buskin,1988,0,,189,4
Buskin,1988,0,,190,4
Buskin,1988,1,,191,5
Buskin,1988,4,,192,9
Buskin,1988,3,,193,12
Buskin,1988,3,,194,15
Buskin,1988,16,,195,31
Buskin,1988,2,,196,33
Buskin,1988,19,,197,52
Buskin,1988,16,,198,68
Buskin,1988,29,,199,97
Buskin,1988,3,,200,100
Buskin,1988,68,,201,168
Buskin,1988,47,,202,215
Buskin,1988,100,,203,315
Buskin,1988,247,,204,562
Buskin,1988,233,,205,795
Buskin,1988,315,,206,1110
Buskin,1988,644,,207,1754
Buskin,1988,785,,208,2539
Buskin,1988,955,,209,3494
Buskin,1988,1189,,210,4683
Buskin,1988,3459,,211,8142
Buskin,1988,3344,,212,11486
Buskin,1988,5956,,213,17442
Buskin,1988,6190,,214,23632
Buskin,1988,11061,,215,34693
Buskin,1988,11938,,216,46631
Buskin,1988,15513,,217,62144
Buskin,1988,10183,,218,72327
Buskin,1988,10741,,219,83068
Buskin,1988,20936,,220,104004
Buskin,1988,9330,,221,113334
Buskin,1988,16595,,222,129929
Buskin,1988,13714,,223,143643
Buskin,1988,7981,,224,151624
Buskin,1988,5825,,225,157449
Buskin,1988,4553,,226,162002
Buskin,1988,3857,,227,165859
Buskin,1988,3074,,228,168933
Buskin,1988,4472,,229,173405
Buskin,1988,9132,,230,182537
Buskin,1988,2271,,231,184808
Buskin,1988,977,,232,185785
Buskin,1988,2311,,233,188096
Buskin,1988,2870,,234,190966
Buskin,1988,491,,235,191457
Buskin,1988,776,,236,192233
Buskin,1988,713,,237,192946
Buskin,1988,1172,,238,194118
Buskin,1988,5392,,239,199510
Buskin,1988,589,,240,200099
Buskin,1988,500,,241,200599
Buskin,1988,700,,242,201299
Buskin,1988,600,,243,201899
Buskin,1988,567,,244,202466
Buskin,1988,464,,245,202930
Buskin,1988,0,,246,202930
Buskin,1988,0,,247,202930
Buskin,1988,70,,248,203000
Buskin,1988,0,,249,203000
Buskin,1988,79,,250,203079
Buskin,1988,569,,251,203648
Buskin,1988,0,,252,203648
Buskin,1988,0,,253,203648
Buskin,1988,0,,254,203648
Buskin,1988,0,,255,203648
Buskin,1988,0,,256,203648
Buskin,1988,0,,257,203648
Buskin,1988,0,,258,203648
Buskin,1988,0,,259,203648
Buskin,1988,0,,260,203648
Buskin,1988,0,,261,203648
Buskin,1988,0,,262,203648
Buskin,1988,0,,263,203648
Buskin,1988,0,,264,203648
Buskin,1988,0,,265,203648
Buskin,1988,0,,266,203648
Buskin,1988,0,,267,203648
Buskin,1988,0,,268,203648
Buskin,1988,0,,269,203648
Buskin,1988,0,,270,203648
Buskin,1988,0,,271,203648
Buskin,1988,0,,272,203648
Buskin,1988,0,,273,203648
Buskin,1988,0,,274,203648
Buskin,1988,0,,275,203648
Buskin,1988,0,,276,203648
Buskin,1988,0,,277,203648
Buskin,1988,0,,278,203648
Buskin,1988,0,,279,203648
Buskin,1988,0,,280,203648
Buskin,1988,0,,281,203648
Buskin,1988,0,,282,203648
Buskin,1987,0,,173,0
Buskin,1987,0,,174,0
Buskin,1987,0,,175,0
Buskin,1987,0,,176,0
Buskin,1987,0,,177,0
Buskin,1987,0,,178,0
Buskin,1987,0,,179,0
Buskin,1987,0,,180,0
Buskin,1987,0,,181,0
Buskin,1987,0,,182,0
Buskin,1987,1,,183,1
Buskin,1987,2,,184,3
Buskin,1987,1,,185,4
Buskin,1987,0,,186,4
Buskin,1987,0,,187,4
Buskin,1987,1,,188,5
Buskin,1987,0,,189,5
Buskin,1987,4,,190,9
Buskin,1987,0,,191,9
Buskin,1987,2,,192,11
Buskin,1987,2,,193,13
Buskin,1987,3,,194,16
Buskin,1987,2,,195,18
Buskin,1987,13,,196,31
Buskin,1987,6,,197,37
Buskin,1987,17,,198,54
Buskin,1987,6,,199,60
Buskin,1987,7,,200,67
Buskin,1987,41,,201,108
Buskin,1987,35,,202,143
Buskin,1987,104,,203,247
Buskin,1987,30,,204,277
Buskin,1987,46,,205,323
Buskin,1987,154,,206,477
Buskin,1987,127,,207,604
Buskin,1987,159,,208,763
Buskin,1987,178,,209,941
Buskin,1987,346,,210,1287
Buskin,1987,727,,211,2014
Buskin,1987,1244,,212,3258
Buskin,1987,1494,,213,4752
Buskin,1987,864,,214,5616
Buskin,1987,1378,,215,6994
Buskin,1987,1117,,216,8111
Buskin,1987,926,,217,9037
Buskin,1987,781,,218,9818
Buskin,1987,928,,219,10746
Buskin,1987,693,,220,11439
Buskin,1987,771,,221,12210
Buskin,1987,661,,222,12871
Buskin,1987,2135,,223,15006
Buskin,1987,1208,,224,16214
Buskin,1987,731,,225,16945
Buskin,1987,394,,226,17339
Buskin,1987,214,,227,17553
Buskin,1987,251,,228,17804
Buskin,1987,261,,229,18065
Buskin,1987,229,,230,18294
Buskin,1987,346,,231,18640
Buskin,1987,481,,232,19121
Buskin,1987,409,,233,19530
Buskin,1987,405,,234,19935
Buskin,1987,360,,235,20295
Buskin,1987,856,,236,21151
Buskin,1987,497,,237,21648
Buskin,1987,602,,238,22250
Buskin,1987,199,,239,22449
Buskin,1987,214,,240,22663
Buskin,1987,433,,241,23096
Buskin,1987,402,,242,23498
Buskin,1987,230,,243,23728
Buskin,1987,439,,244,24167
Buskin,1987,554,,245,24721
Buskin,1987,331,,246,25052
Buskin,1987,333,,247,25385
Buskin,1987,273,,248,25658
Buskin,1987,933,,249,26591
Buskin,1987,692,,250,27283
Buskin,1987,30,,251,27313
Buskin,1987,306,,252,27619
Buskin,1987,110,,253,27729
Buskin,1987,23,,254,27752
Buskin,1987,5,,255,27757
Buskin,1987,21,,256,27778
Buskin,1987,3,,257,27781
Buskin,1987,34,,258,27815
Buskin,1987,57,,259,27872
Buskin,1987,12,,260,27884
Buskin,1987,5,,261,27889
Buskin,1987,3,,262,27892
Buskin,1987,0,,263,27892
Buskin,1987,0,,264,27892
Buskin,1987,0,,265,27892
Buskin,1987,0,,266,27892
Buskin,1987,0,,267,27892
Buskin,1987,0,,268,27892
Buskin,1987,0,,269,27892
Buskin,1987,0,,270,27892
Buskin,1987,0,,271,27892
Buskin,1987,0,,272,27892
Buskin,1987,0,,273,27892
Buskin,1987,0,,274,27892
Buskin,1987,0,,275,27892
Buskin,1987,0,,276,27892
Buskin,1987,0,,277,27892
Buskin,1987,0,,278,27892
Buskin,1987,0,,279,27892
Buskin,1987,0,,280,27892
Buskin,1987,0,,281,27892
Buskin,1986,0,,173,0
Buskin,1986,0,,174,0
Buskin,1986,0,,175,0
Buskin,1986,0,,176,0
Buskin,1986,0,,177,0
Buskin,1986,0,,178,0
Buskin,1986,0,,179,0
Buskin,1986,0,,180,0
Buskin,1986,0,,181,0
Buskin,1986,0,,182,0
Buskin,1986,0,,183,0
Buskin,1986,0,,184,0
Buskin,1986,0,,185,0
Buskin,1986,0,,186,0
Buskin,1986,0,,187,0
Buskin,1986,0,,188,0
Buskin,1986,0,,189,0
Buskin,1986,1,,190,1
Buskin,1986,5,,191,6
Buskin,1986,17,,192,23
Buskin,1986,12,,193,35
Buskin,1986,11,,194,46
Buskin,1986,70,,195,116
Buskin,1986,11,,196,127
Buskin,1986,13,,197,140
Buskin,1986,60,,198,200
Buskin,1986,74,,199,274
Buskin,1986,154,,200,428
Buskin,1986,314,,201,742
Buskin,1986,204,,202,946
Buskin,1986,228,,203,1174
Buskin,1986,331,,204,1505
Buskin,1986,107,,205,1612
Buskin,1986,359,,206,1971
Buskin,1986,331,,207,2302
Buskin,1986,286,,208,2588
Buskin,1986,942,,209,3530
Buskin,1986,629,,210,4159
Buskin,1986,1063,,211,5222
Buskin,1986,1457,,212,6679
Buskin,1986,897,,213,7576
Buskin,1986,1676,,214,9252
Buskin,1986,5406,,215,14658
Buskin,1986,3312,,216,17970
Buskin,1986,4266,,217,22236
Buskin,1986,3576,,218,25812
Buskin,1986,3745,,219,29557
Buskin,1986,3946,,220,33503
Buskin,1986,4148,,221,37651
Buskin,1986,2833,,222,40484
Buskin,1986,8024,,223,48508
Buskin,1986,5063,,224,53571
Buskin,1986,2743,,225,56314
Buskin,1986,1575,,226,57889
Buskin,1986,3008,,227,60897
Buskin,1986,1027,,228,61924
Buskin,1986,781,,229,62705
Buskin,1986,2488,,230,65193
Buskin,1986,537,,231,65730
Buskin,1986,180,,232,65910
Buskin,1986,225,,233,66135
Buskin,1986,577,,234,66712
Buskin,1986,1065,,235,67777
Buskin,1986,565,,236,68342
Buskin,1986,2073,,237,70415
Buskin,1986,6104,,238,76519
Buskin,1986,4191,,239,80710
Buskin,1986,1058,,240,81768
Buskin,1986,530,,241,82298
Buskin,1986,1357,,242,83655
Buskin,1986,1565,,243,85220
Buskin,1986,874,,244,86094
Buskin,1986,968,,245,87062
Buskin,1986,770,,246,87832
Buskin,1986,427,,247,88259
Buskin,1986,1298,,248,89557
Buskin,1986,1860,,249,91417
Buskin,1986,3463,,250,94880
Buskin,1986,221,,251,95101
Buskin,1986,150,,252,95251
Buskin,1986,209,,253,95460
Buskin,1986,585,,254,96045
Buskin,1986,680,,255,96725
Buskin,1986,716,,256,97441
Buskin,1986,456,,257,97897
Buskin,1986,345,,258,98242
Buskin,1986,209,,259,98451
Buskin,1986,132,,260,98583
Buskin,1986,94,,261,98677
Buskin,1986,75,,262,98752
Buskin,1986,87,,263,98839
Buskin,1986,29,,264,98868
Buskin,1986,21,,265,98889
Buskin,1986,4,,266,98893
Buskin,1986,2,,267,98895
Buskin,1986,2,,268,98897
Buskin,1986,34,,269,98931
Buskin,1986,14,,270,98945
Buskin,1986,2,,271,98947
Buskin,1986,2,,272,98949
Buskin,1986,0,,273,98949
Buskin,1986,9,,274,98958
Buskin,1986,0,,275,98958
Buskin,1986,0,,276,98958
Buskin,1986,0,,277,98958
Buskin,1986,0,,278,98958
Buskin,1986,0,,279,98958
Buskin,1986,0,,280,98958
Buskin,1986,0,,281,98958
Buskin,1985,1,,173,1
Buskin,1985,1,,174,2
Buskin,1985,0,,175,2
Buskin,1985,0,,176,2
Buskin,1985,0,,177,2
Buskin,1985,0,,178,2
Buskin,1985,1,,179,3
Buskin,1985,0,,180,3
Buskin,1985,0,,181,3
Buskin,1985,2,,182,5
Buskin,1985,0,,183,5
Buskin,1985,1,,184,6
Buskin,1985,1,,185,7
Buskin,1985,0,,186,7
Buskin,1985,3,,187,10
Buskin,1985,12,,188,22
Buskin,1985,7,,189,29
Buskin,1985,5,,190,34
Buskin,1985,0,,191,34
Buskin,1985,7,,192,41
Buskin,1985,2,,193,43
Buskin,1985,3,,194,46
Buskin,1985,2,,195,48
Buskin,1985,38,,196,86
Buskin,1985,11,,197,97
Buskin,1985,18,,198,115
Buskin,1985,150,,199,265
Buskin,1985,810,,200,1075
Buskin,1985,810,,201,1885
Buskin,1985,811,,202,2696
Buskin,1985,811,,203,3507
Buskin,1985,834,,204,4341
Buskin,1985,1918,,205,6259
Buskin,1985,825,,206,7084
Buskin,1985,1507,,207,8591
Buskin,1985,2803,,208,11394
Buskin,1985,2393,,209,13787
Buskin,1985,3863,,210,17650
Buskin,1985,4466,,211,22116
Buskin,1985,2247,,212,24363
Buskin,1985,854,,213,25217
Buskin,1985,4979,,214,30196
Buskin,1985,12408,,215,42604
Buskin,1985,11414,,216,54018
Buskin,1985,10505,,217,64523
Buskin,1985,11021,,218,75544
Buskin,1985,7630,,219,83174
Buskin,1985,5392,,220,88566
Buskin,1985,8448,,221,97014
Buskin,1985,9255,,222,106269
Buskin,1985,4349,,223,110618
Buskin,1985,5838,,224,116456
Buskin,1985,3619,,225,120075
Buskin,1985,2883,,226,122958
Buskin,1985,2945,,227,125903
Buskin,1985,1311,,228,127214
Buskin,1985,908,,229,128122
Buskin,1985,810,,230,128932
Buskin,1985,819,,231,129751
Buskin,1985,239,,232,129990
Buskin,1985,534,,233,130524
Buskin,1985,2069,,234,132593
Buskin,1985,426,,235,133019
Buskin,1985,266,,236,133285
Buskin,1985,385,,237,133670
Buskin,1985,546,,238,134216
Buskin,1985,658,,239,134874
Buskin,1985,778,,240,135652
Buskin,1985,1124,,241,136776
Buskin,1985,2585,,242,139361
Buskin,1985,1515,,243,140876
Buskin,1985,945,,244,141821
Buskin,1985,888,,245,142709
Buskin,1985,2020,,246,144729
Buskin,1985,1096,,247,145825
Buskin,1985,881,,248,146706
Buskin,1985,700,,249,147406
Buskin,1985,1030,,250,148436
Buskin,1985,975,,251,149411
Buskin,1985,342,,252,149753
Buskin,1985,547,,253,150300
Buskin,1985,224,,254,150524
Buskin,1985,420,,255,150944
Buskin,1985,366,,256,151310
Buskin,1985,489,,257,151799
Buskin,1985,171,,258,151970
Buskin,1985,141,,259,152111
Buskin,1985,187,,260,152298
Buskin,1985,238,,261,152536
Buskin,1985,33,,262,152569
Buskin,1985,18,,263,152587
Buskin,1985,56,,264,152643
Buskin,1985,310,,265,152953
Buskin,1985,7,,266,152960
Buskin,1985,40,,267,153000
Buskin,1985,0,,268,153000
Buskin,1985,24,,269,153024
Buskin,1985,0,,270,153024
Buskin,1985,2,,271,153026
Buskin,1985,0,,272,153026
Buskin,1985,0,,273,153026
Buskin,1985,0,,274,153026
Buskin,1985,0,,275,153026
Buskin,1985,0,,276,153026
Buskin,1985,1,,277,153027
Buskin,1985,1,,278,153028
Buskin,1985,18000,,279,171028
Buskin,1985,0,,280,171028
Buskin,1985,0,,281,171028
Ayakulik,2013,0,,152,0
Ayakulik,2013,0,,153,0
Ayakulik,2013,0,,154,0
Ayakulik,2013,0,,155,0
Ayakulik,2013,0,,156,0
Ayakulik,2013,0,,157,0
Ayakulik,2013,0,,158,0
Ayakulik,2013,0,,159,0
Ayakulik,2013,0,,160,0
Ayakulik,2013,0,,161,0
Ayakulik,2013,0,,162,0
Ayakulik,2013,0,,163,0
Ayakulik,2013,0,,164,0
Ayakulik,2013,0,,165,0
Ayakulik,2013,0,,166,0
Ayakulik,2013,0,,167,0
Ayakulik,2013,0,,168,0
Ayakulik,2013,0,,169,0
Ayakulik,2013,0,,170,0
Ayakulik,2013,0,,171,0
Ayakulik,2013,0,,172,0
Ayakulik,2013,0,,173,0
Ayakulik,2013,0,,174,0
Ayakulik,2013,1,,175,1
Ayakulik,2013,0,,176,1
Ayakulik,2013,7,,177,8
Ayakulik,2013,2,,178,10
Ayakulik,2013,1,,179,11
Ayakulik,2013,1,,180,12
Ayakulik,2013,0,,181,12
Ayakulik,2013,14,,182,26
Ayakulik,2013,2,,183,28
Ayakulik,2013,0,,184,28
Ayakulik,2013,0,,185,28
Ayakulik,2013,0,,186,28
Ayakulik,2013,0,,187,28
Ayakulik,2013,0,,188,28
Ayakulik,2013,0,,189,28
Ayakulik,2013,0,,190,28
Ayakulik,2013,0,,191,28
Ayakulik,2013,0,,192,28
Ayakulik,2013,0,,193,28
Ayakulik,2013,0,,194,28
Ayakulik,2013,0,,195,28
Ayakulik,2013,0,,196,28
Ayakulik,2013,0,,197,28
Ayakulik,2013,0,,198,28
Ayakulik,2013,0,,199,28
Ayakulik,2013,0,,200,28
Ayakulik,2013,0,,201,28
Ayakulik,2013,0,,202,28
Ayakulik,2013,0,,203,28
Ayakulik,2013,0,,204,28
Ayakulik,2013,0,,205,28
Ayakulik,2013,0,,206,28
Ayakulik,2013,0,,207,28
Ayakulik,2013,0,,208,28
Ayakulik,2013,0,,209,28
Ayakulik,2013,0,,210,28
Ayakulik,2013,0,,211,28
Ayakulik,2013,0,,212,28
Ayakulik,2013,0,,213,28
Ayakulik,2013,0,,214,28
Ayakulik,2013,0,,215,28
Ayakulik,2013,0,,216,28
Ayakulik,2013,0,,217,28
Ayakulik,2013,0,,218,28
Ayakulik,2013,0,,219,28
Ayakulik,2013,0,,220,28
Ayakulik,2013,0,,221,28
Ayakulik,2013,0,,222,28
Ayakulik,2013,0,,223,28
Ayakulik,2013,0,,224,28
Ayakulik,2013,0,,225,28
Ayakulik,2013,0,,226,28
Ayakulik,2013,0,,227,28
Ayakulik,2013,0,,228,28
Ayakulik,2013,0,,229,28
Ayakulik,2013,0,,230,28
Ayakulik,2013,0,,231,28
Ayakulik,2013,0,,232,28
Ayakulik,2013,0,,233,28
Ayakulik,2013,0,,234,28
Ayakulik,2013,0,,235,28
Ayakulik,2013,0,,236,28
Ayakulik,2013,0,,237,28
Ayakulik,2013,0,,238,28
Ayakulik,2013,0,,239,28
Ayakulik,2013,0,,240,28
Ayakulik,2013,0,,241,28
Ayakulik,2013,0,,242,28
Ayakulik,2013,0,,243,28
Ayakulik,2013,0,,244,28
Ayakulik,2013,0,,245,28
Ayakulik,2013,0,,246,28
Ayakulik,2013,0,,247,28
Ayakulik,2013,0,,248,28
Ayakulik,2013,0,,249,28
Ayakulik,2013,0,,250,28
Ayakulik,2013,0,,251,28
Ayakulik,2013,0,,252,28
Ayakulik,2013,0,,253,28
Ayakulik,2013,0,,254,28
Ayakulik,2013,0,,255,28
Ayakulik,2013,0,,256,28
Ayakulik,2013,0,,257,28
Ayakulik,2013,0,,258,28
Ayakulik,2013,0,,259,28
Ayakulik,2013,0,,260,28
Ayakulik,2013,0,,261,28
Ayakulik,2013,0,,262,28
Ayakulik,2013,0,,263,28
Ayakulik,2013,0,,264,28
Ayakulik,2013,0,,265,28
Ayakulik,2013,0,,266,28
Ayakulik,2013,0,,267,28
Ayakulik,2013,0,,268,28
Ayakulik,2013,0,,269,28
Ayakulik,2013,0,,270,28
Ayakulik,2013,0,,271,28
Ayakulik,2013,0,,272,28
Ayakulik,2013,0,,273,28
Ayakulik,2012,0,,153,0
Ayakulik,2012,0,,154,0
Ayakulik,2012,0,,155,0
Ayakulik,2012,0,,156,0
Ayakulik,2012,0,,157,0
Ayakulik,2012,0,,158,0
Ayakulik,2012,0,,159,0
Ayakulik,2012,0,,160,0
Ayakulik,2012,0,,161,0
Ayakulik,2012,0,,162,0
Ayakulik,2012,0,,163,0
Ayakulik,2012,0,,164,0
Ayakulik,2012,0,,165,0
Ayakulik,2012,0,,166,0
Ayakulik,2012,0,,167,0
Ayakulik,2012,0,,168,0
Ayakulik,2012,0,,169,0
Ayakulik,2012,0,,170,0
Ayakulik,2012,0,,171,0
Ayakulik,2012,0,,172,0
Ayakulik,2012,5,,173,5
Ayakulik,2012,7,,174,12
Ayakulik,2012,0,,175,12
Ayakulik,2012,0,,176,12
Ayakulik,2012,5,,177,17
Ayakulik,2012,2,,178,19
Ayakulik,2012,19,,179,38
Ayakulik,2012,8,,180,46
Ayakulik,2012,14,,181,60
Ayakulik,2012,12,,182,72
Ayakulik,2012,12,,183,84
Ayakulik,2012,7,,184,91
Ayakulik,2012,40,,185,131
Ayakulik,2012,24,,186,155
Ayakulik,2012,12,,187,167
Ayakulik,2012,37,,188,204
Ayakulik,2012,9,,189,213
Ayakulik,2012,15,,190,228
Ayakulik,2012,123,,191,351
Ayakulik,2012,267,,192,618
Ayakulik,2012,713,,193,1331
Ayakulik,2012,700,,194,2031
Ayakulik,2012,855,,195,2886
Ayakulik,2012,96,,196,2982
Ayakulik,2012,809,,197,3791
Ayakulik,2012,7,,198,3798
Ayakulik,2012,144,,199,3942
Ayakulik,2012,324,,200,4266
Ayakulik,2012,2112,,201,6378
Ayakulik,2012,3700,,202,10078
Ayakulik,2012,2529,,203,12607
Ayakulik,2012,1173,,204,13780
Ayakulik,2012,9794,,205,23574
Ayakulik,2012,22316,,206,45890
Ayakulik,2012,11408,,207,57298
Ayakulik,2012,8102,,208,65400
Ayakulik,2012,6902,,209,72302
Ayakulik,2012,22784,,210,95086
Ayakulik,2012,13252,,211,108338
Ayakulik,2012,18630,,212,126968
Ayakulik,2012,3284,,213,130252
Ayakulik,2012,3606,,214,133858
Ayakulik,2012,368,,215,134226
Ayakulik,2012,28798,,216,163024
Ayakulik,2012,10202,,217,173226
Ayakulik,2012,31955,,218,205181
Ayakulik,2012,17073,,219,222254
Ayakulik,2012,40306,,220,262560
Ayakulik,2012,31209,,221,293769
Ayakulik,2012,13229,,222,306998
Ayakulik,2012,18407,,223,325405
Ayakulik,2012,6799,,224,332204
Ayakulik,2012,19604,,225,351808
Ayakulik,2012,12105,,226,363913
Ayakulik,2012,4912,,227,368825
Ayakulik,2012,9668,,228,378493
Ayakulik,2012,1527,,229,380020
Ayakulik,2012,6713,,230,386733
Ayakulik,2012,1941,,231,388674
Ayakulik,2012,6003,,232,394677
Ayakulik,2012,7941,,233,402618
Ayakulik,2012,2585,,234,405203
Ayakulik,2012,2345,,235,407548
Ayakulik,2012,6611,,236,414159
Ayakulik,2012,5280,,237,419439
Ayakulik,2012,5875,,238,425314
Ayakulik,2012,4532,,239,429846
Ayakulik,2012,3125,,240,432971
Ayakulik,2012,3501,,241,436472
Ayakulik,2012,3603,,242,440075
Ayakulik,2012,12533,,243,452608
Ayakulik,2012,3000,,244,455608
Ayakulik,2012,4300,,245,459908
Ayakulik,2012,0,,246,459908
Ayakulik,2012,0,,247,459908
Ayakulik,2012,0,,248,459908
Ayakulik,2012,0,,249,459908
Ayakulik,2012,0,,250,459908
Ayakulik,2012,0,,251,459908
Ayakulik,2012,0,,252,459908
Ayakulik,2012,0,,253,459908
Ayakulik,2012,0,,254,459908
Ayakulik,2012,0,,255,459908
Ayakulik,2012,0,,256,459908
Ayakulik,2012,0,,257,459908
Ayakulik,2012,0,,258,459908
Ayakulik,2012,0,,259,459908
Ayakulik,2012,0,,260,459908
Ayakulik,2012,0,,261,459908
Ayakulik,2012,0,,262,459908
Ayakulik,2012,0,,263,459908
Ayakulik,2012,0,,264,459908
Ayakulik,2012,0,,265,459908
Ayakulik,2012,0,,266,459908
Ayakulik,2012,0,,267,459908
Ayakulik,2012,0,,268,459908
Ayakulik,2012,0,,269,459908
Ayakulik,2012,0,,270,459908
Ayakulik,2012,0,,271,459908
Ayakulik,2012,0,,272,459908
Ayakulik,2012,0,,273,459908
Ayakulik,2012,0,,274,459908
Ayakulik,2011,0,,152,0
Ayakulik,2011,0,,153,0
Ayakulik,2011,0,,154,0
Ayakulik,2011,0,,155,0
Ayakulik,2011,0,,156,0
Ayakulik,2011,0,,157,0
Ayakulik,2011,0,,158,0
Ayakulik,2011,0,,159,0
Ayakulik,2011,0,,160,0
Ayakulik,2011,0,,161,0
Ayakulik,2011,0,,162,0
Ayakulik,2011,0,,163,0
Ayakulik,2011,0,,164,0
Ayakulik,2011,0,,165,0
Ayakulik,2011,0,,166,0
Ayakulik,2011,0,,167,0
Ayakulik,2011,0,,168,0
Ayakulik,2011,0,,169,0
Ayakulik,2011,0,,170,0
Ayakulik,2011,0,,171,0
Ayakulik,2011,7,,172,7
Ayakulik,2011,9,,173,16
Ayakulik,2011,0,,174,16
Ayakulik,2011,15,,175,31
Ayakulik,2011,21,,176,52
Ayakulik,2011,64,,177,116
Ayakulik,2011,2,,178,118
Ayakulik,2011,72,,179,190
Ayakulik,2011,9,,180,199
Ayakulik,2011,35,,181,234
Ayakulik,2011,14,,182,248
Ayakulik,2011,13,,183,261
Ayakulik,2011,23,,184,284
Ayakulik,2011,6,,185,290
Ayakulik,2011,6,,186,296
Ayakulik,2011,20,,187,316
Ayakulik,2011,6,,188,322
Ayakulik,2011,65,,189,387
Ayakulik,2011,269,,190,656
Ayakulik,2011,74,,191,730
Ayakulik,2011,59,,192,789
Ayakulik,2011,195,,193,984
Ayakulik,2011,40,,194,1024
Ayakulik,2011,124,,195,1148
Ayakulik,2011,132,,196,1280
Ayakulik,2011,336,,197,1616
Ayakulik,2011,335,,198,1951
Ayakulik,2011,83,,199,2034
Ayakulik,2011,41,,200,2075
Ayakulik,2011,29,,201,2104
Ayakulik,2011,81,,202,2185
Ayakulik,2011,199,,203,2384
Ayakulik,2011,327,,204,2711
Ayakulik,2011,300,,205,3011
Ayakulik,2011,89,,206,3100
Ayakulik,2011,7,,207,3107
Ayakulik,2011,58,,208,3165
Ayakulik,2011,66,,209,3231
Ayakulik,2011,150,,210,3381
Ayakulik,2011,286,,211,3667
Ayakulik,2011,887,,212,4554
Ayakulik,2011,594,,213,5148
Ayakulik,2011,961,,214,6109
Ayakulik,2011,35,,215,6144
Ayakulik,2011,35,,216,6179
Ayakulik,2011,25,,217,6204
Ayakulik,2011,65,,218,6269
Ayakulik,2011,50,,219,6319
Ayakulik,2011,90,,220,6409
Ayakulik,2011,300,,221,6709
Ayakulik,2011,927,,222,7636
Ayakulik,2011,312,,223,7948
Ayakulik,2011,471,,224,8419
Ayakulik,2011,115,,225,8534
Ayakulik,2011,336,,226,8870
Ayakulik,2011,19,,227,8889
Ayakulik,2011,111,,228,9000
Ayakulik,2011,268,,229,9268
Ayakulik,2011,807,,230,10075
Ayakulik,2011,893,,231,10968
Ayakulik,2011,2025,,232,12993
Ayakulik,2011,700,,233,13693
Ayakulik,2011,487,,234,14180
Ayakulik,2011,365,,235,14545
Ayakulik,2011,193,,236,14738
Ayakulik,2011,364,,237,15102
Ayakulik,2011,418,,238,15520
Ayakulik,2011,598,,239,16118
Ayakulik,2011,240,,240,16358
Ayakulik,2011,733,,241,17091
Ayakulik,2011,213,,242,17304
Ayakulik,2011,402,,243,17706
Ayakulik,2011,537,,244,18243
Ayakulik,2011,231,,245,18474
Ayakulik,2011,291,,246,18765
Ayakulik,2011,183,,247,18948
Ayakulik,2011,196,,248,19144
Ayakulik,2011,203,,249,19347
Ayakulik,2011,216,,250,19563
Ayakulik,2011,615,,251,20178
Ayakulik,2011,250,,252,20428
Ayakulik,2011,0,,253,20428
Ayakulik,2011,0,,254,20428
Ayakulik,2011,0,,255,20428
Ayakulik,2011,0,,256,20428
Ayakulik,2011,0,,257,20428
Ayakulik,2011,0,,258,20428
Ayakulik,2011,0,,259,20428
Ayakulik,2011,0,,260,20428
Ayakulik,2011,0,,261,20428
Ayakulik,2011,0,,262,20428
Ayakulik,2011,0,,263,20428
Ayakulik,2011,0,,264,20428
Ayakulik,2011,0,,265,20428
Ayakulik,2011,0,,266,20428
Ayakulik,2011,0,,267,20428
Ayakulik,2011,0,,268,20428
Ayakulik,2011,0,,269,20428
Ayakulik,2011,0,,270,20428
Ayakulik,2011,0,,271,20428
Ayakulik,2011,0,,272,20428
Ayakulik,2011,0,,273,20428
Ayakulik,2010,0,,152,0
Ayakulik,2010,0,,153,0
Ayakulik,2010,0,,154,0
Ayakulik,2010,0,,155,0
Ayakulik,2010,0,,156,0
Ayakulik,2010,0,,157,0
Ayakulik,2010,0,,158,0
Ayakulik,2010,0,,159,0
Ayakulik,2010,0,,160,0
Ayakulik,2010,0,,161,0
Ayakulik,2010,0,,162,0
Ayakulik,2010,0,,163,0
Ayakulik,2010,0,,164,0
Ayakulik,2010,0,,165,0
Ayakulik,2010,0,,166,0
Ayakulik,2010,0,,167,0
Ayakulik,2010,0,,168,0
Ayakulik,2010,0,,169,0
Ayakulik,2010,0,,170,0
Ayakulik,2010,0,,171,0
Ayakulik,2010,0,,172,0
Ayakulik,2010,5,,173,5
Ayakulik,2010,1,,174,6
Ayakulik,2010,0,,175,6
Ayakulik,2010,9,,176,15
Ayakulik,2010,4,,177,19
Ayakulik,2010,4,,178,23
Ayakulik,2010,4,,179,27
Ayakulik,2010,12,,180,39
Ayakulik,2010,3,,181,42
Ayakulik,2010,3,,182,45
Ayakulik,2010,0,,183,45
Ayakulik,2010,1,,184,46
Ayakulik,2010,16,,185,62
Ayakulik,2010,13,,186,75
Ayakulik,2010,9,,187,84
Ayakulik,2010,165,,188,249
Ayakulik,2010,59,,189,308
Ayakulik,2010,146,,190,454
Ayakulik,2010,410,,191,864
Ayakulik,2010,306,,192,1170
Ayakulik,2010,4,,193,1174
Ayakulik,2010,88,,194,1262
Ayakulik,2010,781,,195,2043
Ayakulik,2010,110,,196,2153
Ayakulik,2010,907,,197,3060
Ayakulik,2010,1262,,198,4322
Ayakulik,2010,1573,,199,5895
Ayakulik,2010,332,,200,6227
Ayakulik,2010,367,,201,6594
Ayakulik,2010,3300,,202,9894
Ayakulik,2010,917,,203,10811
Ayakulik,2010,22,,204,10833
Ayakulik,2010,105,,205,10938
Ayakulik,2010,105,,206,11043
Ayakulik,2010,2100,,207,13143
Ayakulik,2010,28849,,208,41992
Ayakulik,2010,12188,,209,54180
Ayakulik,2010,25444,,210,79624
Ayakulik,2010,44211,,211,123835
Ayakulik,2010,49000,,212,172835
Ayakulik,2010,6900,,213,179735
Ayakulik,2010,14478,,214,194213
Ayakulik,2010,8175,,215,202388
Ayakulik,2010,2728,,216,205116
Ayakulik,2010,12820,,217,217936
Ayakulik,2010,52982,,218,270918
Ayakulik,2010,42510,,219,313428
Ayakulik,2010,36000,,220,349428
Ayakulik,2010,28000,,221,377428
Ayakulik,2010,38000,,222,415428
Ayakulik,2010,31000,,223,446428
Ayakulik,2010,32000,,224,478428
Ayakulik,2010,41000,,225,519428
Ayakulik,2010,13000,,226,532428
Ayakulik,2010,0,,227,532428
Ayakulik,2010,0,,228,532428
Ayakulik,2010,0,,229,532428
Ayakulik,2010,0,,230,532428
Ayakulik,2010,0,,231,532428
Ayakulik,2010,0,,232,532428
Ayakulik,2010,0,,233,532428
Ayakulik,2010,0,,234,532428
Ayakulik,2010,0,,235,532428
Ayakulik,2010,0,,236,532428
Ayakulik,2010,0,,237,532428
Ayakulik,2010,0,,238,532428
Ayakulik,2010,0,,239,532428
Ayakulik,2010,0,,240,532428
Ayakulik,2010,0,,241,532428
Ayakulik,2010,0,,242,532428
Ayakulik,2010,0,,243,532428
Ayakulik,2010,0,,244,532428
Ayakulik,2010,0,,245,532428
Ayakulik,2010,0,,246,532428
Ayakulik,2010,0,,247,532428
Ayakulik,2010,0,,248,532428
Ayakulik,2010,0,,249,532428
Ayakulik,2010,0,,250,532428
Ayakulik,2010,0,,251,532428
Ayakulik,2010,0,,252,532428
Ayakulik,2010,0,,253,532428
Ayakulik,2010,0,,254,532428
Ayakulik,2010,0,,255,532428
Ayakulik,2010,0,,256,532428
Ayakulik,2010,0,,257,532428
Ayakulik,2010,0,,258,532428
Ayakulik,2010,0,,259,532428
Ayakulik,2010,0,,260,532428
Ayakulik,2010,0,,261,532428
Ayakulik,2010,0,,262,532428
Ayakulik,2010,0,,263,532428
Ayakulik,2010,0,,264,532428
Ayakulik,2010,0,,265,532428
Ayakulik,2010,0,,266,532428
Ayakulik,2010,0,,267,532428
Ayakulik,2010,0,,268,532428
Ayakulik,2010,0,,269,532428
Ayakulik,2010,0,,270,532428
Ayakulik,2010,0,,271,532428
Ayakulik,2010,0,,272,532428
Ayakulik,2010,0,,273,532428
Ayakulik,2009,0,,152,0
Ayakulik,2009,0,,153,0
Ayakulik,2009,0,,154,0
Ayakulik,2009,0,,155,0
Ayakulik,2009,0,,156,0
Ayakulik,2009,0,,157,0
Ayakulik,2009,0,,158,0
Ayakulik,2009,0,,159,0
Ayakulik,2009,0,,160,0
Ayakulik,2009,0,,161,0
Ayakulik,2009,0,,162,0
Ayakulik,2009,0,,163,0
Ayakulik,2009,0,,164,0
Ayakulik,2009,0,,165,0
Ayakulik,2009,0,,166,0
Ayakulik,2009,0,,167,0
Ayakulik,2009,0,,168,0
Ayakulik,2009,0,,169,0
Ayakulik,2009,0,,170,0
Ayakulik,2009,0,,171,0
Ayakulik,2009,0,,172,0
Ayakulik,2009,0,,173,0
Ayakulik,2009,0,,174,0
Ayakulik,2009,2,,175,2
Ayakulik,2009,0,,176,2
Ayakulik,2009,0,,177,2
Ayakulik,2009,1,,178,3
Ayakulik,2009,0,,179,3
Ayakulik,2009,13,,180,16
Ayakulik,2009,8,,181,24
Ayakulik,2009,7,,182,31
Ayakulik,2009,39,,183,70
Ayakulik,2009,24,,184,94
Ayakulik,2009,143,,185,237
Ayakulik,2009,91,,186,328
Ayakulik,2009,19,,187,347
Ayakulik,2009,65,,188,412
Ayakulik,2009,79,,189,491
Ayakulik,2009,71,,190,562
Ayakulik,2009,183,,191,745
Ayakulik,2009,148,,192,893
Ayakulik,2009,366,,193,1259
Ayakulik,2009,11,,194,1270
Ayakulik,2009,283,,195,1553
Ayakulik,2009,165,,196,1718
Ayakulik,2009,94,,197,1812
Ayakulik,2009,562,,198,2374
Ayakulik,2009,12,,199,2386
Ayakulik,2009,396,,200,2782
Ayakulik,2009,481,,201,3263
Ayakulik,2009,279,,202,3542
Ayakulik,2009,3,,203,3545
Ayakulik,2009,0,,204,3545
Ayakulik,2009,23,,205,3568
Ayakulik,2009,35,,206,3603
Ayakulik,2009,47,,207,3650
Ayakulik,2009,10,,208,3660
Ayakulik,2009,2,,209,3662
Ayakulik,2009,99,,210,3761
Ayakulik,2009,44,,211,3805
Ayakulik,2009,777,,212,4582
Ayakulik,2009,137,,213,4719
Ayakulik,2009,837,,214,5556
Ayakulik,2009,418,,215,5974
Ayakulik,2009,2053,,216,8027
Ayakulik,2009,700,,217,8727
Ayakulik,2009,50,,218,8777
Ayakulik,2009,30,,219,8807
Ayakulik,2009,165,,220,8972
Ayakulik,2009,585,,221,9557
Ayakulik,2009,14,,222,9571
Ayakulik,2009,6,,223,9577
Ayakulik,2009,1616,,224,11193
Ayakulik,2009,3865,,225,15058
Ayakulik,2009,1214,,226,16272
Ayakulik,2009,988,,227,17260
Ayakulik,2009,386,,228,17646
Ayakulik,2009,922,,229,18568
Ayakulik,2009,1689,,230,20257
Ayakulik,2009,268,,231,20525
Ayakulik,2009,105,,232,20630
Ayakulik,2009,258,,233,20888
Ayakulik,2009,31,,234,20919
Ayakulik,2009,2,,235,20921
Ayakulik,2009,374,,236,21295
Ayakulik,2009,644,,237,21939
Ayakulik,2009,78,,238,22017
Ayakulik,2009,1728,,239,23745
Ayakulik,2009,608,,240,24353
Ayakulik,2009,568,,241,24921
Ayakulik,2009,223,,242,25144
Ayakulik,2009,276,,243,25420
Ayakulik,2009,119,,244,25539
Ayakulik,2009,458,,245,25997
Ayakulik,2009,924,,246,26921
Ayakulik,2009,112,,247,27033
Ayakulik,2009,109,,248,27142
Ayakulik,2009,99,,249,27241
Ayakulik,2009,88,,250,27329
Ayakulik,2009,121,,251,27450
Ayakulik,2009,103,,252,27553
Ayakulik,2009,21,,253,27574
Ayakulik,2009,92,,254,27666
Ayakulik,2009,8,,255,27674
Ayakulik,2009,139,,256,27813
Ayakulik,2009,50,,257,27863
Ayakulik,2009,20,,258,27883
Ayakulik,2009,20,,259,27903
Ayakulik,2009,20,,260,27923
Ayakulik,2009,0,,261,27923
Ayakulik,2009,0,,262,27923
Ayakulik,2009,0,,263,27923
Ayakulik,2009,0,,264,27923
Ayakulik,2009,0,,265,27923
Ayakulik,2009,0,,266,27923
Ayakulik,2009,0,,267,27923
Ayakulik,2009,0,,268,27923
Ayakulik,2009,0,,269,27923
Ayakulik,2009,0,,270,27923
Ayakulik,2009,0,,271,27923
Ayakulik,2009,0,,272,27923
Ayakulik,2009,0,,273,27923
Ayakulik,2008,0,,153,0
Ayakulik,2008,0,,154,0
Ayakulik,2008,0,,155,0
Ayakulik,2008,0,,156,0
Ayakulik,2008,0,,157,0
Ayakulik,2008,0,,158,0
Ayakulik,2008,0,,159,0
Ayakulik,2008,0,,160,0
Ayakulik,2008,0,,161,0
Ayakulik,2008,0,,162,0
Ayakulik,2008,0,,163,0
Ayakulik,2008,0,,164,0
Ayakulik,2008,0,,165,0
Ayakulik,2008,0,,166,0
Ayakulik,2008,0,,167,0
Ayakulik,2008,0,,168,0
Ayakulik,2008,0,,169,0
Ayakulik,2008,0,,170,0
Ayakulik,2008,0,,171,0
Ayakulik,2008,0,,172,0
Ayakulik,2008,0,,173,0
Ayakulik,2008,0,,174,0
Ayakulik,2008,0,,175,0
Ayakulik,2008,0,,176,0
Ayakulik,2008,0,,177,0
Ayakulik,2008,0,,178,0
Ayakulik,2008,0,,179,0
Ayakulik,2008,0,,180,0
Ayakulik,2008,0,,181,0
Ayakulik,2008,0,,182,0
Ayakulik,2008,0,,183,0
Ayakulik,2008,7,,184,7
Ayakulik,2008,57,,185,64
Ayakulik,2008,16,,186,80
Ayakulik,2008,41,,187,121
Ayakulik,2008,2,,188,123
Ayakulik,2008,22,,189,145
Ayakulik,2008,21,,190,166
Ayakulik,2008,9,,191,175
Ayakulik,2008,23,,192,198
Ayakulik,2008,668,,193,866
Ayakulik,2008,2957,,194,3823
Ayakulik,2008,1435,,195,5258
Ayakulik,2008,588,,196,5846
Ayakulik,2008,1427,,197,7273
Ayakulik,2008,6709,,198,13982
Ayakulik,2008,93,,199,14075
Ayakulik,2008,25,,200,14100
Ayakulik,2008,595,,201,14695
Ayakulik,2008,287,,202,14982
Ayakulik,2008,140,,203,15122
Ayakulik,2008,0,,204,15122
Ayakulik,2008,314,,205,15436
Ayakulik,2008,938,,206,16374
Ayakulik,2008,2815,,207,19189
Ayakulik,2008,2671,,208,21860
Ayakulik,2008,25120,,209,46980
Ayakulik,2008,18971,,210,65951
Ayakulik,2008,15360,,211,81311
Ayakulik,2008,2105,,212,83416
Ayakulik,2008,378,,213,83794
Ayakulik,2008,2460,,214,86254
Ayakulik,2008,36582,,215,122836
Ayakulik,2008,21428,,216,144264
Ayakulik,2008,1760,,217,146024
Ayakulik,2008,58746,,218,204770
Ayakulik,2008,66627,,219,271397
Ayakulik,2008,49766,,220,321163
Ayakulik,2008,19399,,221,340562
Ayakulik,2008,58845,,222,399407
Ayakulik,2008,40621,,223,440028
Ayakulik,2008,36848,,224,476876
Ayakulik,2008,59622,,225,536498
Ayakulik,2008,9889,,226,546387
Ayakulik,2008,6778,,227,553165
Ayakulik,2008,45614,,228,598779
Ayakulik,2008,24804,,229,623583
Ayakulik,2008,35542,,230,659125
Ayakulik,2008,1116,,231,660241
Ayakulik,2008,345,,232,660586
Ayakulik,2008,4917,,233,665503
Ayakulik,2008,13356,,234,678859
Ayakulik,2008,1815,,235,680674
Ayakulik,2008,17983,,236,698657
Ayakulik,2008,1622,,237,700279
Ayakulik,2008,5136,,238,705415
Ayakulik,2008,6559,,239,711974
Ayakulik,2008,4400,,240,716374
Ayakulik,2008,5676,,241,722050
Ayakulik,2008,3594,,242,725644
Ayakulik,2008,1300,,243,726944
Ayakulik,2008,1886,,244,728830
Ayakulik,2008,2323,,245,731153
Ayakulik,2008,923,,246,732076
Ayakulik,2008,889,,247,732965
Ayakulik,2008,508,,248,733473
Ayakulik,2008,763,,249,734236
Ayakulik,2008,527,,250,734763
Ayakulik,2008,3034,,251,737797
Ayakulik,2008,1000,,252,738797
Ayakulik,2008,1000,,253,739797
Ayakulik,2008,1000,,254,740797
Ayakulik,2008,1000,,255,741797
Ayakulik,2008,0,,256,741797
Ayakulik,2008,0,,257,741797
Ayakulik,2008,0,,258,741797
Ayakulik,2008,0,,259,741797
Ayakulik,2008,0,,260,741797
Ayakulik,2008,0,,261,741797
Ayakulik,2008,0,,262,741797
Ayakulik,2008,0,,263,741797
Ayakulik,2008,0,,264,741797
Ayakulik,2008,0,,265,741797
Ayakulik,2008,0,,266,741797
Ayakulik,2008,0,,267,741797
Ayakulik,2008,0,,268,741797
Ayakulik,2008,0,,269,741797
Ayakulik,2008,0,,270,741797
Ayakulik,2008,0,,271,741797
Ayakulik,2008,0,,272,741797
Ayakulik,2008,0,,273,741797
Ayakulik,2008,0,,274,741797
Ayakulik,2007,0,,152,0
Ayakulik,2007,0,,153,0
Ayakulik,2007,0,,154,0
Ayakulik,2007,0,,155,0
Ayakulik,2007,0,,156,0
Ayakulik,2007,0,,157,0
Ayakulik,2007,0,,158,0
Ayakulik,2007,0,,159,0
Ayakulik,2007,0,,160,0
Ayakulik,2007,0,,161,0
Ayakulik,2007,0,,162,0
Ayakulik,2007,0,,163,0
Ayakulik,2007,0,,164,0
Ayakulik,2007,0,,165,0
Ayakulik,2007,0,,166,0
Ayakulik,2007,0,,167,0
Ayakulik,2007,0,,168,0
Ayakulik,2007,0,,169,0
Ayakulik,2007,0,,170,0
Ayakulik,2007,0,,171,0
Ayakulik,2007,0,,172,0
Ayakulik,2007,0,,173,0
Ayakulik,2007,0,,174,0
Ayakulik,2007,0,,175,0
Ayakulik,2007,0,,176,0
Ayakulik,2007,0,,177,0
Ayakulik,2007,0,,178,0
Ayakulik,2007,0,,179,0
Ayakulik,2007,0,,180,0
Ayakulik,2007,28,,181,28
Ayakulik,2007,12,,182,40
Ayakulik,2007,0,,183,40
Ayakulik,2007,5,,184,45
Ayakulik,2007,0,,185,45
Ayakulik,2007,0,,186,45
Ayakulik,2007,3,,187,48
Ayakulik,2007,1,,188,49
Ayakulik,2007,59,,189,108
Ayakulik,2007,9,,190,117
Ayakulik,2007,3,,191,120
Ayakulik,2007,44,,192,164
Ayakulik,2007,45,,193,209
Ayakulik,2007,21,,194,230
Ayakulik,2007,80,,195,310
Ayakulik,2007,54,,196,364
Ayakulik,2007,64,,197,428
Ayakulik,2007,5,,198,433
Ayakulik,2007,443,,199,876
Ayakulik,2007,177,,200,1053
Ayakulik,2007,202,,201,1255
Ayakulik,2007,62,,202,1317
Ayakulik,2007,111,,203,1428
Ayakulik,2007,149,,204,1577
Ayakulik,2007,137,,205,1714
Ayakulik,2007,519,,206,2233
Ayakulik,2007,1131,,207,3364
Ayakulik,2007,1126,,208,4490
Ayakulik,2007,345,,209,4835
Ayakulik,2007,25,,210,4860
Ayakulik,2007,20,,211,4880
Ayakulik,2007,141,,212,5021
Ayakulik,2007,934,,213,5955
Ayakulik,2007,120,,214,6075
Ayakulik,2007,1184,,215,7259
Ayakulik,2007,125,,216,7384
Ayakulik,2007,0,,217,7384
Ayakulik,2007,55,,218,7439
Ayakulik,2007,885,,219,8324
Ayakulik,2007,625,,220,8949
Ayakulik,2007,374,,221,9323
Ayakulik,2007,2539,,222,11862
Ayakulik,2007,754,,223,12616
Ayakulik,2007,499,,224,13115
Ayakulik,2007,1198,,225,14313
Ayakulik,2007,769,,226,15082
Ayakulik,2007,113,,227,15195
Ayakulik,2007,166,,228,15361
Ayakulik,2007,208,,229,15569
Ayakulik,2007,69,,230,15638
Ayakulik,2007,92,,231,15730
Ayakulik,2007,305,,232,16035
Ayakulik,2007,138,,233,16173
Ayakulik,2007,11,,234,16184
Ayakulik,2007,659,,235,16843
Ayakulik,2007,318,,236,17161
Ayakulik,2007,803,,237,17964
Ayakulik,2007,384,,238,18348
Ayakulik,2007,576,,239,18924
Ayakulik,2007,36,,240,18960
Ayakulik,2007,625,,241,19585
Ayakulik,2007,504,,242,20089
Ayakulik,2007,253,,243,20342
Ayakulik,2007,457,,244,20799
Ayakulik,2007,481,,245,21280
Ayakulik,2007,640,,246,21920
Ayakulik,2007,1989,,247,23909
Ayakulik,2007,578,,248,24487
Ayakulik,2007,513,,249,25000
Ayakulik,2007,1948,,250,26948
Ayakulik,2007,1200,,251,28148
Ayakulik,2007,900,,252,29048
Ayakulik,2007,600,,253,29648
Ayakulik,2007,600,,254,30248
Ayakulik,2007,800,,255,31048
Ayakulik,2007,400,,256,31448
Ayakulik,2007,600,,257,32048
Ayakulik,2007,0,,258,32048
Ayakulik,2007,0,,259,32048
Ayakulik,2007,0,,260,32048
Ayakulik,2007,0,,261,32048
Ayakulik,2007,0,,262,32048
Ayakulik,2007,0,,263,32048
Ayakulik,2007,0,,264,32048
Ayakulik,2007,0,,265,32048
Ayakulik,2007,0,,266,32048
Ayakulik,2007,0,,267,32048
Ayakulik,2007,0,,268,32048
Ayakulik,2007,0,,269,32048
Ayakulik,2007,0,,270,32048
Ayakulik,2007,0,,271,32048
Ayakulik,2007,0,,272,32048
Ayakulik,2007,0,,273,32048
Ayakulik,2006,0,,152,0
Ayakulik,2006,0,,153,0
Ayakulik,2006,0,,154,0
Ayakulik,2006,0,,155,0
Ayakulik,2006,0,,156,0
Ayakulik,2006,0,,157,0
Ayakulik,2006,0,,158,0
Ayakulik,2006,0,,159,0
Ayakulik,2006,0,,160,0
Ayakulik,2006,0,,161,0
Ayakulik,2006,0,,162,0
Ayakulik,2006,0,,163,0
Ayakulik,2006,0,,164,0
Ayakulik,2006,0,,165,0
Ayakulik,2006,0,,166,0
Ayakulik,2006,0,,167,0
Ayakulik,2006,0,,168,0
Ayakulik,2006,0,,169,0
Ayakulik,2006,12,,170,12
Ayakulik,2006,0,,171,12
Ayakulik,2006,0,,172,12
Ayakulik,2006,0,,173,12
Ayakulik,2006,0,,174,12
Ayakulik,2006,0,,175,12
Ayakulik,2006,0,,176,12
Ayakulik,2006,1,,177,13
Ayakulik,2006,0,,178,13
Ayakulik,2006,0,,179,13
Ayakulik,2006,0,,180,13
Ayakulik,2006,0,,181,13
Ayakulik,2006,6,,182,19
Ayakulik,2006,3,,183,22
Ayakulik,2006,11,,184,33
Ayakulik,2006,0,,185,33
Ayakulik,2006,0,,186,33
Ayakulik,2006,0,,187,33
Ayakulik,2006,0,,188,33
Ayakulik,2006,1,,189,34
Ayakulik,2006,7,,190,41
Ayakulik,2006,10,,191,51
Ayakulik,2006,144,,192,195
Ayakulik,2006,60,,193,255
Ayakulik,2006,14,,194,269
Ayakulik,2006,0,,195,269
Ayakulik,2006,6,,196,275
Ayakulik,2006,19,,197,294
Ayakulik,2006,21,,198,315
Ayakulik,2006,60,,199,375
Ayakulik,2006,706,,200,1081
Ayakulik,2006,158,,201,1239
Ayakulik,2006,1876,,202,3115
Ayakulik,2006,214,,203,3329
Ayakulik,2006,0,,204,3329
Ayakulik,2006,1044,,205,4373
Ayakulik,2006,1473,,206,5846
Ayakulik,2006,2541,,207,8387
Ayakulik,2006,2239,,208,10626
Ayakulik,2006,4209,,209,14835
Ayakulik,2006,1760,,210,16595
Ayakulik,2006,0,,211,16595
Ayakulik,2006,1781,,212,18376
Ayakulik,2006,295,,213,18671
Ayakulik,2006,20200,,214,38871
Ayakulik,2006,32835,,215,71706
Ayakulik,2006,20735,,216,92441
Ayakulik,2006,2515,,217,94956
Ayakulik,2006,16790,,218,111746
Ayakulik,2006,14269,,219,126015
Ayakulik,2006,46134,,220,172149
Ayakulik,2006,27697,,221,199846
Ayakulik,2006,3092,,222,202938
Ayakulik,2006,21619,,223,224557
Ayakulik,2006,16827,,224,241384
Ayakulik,2006,37480,,225,278864
Ayakulik,2006,45469,,226,324333
Ayakulik,2006,45482,,227,369815
Ayakulik,2006,50000,,228,419815
Ayakulik,2006,0,,229,419815
Ayakulik,2006,0,,230,419815
Ayakulik,2006,0,,231,419815
Ayakulik,2006,0,,232,419815
Ayakulik,2006,120000,,233,539815
Ayakulik,2006,0,,234,539815
Ayakulik,2006,0,,235,539815
Ayakulik,2006,0,,236,539815
Ayakulik,2006,0,,237,539815
Ayakulik,2006,0,,238,539815
Ayakulik,2006,0,,239,539815
Ayakulik,2006,0,,240,539815
Ayakulik,2006,0,,241,539815
Ayakulik,2006,0,,242,539815
Ayakulik,2006,0,,243,539815
Ayakulik,2006,0,,244,539815
Ayakulik,2006,0,,245,539815
Ayakulik,2006,0,,246,539815
Ayakulik,2006,0,,247,539815
Ayakulik,2006,0,,248,539815
Ayakulik,2006,0,,249,539815
Ayakulik,2006,0,,250,539815
Ayakulik,2006,0,,251,539815
Ayakulik,2006,0,,252,539815
Ayakulik,2006,0,,253,539815
Ayakulik,2006,0,,254,539815
Ayakulik,2006,0,,255,539815
Ayakulik,2006,0,,256,539815
Ayakulik,2006,0,,257,539815
Ayakulik,2006,0,,258,539815
Ayakulik,2006,0,,259,539815
Ayakulik,2006,0,,260,539815
Ayakulik,2006,0,,261,539815
Ayakulik,2006,0,,262,539815
Ayakulik,2006,0,,263,539815
Ayakulik,2006,0,,264,539815
Ayakulik,2006,0,,265,539815
Ayakulik,2006,0,,266,539815
Ayakulik,2006,0,,267,539815
Ayakulik,2006,0,,268,539815
Ayakulik,2006,0,,269,539815
Ayakulik,2006,0,,270,539815
Ayakulik,2006,0,,271,539815
Ayakulik,2006,0,,272,539815
Ayakulik,2006,0,,273,539815
Ayakulik,2005,0,,152,0
Ayakulik,2005,0,,153,0
Ayakulik,2005,0,,154,0
Ayakulik,2005,0,,155,0
Ayakulik,2005,0,,156,0
Ayakulik,2005,0,,157,0
Ayakulik,2005,0,,158,0
Ayakulik,2005,0,,159,0
Ayakulik,2005,0,,160,0
Ayakulik,2005,0,,161,0
Ayakulik,2005,0,,162,0
Ayakulik,2005,0,,163,0
Ayakulik,2005,0,,164,0
Ayakulik,2005,0,,165,0
Ayakulik,2005,0,,166,0
Ayakulik,2005,0,,167,0
Ayakulik,2005,0,,168,0
Ayakulik,2005,0,,169,0
Ayakulik,2005,0,,170,0
Ayakulik,2005,0,,171,0
Ayakulik,2005,0,,172,0
Ayakulik,2005,0,,173,0
Ayakulik,2005,0,,174,0
Ayakulik,2005,0,,175,0
Ayakulik,2005,10,,176,10
Ayakulik,2005,0,,177,10
Ayakulik,2005,12,,178,22
Ayakulik,2005,0,,179,22
Ayakulik,2005,2,,180,24
Ayakulik,2005,4,,181,28
Ayakulik,2005,3,,182,31
Ayakulik,2005,0,,183,31
Ayakulik,2005,3,,184,34
Ayakulik,2005,46,,185,80
Ayakulik,2005,24,,186,104
Ayakulik,2005,0,,187,104
Ayakulik,2005,982,,188,1086
Ayakulik,2005,1,,189,1087
Ayakulik,2005,22,,190,1109
Ayakulik,2005,3,,191,1112
Ayakulik,2005,2,,192,1114
Ayakulik,2005,5,,193,1119
Ayakulik,2005,0,,194,1119
Ayakulik,2005,504,,195,1623
Ayakulik,2005,227,,196,1850
Ayakulik,2005,109,,197,1959
Ayakulik,2005,85,,198,2044
Ayakulik,2005,9,,199,2053
Ayakulik,2005,13,,200,2066
Ayakulik,2005,80,,201,2146
Ayakulik,2005,113,,202,2259
Ayakulik,2005,308,,203,2567
Ayakulik,2005,24,,204,2591
Ayakulik,2005,0,,205,2591
Ayakulik,2005,0,,206,2591
Ayakulik,2005,226,,207,2817
Ayakulik,2005,751,,208,3568
Ayakulik,2005,205,,209,3773
Ayakulik,2005,1044,,210,4817
Ayakulik,2005,163,,211,4980
Ayakulik,2005,411,,212,5391
Ayakulik,2005,48,,213,5439
Ayakulik,2005,332,,214,5771
Ayakulik,2005,163,,215,5934
Ayakulik,2005,339,,216,6273
Ayakulik,2005,134,,217,6407
Ayakulik,2005,134,,218,6541
Ayakulik,2005,119,,219,6660
Ayakulik,2005,461,,220,7121
Ayakulik,2005,143,,221,7264
Ayakulik,2005,586,,222,7850
Ayakulik,2005,18,,223,7868
Ayakulik,2005,756,,224,8624
Ayakulik,2005,2965,,225,11589
Ayakulik,2005,1874,,226,13463
Ayakulik,2005,1281,,227,14744
Ayakulik,2005,3148,,228,17892
Ayakulik,2005,5448,,229,23340
Ayakulik,2005,1314,,230,24654
Ayakulik,2005,1374,,231,26028
Ayakulik,2005,1371,,232,27399
Ayakulik,2005,512,,233,27911
Ayakulik,2005,1422,,234,29333
Ayakulik,2005,2911,,235,32244
Ayakulik,2005,948,,236,33192
Ayakulik,2005,895,,237,34087
Ayakulik,2005,1451,,238,35538
Ayakulik,2005,804,,239,36342
Ayakulik,2005,433,,240,36775
Ayakulik,2005,664,,241,37439
Ayakulik,2005,993,,242,38432
Ayakulik,2005,660,,243,39092
Ayakulik,2005,375,,244,39467
Ayakulik,2005,471,,245,39938
Ayakulik,2005,290,,246,40228
Ayakulik,2005,369,,247,40597
Ayakulik,2005,1000,,248,41597
Ayakulik,2005,0,,249,41597
Ayakulik,2005,0,,250,41597
Ayakulik,2005,0,,251,41597
Ayakulik,2005,0,,252,41597
Ayakulik,2005,0,,253,41597
Ayakulik,2005,0,,254,41597
Ayakulik,2005,0,,255,41597
Ayakulik,2005,0,,256,41597
Ayakulik,2005,0,,257,41597
Ayakulik,2005,0,,258,41597
Ayakulik,2005,0,,259,41597
Ayakulik,2005,0,,260,41597
Ayakulik,2005,0,,261,41597
Ayakulik,2005,0,,262,41597
Ayakulik,2005,0,,263,41597
Ayakulik,2005,0,,264,41597
Ayakulik,2005,0,,265,41597
Ayakulik,2005,0,,266,41597
Ayakulik,2005,0,,267,41597
Ayakulik,2005,0,,268,41597
Ayakulik,2005,0,,269,41597
Ayakulik,2005,0,,270,41597
Ayakulik,2005,0,,271,41597
Ayakulik,2005,0,,272,41597
Ayakulik,2005,0,,273,41597
Ayakulik,2004,0,,153,0
Ayakulik,2004,0,,154,0
Ayakulik,2004,0,,155,0
Ayakulik,2004,0,,156,0
Ayakulik,2004,0,,157,0
Ayakulik,2004,0,,158,0
Ayakulik,2004,0,,159,0
Ayakulik,2004,0,,160,0
Ayakulik,2004,0,,161,0
Ayakulik,2004,0,,162,0
Ayakulik,2004,0,,163,0
Ayakulik,2004,0,,164,0
Ayakulik,2004,0,,165,0
Ayakulik,2004,0,,166,0
Ayakulik,2004,0,,167,0
Ayakulik,2004,0,,168,0
Ayakulik,2004,0,,169,0
Ayakulik,2004,0,,170,0
Ayakulik,2004,0,,171,0
Ayakulik,2004,0,,172,0
Ayakulik,2004,0,,173,0
Ayakulik,2004,0,,174,0
Ayakulik,2004,0,,175,0
Ayakulik,2004,0,,176,0
Ayakulik,2004,0,,177,0
Ayakulik,2004,0,,178,0
Ayakulik,2004,0,,179,0
Ayakulik,2004,0,,180,0
Ayakulik,2004,0,,181,0
Ayakulik,2004,2,,182,2
Ayakulik,2004,2,,183,4
Ayakulik,2004,0,,184,4
Ayakulik,2004,0,,185,4
Ayakulik,2004,5,,186,9
Ayakulik,2004,0,,187,9
Ayakulik,2004,7,,188,16
Ayakulik,2004,5,,189,21
Ayakulik,2004,18,,190,39
Ayakulik,2004,9,,191,48
Ayakulik,2004,18,,192,66
Ayakulik,2004,6,,193,72
Ayakulik,2004,29,,194,101
Ayakulik,2004,85,,195,186
Ayakulik,2004,64,,196,250
Ayakulik,2004,214,,197,464
Ayakulik,2004,48,,198,512
Ayakulik,2004,62,,199,574
Ayakulik,2004,184,,200,758
Ayakulik,2004,1547,,201,2305
Ayakulik,2004,2466,,202,4771
Ayakulik,2004,401,,203,5172
Ayakulik,2004,814,,204,5986
Ayakulik,2004,3987,,205,9973
Ayakulik,2004,3958,,206,13931
Ayakulik,2004,3835,,207,17766
Ayakulik,2004,2491,,208,20257
Ayakulik,2004,0,,209,20257
Ayakulik,2004,4000,,210,24257
Ayakulik,2004,2500,,211,26757
Ayakulik,2004,8000,,212,34757
Ayakulik,2004,58579,,213,93336
Ayakulik,2004,60350,,214,153686
Ayakulik,2004,22128,,215,175814
Ayakulik,2004,38568,,216,214382
Ayakulik,2004,35903,,217,250285
Ayakulik,2004,19716,,218,270001
Ayakulik,2004,80892,,219,350893
Ayakulik,2004,125954,,220,476847
Ayakulik,2004,79412,,221,556259
Ayakulik,2004,97372,,222,653631
Ayakulik,2004,137343,,223,790974
Ayakulik,2004,56137,,224,847111
Ayakulik,2004,35079,,225,882190
Ayakulik,2004,12773,,226,894963
Ayakulik,2004,14465,,227,909428
Ayakulik,2004,18855,,228,928283
Ayakulik,2004,20531,,229,948814
Ayakulik,2004,16037,,230,964851
Ayakulik,2004,14543,,231,979394
Ayakulik,2004,10755,,232,990149
Ayakulik,2004,6945,,233,997094
Ayakulik,2004,9377,,234,1006471
Ayakulik,2004,7378,,235,1013849
Ayakulik,2004,3142,,236,1016991
Ayakulik,2004,7232,,237,1024223
Ayakulik,2004,16869,,238,1041092
Ayakulik,2004,4637,,239,1045729
Ayakulik,2004,13500,,240,1059229
Ayakulik,2004,0,,241,1059229
Ayakulik,2004,0,,242,1059229
Ayakulik,2004,0,,243,1059229
Ayakulik,2004,0,,244,1059229
Ayakulik,2004,0,,245,1059229
Ayakulik,2004,0,,246,1059229
Ayakulik,2004,0,,247,1059229
Ayakulik,2004,0,,248,1059229
Ayakulik,2004,0,,249,1059229
Ayakulik,2004,0,,250,1059229
Ayakulik,2004,0,,251,1059229
Ayakulik,2004,0,,252,1059229
Ayakulik,2004,0,,253,1059229
Ayakulik,2004,0,,254,1059229
Ayakulik,2004,0,,255,1059229
Ayakulik,2004,0,,256,1059229
Ayakulik,2004,0,,257,1059229
Ayakulik,2004,0,,258,1059229
Ayakulik,2004,0,,259,1059229
Ayakulik,2004,0,,260,1059229
Ayakulik,2004,0,,261,1059229
Ayakulik,2004,0,,262,1059229
Ayakulik,2004,0,,263,1059229
Ayakulik,2004,0,,264,1059229
Ayakulik,2004,0,,265,1059229
Ayakulik,2004,0,,266,1059229
Ayakulik,2004,0,,267,1059229
Ayakulik,2004,0,,268,1059229
Ayakulik,2004,0,,269,1059229
Ayakulik,2004,0,,270,1059229
Ayakulik,2004,0,,271,1059229
Ayakulik,2004,0,,272,1059229
Ayakulik,2004,0,,273,1059229
Ayakulik,2004,0,,274,1059229
Ayakulik,2003,0,,152,0
Ayakulik,2003,0,,153,0
Ayakulik,2003,0,,154,0
Ayakulik,2003,0,,155,0
Ayakulik,2003,0,,156,0
Ayakulik,2003,0,,157,0
Ayakulik,2003,0,,158,0
Ayakulik,2003,0,,159,0
Ayakulik,2003,0,,160,0
Ayakulik,2003,0,,161,0
Ayakulik,2003,0,,162,0
Ayakulik,2003,0,,163,0
Ayakulik,2003,0,,164,0
Ayakulik,2003,0,,165,0
Ayakulik,2003,0,,166,0
Ayakulik,2003,0,,167,0
Ayakulik,2003,0,,168,0
Ayakulik,2003,0,,169,0
Ayakulik,2003,0,,170,0
Ayakulik,2003,0,,171,0
Ayakulik,2003,0,,172,0
Ayakulik,2003,0,,173,0
Ayakulik,2003,0,,174,0
Ayakulik,2003,0,,175,0
Ayakulik,2003,0,,176,0
Ayakulik,2003,0,,177,0
Ayakulik,2003,0,,178,0
Ayakulik,2003,0,,179,0
Ayakulik,2003,0,,180,0
Ayakulik,2003,0,,181,0
Ayakulik,2003,0,,182,0
Ayakulik,2003,2,,183,2
Ayakulik,2003,1,,184,3
Ayakulik,2003,3,,185,6
Ayakulik,2003,1,,186,7
Ayakulik,2003,3,,187,10
Ayakulik,2003,2,,188,12
Ayakulik,2003,15,,189,27
Ayakulik,2003,51,,190,78
Ayakulik,2003,17,,191,95
Ayakulik,2003,40,,192,135
Ayakulik,2003,10,,193,145
Ayakulik,2003,7,,194,152
Ayakulik,2003,87,,195,239
Ayakulik,2003,17,,196,256
Ayakulik,2003,35,,197,291
Ayakulik,2003,1,,198,292
Ayakulik,2003,16,,199,308
Ayakulik,2003,200,,200,508
Ayakulik,2003,1153,,201,1661
Ayakulik,2003,438,,202,2099
Ayakulik,2003,675,,203,2774
Ayakulik,2003,2,,204,2776
Ayakulik,2003,140,,205,2916
Ayakulik,2003,539,,206,3455
Ayakulik,2003,21,,207,3476
Ayakulik,2003,259,,208,3735
Ayakulik,2003,375,,209,4110
Ayakulik,2003,164,,210,4274
Ayakulik,2003,500,,211,4774
Ayakulik,2003,443,,212,5217
Ayakulik,2003,62,,213,5279
Ayakulik,2003,43,,214,5322
Ayakulik,2003,349,,215,5671
Ayakulik,2003,61,,216,5732
Ayakulik,2003,158,,217,5890
Ayakulik,2003,315,,218,6205
Ayakulik,2003,388,,219,6593
Ayakulik,2003,58,,220,6651
Ayakulik,2003,117,,221,6768
Ayakulik,2003,413,,222,7181
Ayakulik,2003,633,,223,7814
Ayakulik,2003,0,,224,7814
Ayakulik,2003,0,,225,7814
Ayakulik,2003,0,,226,7814
Ayakulik,2003,0,,227,7814
Ayakulik,2003,0,,228,7814
Ayakulik,2003,0,,229,7814
Ayakulik,2003,0,,230,7814
Ayakulik,2003,0,,231,7814
Ayakulik,2003,0,,232,7814
Ayakulik,2003,0,,233,7814
Ayakulik,2003,0,,234,7814
Ayakulik,2003,0,,235,7814
Ayakulik,2003,0,,236,7814
Ayakulik,2003,0,,237,7814
Ayakulik,2003,0,,238,7814
Ayakulik,2003,0,,239,7814
Ayakulik,2003,0,,240,7814
Ayakulik,2003,0,,241,7814
Ayakulik,2003,0,,242,7814
Ayakulik,2003,0,,243,7814
Ayakulik,2003,0,,244,7814
Ayakulik,2003,0,,245,7814
Ayakulik,2003,0,,246,7814
Ayakulik,2003,0,,247,7814
Ayakulik,2003,0,,248,7814
Ayakulik,2003,0,,249,7814
Ayakulik,2003,0,,250,7814
Ayakulik,2003,0,,251,7814
Ayakulik,2003,0,,252,7814
Ayakulik,2003,0,,253,7814
Ayakulik,2003,0,,254,7814
Ayakulik,2003,0,,255,7814
Ayakulik,2003,0,,256,7814
Ayakulik,2003,0,,257,7814
Ayakulik,2003,0,,258,7814
Ayakulik,2003,0,,259,7814
Ayakulik,2003,0,,260,7814
Ayakulik,2003,0,,261,7814
Ayakulik,2003,0,,262,7814
Ayakulik,2003,0,,263,7814
Ayakulik,2003,0,,264,7814
Ayakulik,2003,0,,265,7814
Ayakulik,2003,0,,266,7814
Ayakulik,2003,0,,267,7814
Ayakulik,2003,0,,268,7814
Ayakulik,2003,0,,269,7814
Ayakulik,2003,0,,270,7814
Ayakulik,2003,0,,271,7814
Ayakulik,2003,0,,272,7814
Ayakulik,2003,0,,273,7814
Ayakulik,2002,0,,152,0
Ayakulik,2002,0,,153,0
Ayakulik,2002,0,,154,0
Ayakulik,2002,0,,155,0
Ayakulik,2002,0,,156,0
Ayakulik,2002,0,,157,0
Ayakulik,2002,0,,158,0
Ayakulik,2002,0,,159,0
Ayakulik,2002,0,,160,0
Ayakulik,2002,0,,161,0
Ayakulik,2002,0,,162,0
Ayakulik,2002,0,,163,0
Ayakulik,2002,0,,164,0
Ayakulik,2002,0,,165,0
Ayakulik,2002,0,,166,0
Ayakulik,2002,0,,167,0
Ayakulik,2002,0,,168,0
Ayakulik,2002,0,,169,0
Ayakulik,2002,0,,170,0
Ayakulik,2002,0,,171,0
Ayakulik,2002,0,,172,0
Ayakulik,2002,0,,173,0
Ayakulik,2002,0,,174,0
Ayakulik,2002,0,,175,0
Ayakulik,2002,0,,176,0
Ayakulik,2002,0,,177,0
Ayakulik,2002,0,,178,0
Ayakulik,2002,0,,179,0
Ayakulik,2002,0,,180,0
Ayakulik,2002,2,,181,2
Ayakulik,2002,0,,182,2
Ayakulik,2002,3,,183,5
Ayakulik,2002,2,,184,7
Ayakulik,2002,0,,185,7
Ayakulik,2002,9,,186,16
Ayakulik,2002,4,,187,20
Ayakulik,2002,33,,188,53
Ayakulik,2002,560,,189,613
Ayakulik,2002,10,,190,623
Ayakulik,2002,88,,191,711
Ayakulik,2002,689,,192,1400
Ayakulik,2002,372,,193,1772
Ayakulik,2002,1,,194,1773
Ayakulik,2002,41,,195,1814
Ayakulik,2002,139,,196,1953
Ayakulik,2002,18,,197,1971
Ayakulik,2002,1061,,198,3032
Ayakulik,2002,916,,199,3948
Ayakulik,2002,4520,,200,8468
Ayakulik,2002,3061,,201,11529
Ayakulik,2002,2592,,202,14121
Ayakulik,2002,1673,,203,15794
Ayakulik,2002,4326,,204,20120
Ayakulik,2002,216,,205,20336
Ayakulik,2002,57,,206,20393
Ayakulik,2002,28,,207,20421
Ayakulik,2002,472,,208,20893
Ayakulik,2002,25,,209,20918
Ayakulik,2002,18,,210,20936
Ayakulik,2002,4,,211,20940
Ayakulik,2002,371,,212,21311
Ayakulik,2002,60194,,213,81505
Ayakulik,2002,9259,,214,90764
Ayakulik,2002,9449,,215,100213
Ayakulik,2002,14205,,216,114418
Ayakulik,2002,29926,,217,144344
Ayakulik,2002,22372,,218,166716
Ayakulik,2002,21957,,219,188673
Ayakulik,2002,4785,,220,193458
Ayakulik,2002,5600,,221,199058
Ayakulik,2002,4698,,222,203756
Ayakulik,2002,583,,223,204339
Ayakulik,2002,2128,,224,206467
Ayakulik,2002,2348,,225,208815
Ayakulik,2002,21910,,226,230725
Ayakulik,2002,10227,,227,240952
Ayakulik,2002,8064,,228,249016
Ayakulik,2002,2739,,229,251755
Ayakulik,2002,17358,,230,269113
Ayakulik,2002,4640,,231,273753
Ayakulik,2002,6672,,232,280425
Ayakulik,2002,47270,,233,327695
Ayakulik,2002,1250,,234,328945
Ayakulik,2002,1534,,235,330479
Ayakulik,2002,3763,,236,334242
Ayakulik,2002,4385,,237,338627
Ayakulik,2002,1876,,238,340503
Ayakulik,2002,1651,,239,342154
Ayakulik,2002,1918,,240,344072
Ayakulik,2002,886,,241,344958
Ayakulik,2002,1156,,242,346114
Ayakulik,2002,1858,,243,347972
Ayakulik,2002,977,,244,348949
Ayakulik,2002,602,,245,349551
Ayakulik,2002,765,,246,350316
Ayakulik,2002,810,,247,351126
Ayakulik,2002,322,,248,351448
Ayakulik,2002,305,,249,351753
Ayakulik,2002,1100,,250,352853
Ayakulik,2002,0,,251,352853
Ayakulik,2002,0,,252,352853
Ayakulik,2002,0,,253,352853
Ayakulik,2002,0,,254,352853
Ayakulik,2002,0,,255,352853
Ayakulik,2002,0,,256,352853
Ayakulik,2002,0,,257,352853
Ayakulik,2002,0,,258,352853
Ayakulik,2002,0,,259,352853
Ayakulik,2002,0,,260,352853
Ayakulik,2002,0,,261,352853
Ayakulik,2002,0,,262,352853
Ayakulik,2002,0,,263,352853
Ayakulik,2002,0,,264,352853
Ayakulik,2002,0,,265,352853
Ayakulik,2002,0,,266,352853
Ayakulik,2002,0,,267,352853
Ayakulik,2002,0,,268,352853
Ayakulik,2002,0,,269,352853
Ayakulik,2002,0,,270,352853
Ayakulik,2002,0,,271,352853
Ayakulik,2002,0,,272,352853
Ayakulik,2002,0,,273,352853
Ayakulik,2001,0,,152,0
Ayakulik,2001,0,,153,0
Ayakulik,2001,0,,154,0
Ayakulik,2001,0,,155,0
Ayakulik,2001,0,,156,0
Ayakulik,2001,0,,157,0
Ayakulik,2001,0,,158,0
Ayakulik,2001,0,,159,0
Ayakulik,2001,0,,160,0
Ayakulik,2001,0,,161,0
Ayakulik,2001,0,,162,0
Ayakulik,2001,0,,163,0
Ayakulik,2001,0,,164,0
Ayakulik,2001,0,,165,0
Ayakulik,2001,0,,166,0
Ayakulik,2001,0,,167,0
Ayakulik,2001,0,,168,0
Ayakulik,2001,0,,169,0
Ayakulik,2001,0,,170,0
Ayakulik,2001,0,,171,0
Ayakulik,2001,0,,172,0
Ayakulik,2001,0,,173,0
Ayakulik,2001,1,,174,1
Ayakulik,2001,0,,175,1
Ayakulik,2001,0,,176,1
Ayakulik,2001,0,,177,1
Ayakulik,2001,0,,178,1
Ayakulik,2001,0,,179,1
Ayakulik,2001,0,,180,1
Ayakulik,2001,0,,181,1
Ayakulik,2001,0,,182,1
Ayakulik,2001,0,,183,1
Ayakulik,2001,0,,184,1
Ayakulik,2001,2,,185,3
Ayakulik,2001,0,,186,3
Ayakulik,2001,63,,187,66
Ayakulik,2001,29,,188,95
Ayakulik,2001,3,,189,98
Ayakulik,2001,43,,190,141
Ayakulik,2001,87,,191,228
Ayakulik,2001,7,,192,235
Ayakulik,2001,34,,193,269
Ayakulik,2001,118,,194,387
Ayakulik,2001,26,,195,413
Ayakulik,2001,104,,196,517
Ayakulik,2001,191,,197,708
Ayakulik,2001,123,,198,831
Ayakulik,2001,43,,199,874
Ayakulik,2001,117,,200,991
Ayakulik,2001,0,,201,991
Ayakulik,2001,35,,202,1026
Ayakulik,2001,47,,203,1073
Ayakulik,2001,34,,204,1107
Ayakulik,2001,60,,205,1167
Ayakulik,2001,666,,206,1833
Ayakulik,2001,519,,207,2352
Ayakulik,2001,451,,208,2803
Ayakulik,2001,287,,209,3090
Ayakulik,2001,131,,210,3221
Ayakulik,2001,916,,211,4137
Ayakulik,2001,109,,212,4246
Ayakulik,2001,55,,213,4301
Ayakulik,2001,114,,214,4415
Ayakulik,2001,103,,215,4518
Ayakulik,2001,225,,216,4743
Ayakulik,2001,87,,217,4830
Ayakulik,2001,70,,218,4900
Ayakulik,2001,110,,219,5010
Ayakulik,2001,416,,220,5426
Ayakulik,2001,309,,221,5735
Ayakulik,2001,232,,222,5967
Ayakulik,2001,279,,223,6246
Ayakulik,2001,128,,224,6374
Ayakulik,2001,245,,225,6619
Ayakulik,2001,271,,226,6890
Ayakulik,2001,147,,227,7037
Ayakulik,2001,389,,228,7426
Ayakulik,2001,1387,,229,8813
Ayakulik,2001,256,,230,9069
Ayakulik,2001,136,,231,9205
Ayakulik,2001,50,,232,9255
Ayakulik,2001,7,,233,9262
Ayakulik,2001,46,,234,9308
Ayakulik,2001,46,,235,9354
Ayakulik,2001,78,,236,9432
Ayakulik,2001,166,,237,9598
Ayakulik,2001,280,,238,9878
Ayakulik,2001,304,,239,10182
Ayakulik,2001,128,,240,10310
Ayakulik,2001,64,,241,10374
Ayakulik,2001,0,,242,10374
Ayakulik,2001,0,,243,10374
Ayakulik,2001,0,,244,10374
Ayakulik,2001,0,,245,10374
Ayakulik,2001,0,,246,10374
Ayakulik,2001,0,,247,10374
Ayakulik,2001,0,,248,10374
Ayakulik,2001,0,,249,10374
Ayakulik,2001,0,,250,10374
Ayakulik,2001,0,,251,10374
Ayakulik,2001,0,,252,10374
Ayakulik,2001,0,,253,10374
Ayakulik,2001,0,,254,10374
Ayakulik,2001,0,,255,10374
Ayakulik,2001,0,,256,10374
Ayakulik,2001,0,,257,10374
Ayakulik,2001,0,,258,10374
Ayakulik,2001,0,,259,10374
Ayakulik,2001,0,,260,10374
Ayakulik,2001,0,,261,10374
Ayakulik,2001,0,,262,10374
Ayakulik,2001,0,,263,10374
Ayakulik,2001,0,,264,10374
Ayakulik,2001,0,,265,10374
Ayakulik,2001,0,,266,10374
Ayakulik,2001,0,,267,10374
Ayakulik,2001,0,,268,10374
Ayakulik,2001,0,,269,10374
Ayakulik,2001,0,,270,10374
Ayakulik,2001,0,,271,10374
Ayakulik,2001,0,,272,10374
Ayakulik,2001,0,,273,10374
Ayakulik,2000,0,,153,0
Ayakulik,2000,0,,154,0
Ayakulik,2000,0,,155,0
Ayakulik,2000,0,,156,0
Ayakulik,2000,0,,157,0
Ayakulik,2000,0,,158,0
Ayakulik,2000,0,,159,0
Ayakulik,2000,0,,160,0
Ayakulik,2000,0,,161,0
Ayakulik,2000,0,,162,0
Ayakulik,2000,0,,163,0
Ayakulik,2000,0,,164,0
Ayakulik,2000,0,,165,0
Ayakulik,2000,0,,166,0
Ayakulik,2000,0,,167,0
Ayakulik,2000,0,,168,0
Ayakulik,2000,0,,169,0
Ayakulik,2000,0,,170,0
Ayakulik,2000,0,,171,0
Ayakulik,2000,0,,172,0
Ayakulik,2000,0,,173,0
Ayakulik,2000,0,,174,0
Ayakulik,2000,0,,175,0
Ayakulik,2000,0,,176,0
Ayakulik,2000,0,,177,0
Ayakulik,2000,0,,178,0
Ayakulik,2000,0,,179,0
Ayakulik,2000,0,,180,0
Ayakulik,2000,0,,181,0
Ayakulik,2000,0,,182,0
Ayakulik,2000,0,,183,0
Ayakulik,2000,6,,184,6
Ayakulik,2000,0,,185,6
Ayakulik,2000,1,,186,7
Ayakulik,2000,13,,187,20
Ayakulik,2000,18,,188,38
Ayakulik,2000,3,,189,41
Ayakulik,2000,2,,190,43
Ayakulik,2000,41,,191,84
Ayakulik,2000,96,,192,180
Ayakulik,2000,27,,193,207
Ayakulik,2000,475,,194,682
Ayakulik,2000,518,,195,1200
Ayakulik,2000,777,,196,1977
Ayakulik,2000,262,,197,2239
Ayakulik,2000,667,,198,2906
Ayakulik,2000,143,,199,3049
Ayakulik,2000,134,,200,3183
Ayakulik,2000,1806,,201,4989
Ayakulik,2000,4459,,202,9448
Ayakulik,2000,2264,,203,11712
Ayakulik,2000,2021,,204,13733
Ayakulik,2000,2606,,205,16339
Ayakulik,2000,3602,,206,19941
Ayakulik,2000,2554,,207,22495
Ayakulik,2000,565,,208,23060
Ayakulik,2000,1906,,209,24966
Ayakulik,2000,2439,,210,27405
Ayakulik,2000,5157,,211,32562
Ayakulik,2000,3760,,212,36322
Ayakulik,2000,5189,,213,41511
Ayakulik,2000,4572,,214,46083
Ayakulik,2000,1003,,215,47086
Ayakulik,2000,22000,,216,69086
Ayakulik,2000,1135,,217,70221
Ayakulik,2000,10207,,218,80428
Ayakulik,2000,15497,,219,95925
Ayakulik,2000,3504,,220,99429
Ayakulik,2000,2396,,221,101825
Ayakulik,2000,649,,222,102474
Ayakulik,2000,8379,,223,110853
Ayakulik,2000,40490,,224,151343
Ayakulik,2000,23540,,225,174883
Ayakulik,2000,23220,,226,198103
Ayakulik,2000,10366,,227,208469
Ayakulik,2000,4484,,228,212953
Ayakulik,2000,3442,,229,216395
Ayakulik,2000,17395,,230,233790
Ayakulik,2000,1917,,231,235707
Ayakulik,2000,7647,,232,243354
Ayakulik,2000,32661,,233,276015
Ayakulik,2000,8626,,234,284641
Ayakulik,2000,3502,,235,288143
Ayakulik,2000,20233,,236,308376
Ayakulik,2000,3136,,237,311512
Ayakulik,2000,2150,,238,313662
Ayakulik,2000,2264,,239,315926
Ayakulik,2000,0,,240,315926
Ayakulik,2000,0,,241,315926
Ayakulik,2000,0,,242,315926
Ayakulik,2000,0,,243,315926
Ayakulik,2000,0,,244,315926
Ayakulik,2000,0,,245,315926
Ayakulik,2000,0,,246,315926
Ayakulik,2000,0,,247,315926
Ayakulik,2000,0,,248,315926
Ayakulik,2000,0,,249,315926
Ayakulik,2000,0,,250,315926
Ayakulik,2000,0,,251,315926
Ayakulik,2000,0,,252,315926
Ayakulik,2000,0,,253,315926
Ayakulik,2000,0,,254,315926
Ayakulik,2000,0,,255,315926
Ayakulik,2000,0,,256,315926
Ayakulik,2000,0,,257,315926
Ayakulik,2000,0,,258,315926
Ayakulik,2000,0,,259,315926
Ayakulik,2000,0,,260,315926
Ayakulik,2000,0,,261,315926
Ayakulik,2000,0,,262,315926
Ayakulik,2000,0,,263,315926
Ayakulik,2000,0,,264,315926
Ayakulik,2000,0,,265,315926
Ayakulik,2000,0,,266,315926
Ayakulik,2000,0,,267,315926
Ayakulik,2000,0,,268,315926
Ayakulik,2000,0,,269,315926
Ayakulik,2000,0,,270,315926
Ayakulik,2000,0,,271,315926
Ayakulik,2000,0,,272,315926
Ayakulik,2000,0,,273,315926
Ayakulik,2000,0,,274,315926
Ayakulik,1999,0,,152,0
Ayakulik,1999,0,,153,0
Ayakulik,1999,0,,154,0
Ayakulik,1999,0,,155,0
Ayakulik,1999,0,,156,0
Ayakulik,1999,0,,157,0
Ayakulik,1999,0,,158,0
Ayakulik,1999,0,,159,0
Ayakulik,1999,0,,160,0
Ayakulik,1999,0,,161,0
Ayakulik,1999,0,,162,0
Ayakulik,1999,0,,163,0
Ayakulik,1999,0,,164,0
Ayakulik,1999,0,,165,0
Ayakulik,1999,0,,166,0
Ayakulik,1999,0,,167,0
Ayakulik,1999,0,,168,0
Ayakulik,1999,0,,169,0
Ayakulik,1999,0,,170,0
Ayakulik,1999,0,,171,0
Ayakulik,1999,0,,172,0
Ayakulik,1999,0,,173,0
Ayakulik,1999,0,,174,0
Ayakulik,1999,0,,175,0
Ayakulik,1999,0,,176,0
Ayakulik,1999,0,,177,0
Ayakulik,1999,0,,178,0
Ayakulik,1999,0,,179,0
Ayakulik,1999,0,,180,0
Ayakulik,1999,0,,181,0
Ayakulik,1999,0,,182,0
Ayakulik,1999,0,,183,0
Ayakulik,1999,0,,184,0
Ayakulik,1999,0,,185,0
Ayakulik,1999,0,,186,0
Ayakulik,1999,0,,187,0
Ayakulik,1999,1,,188,1
Ayakulik,1999,0,,189,1
Ayakulik,1999,0,,190,1
Ayakulik,1999,0,,191,1
Ayakulik,1999,0,,192,1
Ayakulik,1999,6,,193,7
Ayakulik,1999,1,,194,8
Ayakulik,1999,8,,195,16
Ayakulik,1999,0,,196,16
Ayakulik,1999,0,,197,16
Ayakulik,1999,2,,198,18
Ayakulik,1999,1,,199,19
Ayakulik,1999,0,,200,19
Ayakulik,1999,69,,201,88
Ayakulik,1999,6,,202,94
Ayakulik,1999,57,,203,151
Ayakulik,1999,91,,204,242
Ayakulik,1999,16,,205,258
Ayakulik,1999,11,,206,269
Ayakulik,1999,103,,207,372
Ayakulik,1999,127,,208,499
Ayakulik,1999,163,,209,662
Ayakulik,1999,166,,210,828
Ayakulik,1999,117,,211,945
Ayakulik,1999,49,,212,994
Ayakulik,1999,13,,213,1007
Ayakulik,1999,294,,214,1301
Ayakulik,1999,361,,215,1662
Ayakulik,1999,35,,216,1697
Ayakulik,1999,126,,217,1823
Ayakulik,1999,0,,218,1823
Ayakulik,1999,48,,219,1871
Ayakulik,1999,84,,220,1955
Ayakulik,1999,384,,221,2339
Ayakulik,1999,481,,222,2820
Ayakulik,1999,0,,223,2820
Ayakulik,1999,0,,224,2820
Ayakulik,1999,0,,225,2820
Ayakulik,1999,0,,226,2820
Ayakulik,1999,68,,227,2888
Ayakulik,1999,59,,228,2947
Ayakulik,1999,185,,229,3132
Ayakulik,1999,332,,230,3464
Ayakulik,1999,576,,231,4040
Ayakulik,1999,168,,232,4208
Ayakulik,1999,260,,233,4468
Ayakulik,1999,0,,234,4468
Ayakulik,1999,0,,235,4468
Ayakulik,1999,0,,236,4468
Ayakulik,1999,0,,237,4468
Ayakulik,1999,0,,238,4468
Ayakulik,1999,0,,239,4468
Ayakulik,1999,0,,240,4468
Ayakulik,1999,0,,241,4468
Ayakulik,1999,0,,242,4468
Ayakulik,1999,0,,243,4468
Ayakulik,1999,0,,244,4468
Ayakulik,1999,0,,245,4468
Ayakulik,1999,0,,246,4468
Ayakulik,1999,0,,247,4468
Ayakulik,1999,0,,248,4468
Ayakulik,1999,0,,249,4468
Ayakulik,1999,0,,250,4468
Ayakulik,1999,0,,251,4468
Ayakulik,1999,0,,252,4468
Ayakulik,1999,0,,253,4468
Ayakulik,1999,0,,254,4468
Ayakulik,1999,0,,255,4468
Ayakulik,1999,0,,256,4468
Ayakulik,1999,0,,257,4468
Ayakulik,1999,0,,258,4468
Ayakulik,1999,0,,259,4468
Ayakulik,1999,0,,260,4468
Ayakulik,1999,0,,261,4468
Ayakulik,1999,0,,262,4468
Ayakulik,1999,0,,263,4468
Ayakulik,1999,0,,264,4468
Ayakulik,1999,0,,265,4468
Ayakulik,1999,0,,266,4468
Ayakulik,1999,0,,267,4468
Ayakulik,1999,0,,268,4468
Ayakulik,1999,0,,269,4468
Ayakulik,1999,0,,270,4468
Ayakulik,1999,0,,271,4468
Ayakulik,1999,0,,272,4468
Ayakulik,1999,0,,273,4468
Ayakulik,1998,0,,152,0
Ayakulik,1998,0,,153,0
Ayakulik,1998,0,,154,0
Ayakulik,1998,0,,155,0
Ayakulik,1998,0,,156,0
Ayakulik,1998,0,,157,0
Ayakulik,1998,0,,158,0
Ayakulik,1998,0,,159,0
Ayakulik,1998,0,,160,0
Ayakulik,1998,0,,161,0
Ayakulik,1998,0,,162,0
Ayakulik,1998,0,,163,0
Ayakulik,1998,0,,164,0
Ayakulik,1998,0,,165,0
Ayakulik,1998,0,,166,0
Ayakulik,1998,0,,167,0
Ayakulik,1998,0,,168,0
Ayakulik,1998,0,,169,0
Ayakulik,1998,0,,170,0
Ayakulik,1998,0,,171,0
Ayakulik,1998,0,,172,0
Ayakulik,1998,0,,173,0
Ayakulik,1998,0,,174,0
Ayakulik,1998,0,,175,0
Ayakulik,1998,0,,176,0
Ayakulik,1998,8,,177,8
Ayakulik,1998,9,,178,17
Ayakulik,1998,3,,179,20
Ayakulik,1998,27,,180,47
Ayakulik,1998,35,,181,82
Ayakulik,1998,7,,182,89
Ayakulik,1998,20,,183,109
Ayakulik,1998,20,,184,129
Ayakulik,1998,30,,185,159
Ayakulik,1998,0,,186,159
Ayakulik,1998,150,,187,309
Ayakulik,1998,300,,188,609
Ayakulik,1998,16,,189,625
Ayakulik,1998,625,,190,1250
Ayakulik,1998,300,,191,1550
Ayakulik,1998,15,,192,1565
Ayakulik,1998,1500,,193,3065
Ayakulik,1998,15,,194,3080
Ayakulik,1998,127,,195,3207
Ayakulik,1998,57,,196,3264
Ayakulik,1998,22,,197,3286
Ayakulik,1998,630,,198,3916
Ayakulik,1998,389,,199,4305
Ayakulik,1998,1254,,200,5559
Ayakulik,1998,2501,,201,8060
Ayakulik,1998,2124,,202,10184
Ayakulik,1998,1160,,203,11344
Ayakulik,1998,1310,,204,12654
Ayakulik,1998,1803,,205,14457
Ayakulik,1998,234,,206,14691
Ayakulik,1998,421,,207,15112
Ayakulik,1998,1482,,208,16594
Ayakulik,1998,13029,,209,29623
Ayakulik,1998,6963,,210,36586
Ayakulik,1998,11422,,211,48008
Ayakulik,1998,21179,,212,69187
Ayakulik,1998,58792,,213,127979
Ayakulik,1998,66087,,214,194066
Ayakulik,1998,17658,,215,211724
Ayakulik,1998,1633,,216,213357
Ayakulik,1998,11995,,217,225352
Ayakulik,1998,10335,,218,235687
Ayakulik,1998,2099,,219,237786
Ayakulik,1998,10469,,220,248255
Ayakulik,1998,60331,,221,308586
Ayakulik,1998,92670,,222,401256
Ayakulik,1998,72851,,223,474107
Ayakulik,1998,27501,,224,501608
Ayakulik,1998,24284,,225,525892
Ayakulik,1998,12393,,226,538285
Ayakulik,1998,8537,,227,546822
Ayakulik,1998,10967,,228,557789
Ayakulik,1998,1840,,229,559629
Ayakulik,1998,5718,,230,565347
Ayakulik,1998,10803,,231,576150
Ayakulik,1998,0,,232,576150
Ayakulik,1998,0,,233,576150
Ayakulik,1998,0,,234,576150
Ayakulik,1998,0,,235,576150
Ayakulik,1998,0,,236,576150
Ayakulik,1998,0,,237,576150
Ayakulik,1998,0,,238,576150
Ayakulik,1998,0,,239,576150
Ayakulik,1998,0,,240,576150
Ayakulik,1998,0,,241,576150
Ayakulik,1998,0,,242,576150
Ayakulik,1998,0,,243,576150
Ayakulik,1998,0,,244,576150
Ayakulik,1998,0,,245,576150
Ayakulik,1998,0,,246,576150
Ayakulik,1998,0,,247,576150
Ayakulik,1998,0,,248,576150
Ayakulik,1998,0,,249,576150
Ayakulik,1998,0,,250,576150
Ayakulik,1998,0,,251,576150
Ayakulik,1998,0,,252,576150
Ayakulik,1998,0,,253,576150
Ayakulik,1998,0,,254,576150
Ayakulik,1998,0,,255,576150
Ayakulik,1998,0,,256,576150
Ayakulik,1998,0,,257,576150
Ayakulik,1998,0,,258,576150
Ayakulik,1998,0,,259,576150
Ayakulik,1998,0,,260,576150
Ayakulik,1998,0,,261,576150
Ayakulik,1998,0,,262,576150
Ayakulik,1998,0,,263,576150
Ayakulik,1998,0,,264,576150
Ayakulik,1998,0,,265,576150
Ayakulik,1998,0,,266,576150
Ayakulik,1998,0,,267,576150
Ayakulik,1998,0,,268,576150
Ayakulik,1998,0,,269,576150
Ayakulik,1998,0,,270,576150
Ayakulik,1998,0,,271,576150
Ayakulik,1998,0,,272,576150
Ayakulik,1998,0,,273,576150
Ayakulik,1997,0,,152,0
Ayakulik,1997,0,,153,0
Ayakulik,1997,0,,154,0
Ayakulik,1997,0,,155,0
Ayakulik,1997,0,,156,0
Ayakulik,1997,0,,157,0
Ayakulik,1997,0,,158,0
Ayakulik,1997,0,,159,0
Ayakulik,1997,0,,160,0
Ayakulik,1997,0,,161,0
Ayakulik,1997,0,,162,0
Ayakulik,1997,0,,163,0
Ayakulik,1997,0,,164,0
Ayakulik,1997,0,,165,0
Ayakulik,1997,0,,166,0
Ayakulik,1997,0,,167,0
Ayakulik,1997,0,,168,0
Ayakulik,1997,0,,169,0
Ayakulik,1997,0,,170,0
Ayakulik,1997,0,,171,0
Ayakulik,1997,0,,172,0
Ayakulik,1997,0,,173,0
Ayakulik,1997,0,,174,0
Ayakulik,1997,0,,175,0
Ayakulik,1997,0,,176,0
Ayakulik,1997,0,,177,0
Ayakulik,1997,0,,178,0
Ayakulik,1997,0,,179,0
Ayakulik,1997,0,,180,0
Ayakulik,1997,0,,181,0
Ayakulik,1997,0,,182,0
Ayakulik,1997,0,,183,0
Ayakulik,1997,1,,184,1
Ayakulik,1997,1,,185,2
Ayakulik,1997,6,,186,8
Ayakulik,1997,3,,187,11
Ayakulik,1997,3,,188,14
Ayakulik,1997,6,,189,20
Ayakulik,1997,7,,190,27
Ayakulik,1997,13,,191,40
Ayakulik,1997,8,,192,48
Ayakulik,1997,20,,193,68
Ayakulik,1997,28,,194,96
Ayakulik,1997,6,,195,102
Ayakulik,1997,9,,196,111
Ayakulik,1997,14,,197,125
Ayakulik,1997,10,,198,135
Ayakulik,1997,0,,199,135
Ayakulik,1997,38,,200,173
Ayakulik,1997,160,,201,333
Ayakulik,1997,49,,202,382
Ayakulik,1997,116,,203,498
Ayakulik,1997,17,,204,515
Ayakulik,1997,16,,205,531
Ayakulik,1997,12,,206,543
Ayakulik,1997,4,,207,547
Ayakulik,1997,91,,208,638
Ayakulik,1997,230,,209,868
Ayakulik,1997,108,,210,976
Ayakulik,1997,484,,211,1460
Ayakulik,1997,265,,212,1725
Ayakulik,1997,227,,213,1952
Ayakulik,1997,264,,214,2216
Ayakulik,1997,151,,215,2367
Ayakulik,1997,395,,216,2762
Ayakulik,1997,210,,217,2972
Ayakulik,1997,129,,218,3101
Ayakulik,1997,118,,219,3219
Ayakulik,1997,240,,220,3459
Ayakulik,1997,88,,221,3547
Ayakulik,1997,206,,222,3753
Ayakulik,1997,1097,,223,4850
Ayakulik,1997,618,,224,5468
Ayakulik,1997,164,,225,5632
Ayakulik,1997,74,,226,5706
Ayakulik,1997,355,,227,6061
Ayakulik,1997,865,,228,6926
Ayakulik,1997,364,,229,7290
Ayakulik,1997,273,,230,7563
Ayakulik,1997,164,,231,7727
Ayakulik,1997,568,,232,8295
Ayakulik,1997,1378,,233,9673
Ayakulik,1997,309,,234,9982
Ayakulik,1997,110,,235,10092
Ayakulik,1997,100,,236,10192
Ayakulik,1997,395,,237,10587
Ayakulik,1997,311,,238,10898
Ayakulik,1997,537,,239,11435
Ayakulik,1997,1100,,240,12535
Ayakulik,1997,692,,241,13227
Ayakulik,1997,367,,242,13594
Ayakulik,1997,0,,243,13594
Ayakulik,1997,0,,244,13594
Ayakulik,1997,0,,245,13594
Ayakulik,1997,0,,246,13594
Ayakulik,1997,0,,247,13594
Ayakulik,1997,0,,248,13594
Ayakulik,1997,0,,249,13594
Ayakulik,1997,0,,250,13594
Ayakulik,1997,0,,251,13594
Ayakulik,1997,0,,252,13594
Ayakulik,1997,0,,253,13594
Ayakulik,1997,0,,254,13594
Ayakulik,1997,0,,255,13594
Ayakulik,1997,0,,256,13594
Ayakulik,1997,0,,257,13594
Ayakulik,1997,0,,258,13594
Ayakulik,1997,0,,259,13594
Ayakulik,1997,0,,260,13594
Ayakulik,1997,0,,261,13594
Ayakulik,1997,0,,262,13594
Ayakulik,1997,0,,263,13594
Ayakulik,1997,0,,264,13594
Ayakulik,1997,0,,265,13594
Ayakulik,1997,0,,266,13594
Ayakulik,1997,0,,267,13594
Ayakulik,1997,0,,268,13594
Ayakulik,1997,0,,269,13594
Ayakulik,1997,0,,270,13594
Ayakulik,1997,0,,271,13594
Ayakulik,1997,0,,272,13594
Ayakulik,1997,0,,273,13594
Ayakulik,1996,0,,153,0
Ayakulik,1996,0,,154,0
Ayakulik,1996,0,,155,0
Ayakulik,1996,0,,156,0
Ayakulik,1996,0,,157,0
Ayakulik,1996,0,,158,0
Ayakulik,1996,0,,159,0
Ayakulik,1996,0,,160,0
Ayakulik,1996,0,,161,0
Ayakulik,1996,0,,162,0
Ayakulik,1996,0,,163,0
Ayakulik,1996,0,,164,0
Ayakulik,1996,0,,165,0
Ayakulik,1996,0,,166,0
Ayakulik,1996,0,,167,0
Ayakulik,1996,0,,168,0
Ayakulik,1996,0,,169,0
Ayakulik,1996,0,,170,0
Ayakulik,1996,0,,171,0
Ayakulik,1996,0,,172,0
Ayakulik,1996,0,,173,0
Ayakulik,1996,0,,174,0
Ayakulik,1996,0,,175,0
Ayakulik,1996,1,,176,1
Ayakulik,1996,0,,177,1
Ayakulik,1996,0,,178,1
Ayakulik,1996,1,,179,2
Ayakulik,1996,3,,180,5
Ayakulik,1996,4,,181,9
Ayakulik,1996,0,,182,9
Ayakulik,1996,0,,183,9
Ayakulik,1996,1,,184,10
Ayakulik,1996,0,,185,10
Ayakulik,1996,0,,186,10
Ayakulik,1996,14,,187,24
Ayakulik,1996,14,,188,38
Ayakulik,1996,6,,189,44
Ayakulik,1996,7,,190,51
Ayakulik,1996,8,,191,59
Ayakulik,1996,0,,192,59
Ayakulik,1996,0,,193,59
Ayakulik,1996,3,,194,62
Ayakulik,1996,0,,195,62
Ayakulik,1996,4,,196,66
Ayakulik,1996,27,,197,93
Ayakulik,1996,28,,198,121
Ayakulik,1996,42,,199,163
Ayakulik,1996,210,,200,373
Ayakulik,1996,25,,201,398
Ayakulik,1996,135,,202,533
Ayakulik,1996,534,,203,1067
Ayakulik,1996,1265,,204,2332
Ayakulik,1996,636,,205,2968
Ayakulik,1996,629,,206,3597
Ayakulik,1996,255,,207,3852
Ayakulik,1996,3349,,208,7201
Ayakulik,1996,1716,,209,8917
Ayakulik,1996,393,,210,9310
Ayakulik,1996,998,,211,10308
Ayakulik,1996,6681,,212,16989
Ayakulik,1996,16941,,213,33930
Ayakulik,1996,18404,,214,52334
Ayakulik,1996,40085,,215,92419
Ayakulik,1996,35086,,216,127505
Ayakulik,1996,39054,,217,166559
Ayakulik,1996,6166,,218,172725
Ayakulik,1996,380,,219,173105
Ayakulik,1996,2331,,220,175436
Ayakulik,1996,49412,,221,224848
Ayakulik,1996,81733,,222,306581
Ayakulik,1996,107348,,223,413929
Ayakulik,1996,38826,,224,452755
Ayakulik,1996,31532,,225,484287
Ayakulik,1996,20827,,226,505114
Ayakulik,1996,9054,,227,514168
Ayakulik,1996,4430,,228,518598
Ayakulik,1996,1853,,229,520451
Ayakulik,1996,670,,230,521121
Ayakulik,1996,1428,,231,522549
Ayakulik,1996,997,,232,523546
Ayakulik,1996,936,,233,524482
Ayakulik,1996,3376,,234,527858
Ayakulik,1996,1647,,235,529505
Ayakulik,1996,1509,,236,531014
Ayakulik,1996,971,,237,531985
Ayakulik,1996,885,,238,532870
Ayakulik,1996,0,,239,532870
Ayakulik,1996,0,,240,532870
Ayakulik,1996,0,,241,532870
Ayakulik,1996,0,,242,532870
Ayakulik,1996,0,,243,532870
Ayakulik,1996,0,,244,532870
Ayakulik,1996,0,,245,532870
Ayakulik,1996,0,,246,532870
Ayakulik,1996,0,,247,532870
Ayakulik,1996,0,,248,532870
Ayakulik,1996,0,,249,532870
Ayakulik,1996,0,,250,532870
Ayakulik,1996,0,,251,532870
Ayakulik,1996,0,,252,532870
Ayakulik,1996,0,,253,532870
Ayakulik,1996,0,,254,532870
Ayakulik,1996,0,,255,532870
Ayakulik,1996,0,,256,532870
Ayakulik,1996,0,,257,532870
Ayakulik,1996,0,,258,532870
Ayakulik,1996,0,,259,532870
Ayakulik,1996,0,,260,532870
Ayakulik,1996,0,,261,532870
Ayakulik,1996,0,,262,532870
Ayakulik,1996,0,,263,532870
Ayakulik,1996,0,,264,532870
Ayakulik,1996,0,,265,532870
Ayakulik,1996,0,,266,532870
Ayakulik,1996,0,,267,532870
Ayakulik,1996,0,,268,532870
Ayakulik,1996,0,,269,532870
Ayakulik,1996,0,,270,532870
Ayakulik,1996,0,,271,532870
Ayakulik,1996,0,,272,532870
Ayakulik,1996,0,,273,532870
Ayakulik,1996,0,,274,532870
Ayakulik,1995,0,,152,0
Ayakulik,1995,0,,153,0
Ayakulik,1995,0,,154,0
Ayakulik,1995,0,,155,0
Ayakulik,1995,0,,156,0
Ayakulik,1995,0,,157,0
Ayakulik,1995,0,,158,0
Ayakulik,1995,0,,159,0
Ayakulik,1995,0,,160,0
Ayakulik,1995,0,,161,0
Ayakulik,1995,0,,162,0
Ayakulik,1995,0,,163,0
Ayakulik,1995,0,,164,0
Ayakulik,1995,0,,165,0
Ayakulik,1995,0,,166,0
Ayakulik,1995,0,,167,0
Ayakulik,1995,0,,168,0
Ayakulik,1995,0,,169,0
Ayakulik,1995,0,,170,0
Ayakulik,1995,0,,171,0
Ayakulik,1995,0,,172,0
Ayakulik,1995,0,,173,0
Ayakulik,1995,0,,174,0
Ayakulik,1995,0,,175,0
Ayakulik,1995,0,,176,0
Ayakulik,1995,0,,177,0
Ayakulik,1995,0,,178,0
Ayakulik,1995,0,,179,0
Ayakulik,1995,1,,180,1
Ayakulik,1995,2,,181,3
Ayakulik,1995,0,,182,3
Ayakulik,1995,0,,183,3
Ayakulik,1995,2,,184,5
Ayakulik,1995,0,,185,5
Ayakulik,1995,0,,186,5
Ayakulik,1995,4,,187,9
Ayakulik,1995,1,,188,10
Ayakulik,1995,6,,189,16
Ayakulik,1995,3,,190,19
Ayakulik,1995,2,,191,21
Ayakulik,1995,0,,192,21
Ayakulik,1995,2,,193,23
Ayakulik,1995,2,,194,25
Ayakulik,1995,0,,195,25
Ayakulik,1995,0,,196,25
Ayakulik,1995,5,,197,30
Ayakulik,1995,10,,198,40
Ayakulik,1995,30,,199,70
Ayakulik,1995,93,,200,163
Ayakulik,1995,29,,201,192
Ayakulik,1995,31,,202,223
Ayakulik,1995,61,,203,284
Ayakulik,1995,61,,204,345
Ayakulik,1995,48,,205,393
Ayakulik,1995,51,,206,444
Ayakulik,1995,22,,207,466
Ayakulik,1995,98,,208,564
Ayakulik,1995,153,,209,717
Ayakulik,1995,86,,210,803
Ayakulik,1995,47,,211,850
Ayakulik,1995,508,,212,1358
Ayakulik,1995,886,,213,2244
Ayakulik,1995,423,,214,2667
Ayakulik,1995,82,,215,2749
Ayakulik,1995,191,,216,2940
Ayakulik,1995,260,,217,3200
Ayakulik,1995,442,,218,3642
Ayakulik,1995,551,,219,4193
Ayakulik,1995,362,,220,4555
Ayakulik,1995,481,,221,5036
Ayakulik,1995,438,,222,5474
Ayakulik,1995,290,,223,5764
Ayakulik,1995,359,,224,6123
Ayakulik,1995,268,,225,6391
Ayakulik,1995,991,,226,7382
Ayakulik,1995,570,,227,7952
Ayakulik,1995,2133,,228,10085
Ayakulik,1995,710,,229,10795
Ayakulik,1995,1365,,230,12160
Ayakulik,1995,458,,231,12618
Ayakulik,1995,727,,232,13345
Ayakulik,1995,2090,,233,15435
Ayakulik,1995,2070,,234,17505
Ayakulik,1995,2496,,235,20001
Ayakulik,1995,3364,,236,23365
Ayakulik,1995,2599,,237,25964
Ayakulik,1995,1656,,238,27620
Ayakulik,1995,385,,239,28005
Ayakulik,1995,1000,,240,29005
Ayakulik,1995,0,,241,29005
Ayakulik,1995,0,,242,29005
Ayakulik,1995,0,,243,29005
Ayakulik,1995,0,,244,29005
Ayakulik,1995,0,,245,29005
Ayakulik,1995,0,,246,29005
Ayakulik,1995,0,,247,29005
Ayakulik,1995,0,,248,29005
Ayakulik,1995,0,,249,29005
Ayakulik,1995,0,,250,29005
Ayakulik,1995,0,,251,29005
Ayakulik,1995,0,,252,29005
Ayakulik,1995,0,,253,29005
Ayakulik,1995,0,,254,29005
Ayakulik,1995,0,,255,29005
Ayakulik,1995,0,,256,29005
Ayakulik,1995,0,,257,29005
Ayakulik,1995,0,,258,29005
Ayakulik,1995,0,,259,29005
Ayakulik,1995,0,,260,29005
Ayakulik,1995,0,,261,29005
Ayakulik,1995,0,,262,29005
Ayakulik,1995,0,,263,29005
Ayakulik,1995,0,,264,29005
Ayakulik,1995,0,,265,29005
Ayakulik,1995,0,,266,29005
Ayakulik,1995,0,,267,29005
Ayakulik,1995,0,,268,29005
Ayakulik,1995,0,,269,29005
Ayakulik,1995,0,,270,29005
Ayakulik,1995,0,,271,29005
Ayakulik,1995,0,,272,29005
Ayakulik,1995,0,,273,29005
Ayakulik,1994,0,,152,0
Ayakulik,1994,0,,153,0
Ayakulik,1994,0,,154,0
Ayakulik,1994,0,,155,0
Ayakulik,1994,0,,156,0
Ayakulik,1994,0,,157,0
Ayakulik,1994,0,,158,0
Ayakulik,1994,0,,159,0
Ayakulik,1994,0,,160,0
Ayakulik,1994,0,,161,0
Ayakulik,1994,0,,162,0
Ayakulik,1994,0,,163,0
Ayakulik,1994,0,,164,0
Ayakulik,1994,0,,165,0
Ayakulik,1994,0,,166,0
Ayakulik,1994,0,,167,0
Ayakulik,1994,0,,168,0
Ayakulik,1994,0,,169,0
Ayakulik,1994,0,,170,0
Ayakulik,1994,0,,171,0
Ayakulik,1994,1,,172,1
Ayakulik,1994,0,,173,1
Ayakulik,1994,0,,174,1
Ayakulik,1994,1,,175,2
Ayakulik,1994,0,,176,2
Ayakulik,1994,0,,177,2
Ayakulik,1994,1,,178,3
Ayakulik,1994,1,,179,4
Ayakulik,1994,0,,180,4
Ayakulik,1994,0,,181,4
Ayakulik,1994,1,,182,5
Ayakulik,1994,5,,183,10
Ayakulik,1994,9,,184,19
Ayakulik,1994,8,,185,27
Ayakulik,1994,8,,186,35
Ayakulik,1994,6,,187,41
Ayakulik,1994,6,,188,47
Ayakulik,1994,70,,189,117
Ayakulik,1994,33,,190,150
Ayakulik,1994,44,,191,194
Ayakulik,1994,79,,192,273
Ayakulik,1994,59,,193,332
Ayakulik,1994,71,,194,403
Ayakulik,1994,82,,195,485
Ayakulik,1994,172,,196,657
Ayakulik,1994,44,,197,701
Ayakulik,1994,104,,198,805
Ayakulik,1994,277,,199,1082
Ayakulik,1994,162,,200,1244
Ayakulik,1994,31,,201,1275
Ayakulik,1994,551,,202,1826
Ayakulik,1994,551,,203,2377
Ayakulik,1994,550,,204,2927
Ayakulik,1994,418,,205,3345
Ayakulik,1994,1406,,206,4751
Ayakulik,1994,1672,,207,6423
Ayakulik,1994,3878,,208,10301
Ayakulik,1994,3187,,209,13488
Ayakulik,1994,3764,,210,17252
Ayakulik,1994,3212,,211,20464
Ayakulik,1994,10434,,212,30898
Ayakulik,1994,7946,,213,38844
Ayakulik,1994,8213,,214,47057
Ayakulik,1994,9709,,215,56766
Ayakulik,1994,23554,,216,80320
Ayakulik,1994,17397,,217,97717
Ayakulik,1994,10012,,218,107729
Ayakulik,1994,5299,,219,113028
Ayakulik,1994,10882,,220,123910
Ayakulik,1994,4451,,221,128361
Ayakulik,1994,5378,,222,133739
Ayakulik,1994,3537,,223,137276
Ayakulik,1994,7459,,224,144735
Ayakulik,1994,5655,,225,150390
Ayakulik,1994,4550,,226,154940
Ayakulik,1994,5306,,227,160246
Ayakulik,1994,2670,,228,162916
Ayakulik,1994,1673,,229,164589
Ayakulik,1994,2586,,230,167175
Ayakulik,1994,4781,,231,171956
Ayakulik,1994,3716,,232,175672
Ayakulik,1994,4230,,233,179902
Ayakulik,1994,1052,,234,180954
Ayakulik,1994,1101,,235,182055
Ayakulik,1994,532,,236,182587
Ayakulik,1994,1840,,237,184427
Ayakulik,1994,2992,,238,187419
Ayakulik,1994,2197,,239,189616
Ayakulik,1994,2197,,240,191813
Ayakulik,1994,432,,241,192245
Ayakulik,1994,571,,242,192816
Ayakulik,1994,494,,243,193310
Ayakulik,1994,439,,244,193749
Ayakulik,1994,401,,245,194150
Ayakulik,1994,379,,246,194529
Ayakulik,1994,338,,247,194867
Ayakulik,1994,182,,248,195049
Ayakulik,1994,200,,249,195249
Ayakulik,1994,200,,250,195449
Ayakulik,1994,0,,251,195449
Ayakulik,1994,0,,252,195449
Ayakulik,1994,0,,253,195449
Ayakulik,1994,0,,254,195449
Ayakulik,1994,0,,255,195449
Ayakulik,1994,0,,256,195449
Ayakulik,1994,0,,257,195449
Ayakulik,1994,0,,258,195449
Ayakulik,1994,0,,259,195449
Ayakulik,1994,0,,260,195449
Ayakulik,1994,0,,261,195449
Ayakulik,1994,0,,262,195449
Ayakulik,1994,0,,263,195449
Ayakulik,1994,0,,264,195449
Ayakulik,1994,0,,265,195449
Ayakulik,1994,0,,266,195449
Ayakulik,1994,0,,267,195449
Ayakulik,1994,0,,268,195449
Ayakulik,1994,0,,269,195449
Ayakulik,1994,0,,270,195449
Ayakulik,1994,0,,271,195449
Ayakulik,1994,0,,272,195449
Ayakulik,1994,0,,273,195449
Ayakulik,1993,0,,152,0
Ayakulik,1993,0,,153,0
Ayakulik,1993,0,,154,0
Ayakulik,1993,0,,155,0
Ayakulik,1993,0,,156,0
Ayakulik,1993,0,,157,0
Ayakulik,1993,0,,158,0
Ayakulik,1993,0,,159,0
Ayakulik,1993,0,,160,0
Ayakulik,1993,0,,161,0
Ayakulik,1993,0,,162,0
Ayakulik,1993,0,,163,0
Ayakulik,1993,0,,164,0
Ayakulik,1993,0,,165,0
Ayakulik,1993,0,,166,0
Ayakulik,1993,0,,167,0
Ayakulik,1993,0,,168,0
Ayakulik,1993,0,,169,0
Ayakulik,1993,0,,170,0
Ayakulik,1993,0,,171,0
Ayakulik,1993,0,,172,0
Ayakulik,1993,0,,173,0
Ayakulik,1993,0,,174,0
Ayakulik,1993,0,,175,0
Ayakulik,1993,0,,176,0
Ayakulik,1993,0,,177,0
Ayakulik,1993,0,,178,0
Ayakulik,1993,0,,179,0
Ayakulik,1993,0,,180,0
Ayakulik,1993,3,,181,3
Ayakulik,1993,1,,182,4
Ayakulik,1993,28,,183,32
Ayakulik,1993,61,,184,93
Ayakulik,1993,17,,185,110
Ayakulik,1993,5,,186,115
Ayakulik,1993,12,,187,127
Ayakulik,1993,6,,188,133
Ayakulik,1993,7,,189,140
Ayakulik,1993,5,,190,145
Ayakulik,1993,47,,191,192
Ayakulik,1993,18,,192,210
Ayakulik,1993,34,,193,244
Ayakulik,1993,43,,194,287
Ayakulik,1993,38,,195,325
Ayakulik,1993,112,,196,437
Ayakulik,1993,138,,197,575
Ayakulik,1993,72,,198,647
Ayakulik,1993,119,,199,766
Ayakulik,1993,1,,200,767
Ayakulik,1993,6,,201,773
Ayakulik,1993,7,,202,780
Ayakulik,1993,12,,203,792
Ayakulik,1993,2,,204,794
Ayakulik,1993,147,,205,941
Ayakulik,1993,60,,206,1001
Ayakulik,1993,116,,207,1117
Ayakulik,1993,462,,208,1579
Ayakulik,1993,498,,209,2077
Ayakulik,1993,34,,210,2111
Ayakulik,1993,37,,211,2148
Ayakulik,1993,250,,212,2398
Ayakulik,1993,1085,,213,3483
Ayakulik,1993,93,,214,3576
Ayakulik,1993,202,,215,3778
Ayakulik,1993,903,,216,4681
Ayakulik,1993,92,,217,4773
Ayakulik,1993,382,,218,5155
Ayakulik,1993,887,,219,6042
Ayakulik,1993,64,,220,6106
Ayakulik,1993,305,,221,6411
Ayakulik,1993,2192,,222,8603
Ayakulik,1993,381,,223,8984
Ayakulik,1993,32,,224,9016
Ayakulik,1993,564,,225,9580
Ayakulik,1993,380,,226,9960
Ayakulik,1993,431,,227,10391
Ayakulik,1993,615,,228,11006
Ayakulik,1993,388,,229,11394
Ayakulik,1993,156,,230,11550
Ayakulik,1993,233,,231,11783
Ayakulik,1993,233,,232,12016
Ayakulik,1993,234,,233,12250
Ayakulik,1993,149,,234,12399
Ayakulik,1993,1061,,235,13460
Ayakulik,1993,1835,,236,15295
Ayakulik,1993,7915,,237,23210
Ayakulik,1993,4023,,238,27233
Ayakulik,1993,933,,239,28166
Ayakulik,1993,980,,240,29146
Ayakulik,1993,451,,241,29597
Ayakulik,1993,0,,242,29597
Ayakulik,1993,0,,243,29597
Ayakulik,1993,0,,244,29597
Ayakulik,1993,0,,245,29597
Ayakulik,1993,0,,246,29597
Ayakulik,1993,0,,247,29597
Ayakulik,1993,0,,248,29597
Ayakulik,1993,0,,249,29597
Ayakulik,1993,0,,250,29597
Ayakulik,1993,0,,251,29597
Ayakulik,1993,0,,252,29597
Ayakulik,1993,0,,253,29597
Ayakulik,1993,0,,254,29597
Ayakulik,1993,0,,255,29597
Ayakulik,1993,0,,256,29597
Ayakulik,1993,0,,257,29597
Ayakulik,1993,0,,258,29597
Ayakulik,1993,0,,259,29597
Ayakulik,1993,0,,260,29597
Ayakulik,1993,0,,261,29597
Ayakulik,1993,0,,262,29597
Ayakulik,1993,0,,263,29597
Ayakulik,1993,0,,264,29597
Ayakulik,1993,0,,265,29597
Ayakulik,1993,0,,266,29597
Ayakulik,1993,0,,267,29597
Ayakulik,1993,0,,268,29597
Ayakulik,1993,0,,269,29597
Ayakulik,1993,0,,270,29597
Ayakulik,1993,0,,271,29597
Ayakulik,1993,0,,272,29597
Ayakulik,1993,0,,273,29597
Ayakulik,1992,0,,153,0
Ayakulik,1992,0,,154,0
Ayakulik,1992,0,,155,0
Ayakulik,1992,0,,156,0
Ayakulik,1992,0,,157,0
Ayakulik,1992,0,,158,0
Ayakulik,1992,0,,159,0
Ayakulik,1992,0,,160,0
Ayakulik,1992,0,,161,0
Ayakulik,1992,0,,162,0
Ayakulik,1992,0,,163,0
Ayakulik,1992,0,,164,0
Ayakulik,1992,0,,165,0
Ayakulik,1992,0,,166,0
Ayakulik,1992,0,,167,0
Ayakulik,1992,0,,168,0
Ayakulik,1992,0,,169,0
Ayakulik,1992,0,,170,0
Ayakulik,1992,0,,171,0
Ayakulik,1992,0,,172,0
Ayakulik,1992,0,,173,0
Ayakulik,1992,0,,174,0
Ayakulik,1992,0,,175,0
Ayakulik,1992,0,,176,0
Ayakulik,1992,0,,177,0
Ayakulik,1992,0,,178,0
Ayakulik,1992,0,,179,0
Ayakulik,1992,0,,180,0
Ayakulik,1992,0,,181,0
Ayakulik,1992,0,,182,0
Ayakulik,1992,0,,183,0
Ayakulik,1992,0,,184,0
Ayakulik,1992,1,,185,1
Ayakulik,1992,0,,186,1
Ayakulik,1992,0,,187,1
Ayakulik,1992,2,,188,3
Ayakulik,1992,0,,189,3
Ayakulik,1992,0,,190,3
Ayakulik,1992,0,,191,3
Ayakulik,1992,8,,192,11
Ayakulik,1992,44,,193,55
Ayakulik,1992,31,,194,86
Ayakulik,1992,38,,195,124
Ayakulik,1992,52,,196,176
Ayakulik,1992,138,,197,314
Ayakulik,1992,539,,198,853
Ayakulik,1992,1111,,199,1964
Ayakulik,1992,145,,200,2109
Ayakulik,1992,821,,201,2930
Ayakulik,1992,1102,,202,4032
Ayakulik,1992,1975,,203,6007
Ayakulik,1992,2074,,204,8081
Ayakulik,1992,501,,205,8582
Ayakulik,1992,3860,,206,12442
Ayakulik,1992,12657,,207,25099
Ayakulik,1992,10222,,208,35321
Ayakulik,1992,6249,,209,41570
Ayakulik,1992,6092,,210,47662
Ayakulik,1992,1776,,211,49438
Ayakulik,1992,3155,,212,52593
Ayakulik,1992,1890,,213,54483
Ayakulik,1992,6365,,214,60848
Ayakulik,1992,3635,,215,64483
Ayakulik,1992,8512,,216,72995
Ayakulik,1992,28153,,217,101148
Ayakulik,1992,35235,,218,136383
Ayakulik,1992,18111,,219,154494
Ayakulik,1992,16006,,220,170500
Ayakulik,1992,25406,,221,195906
Ayakulik,1992,120174,,222,316080
Ayakulik,1992,79068,,223,395148
Ayakulik,1992,28708,,224,423856
Ayakulik,1992,30128,,225,453984
Ayakulik,1992,27897,,226,481881
Ayakulik,1992,45214,,227,527095
Ayakulik,1992,15988,,228,543083
Ayakulik,1992,35150,,229,578233
Ayakulik,1992,18277,,230,596510
Ayakulik,1992,17404,,231,613914
Ayakulik,1992,6414,,232,620328
Ayakulik,1992,10555,,233,630883
Ayakulik,1992,10000,,234,640883
Ayakulik,1992,5000,,235,645883
Ayakulik,1992,5000,,236,650883
Ayakulik,1992,5000,,237,655883
Ayakulik,1992,3000,,238,658883
Ayakulik,1992,3000,,239,661883
Ayakulik,1992,2000,,240,663883
Ayakulik,1992,2000,,241,665883
Ayakulik,1992,0,,242,665883
Ayakulik,1992,0,,243,665883
Ayakulik,1992,0,,244,665883
Ayakulik,1992,0,,245,665883
Ayakulik,1992,0,,246,665883
Ayakulik,1992,0,,247,665883
Ayakulik,1992,0,,248,665883
Ayakulik,1992,0,,249,665883
Ayakulik,1992,0,,250,665883
Ayakulik,1992,0,,251,665883
Ayakulik,1992,0,,252,665883
Ayakulik,1992,0,,253,665883
Ayakulik,1992,0,,254,665883
Ayakulik,1992,0,,255,665883
Ayakulik,1992,0,,256,665883
Ayakulik,1992,0,,257,665883
Ayakulik,1992,0,,258,665883
Ayakulik,1992,0,,259,665883
Ayakulik,1992,0,,260,665883
Ayakulik,1992,0,,261,665883
Ayakulik,1992,0,,262,665883
Ayakulik,1992,0,,263,665883
Ayakulik,1992,0,,264,665883
Ayakulik,1992,0,,265,665883
Ayakulik,1992,0,,266,665883
Ayakulik,1992,0,,267,665883
Ayakulik,1992,0,,268,665883
Ayakulik,1992,0,,269,665883
Ayakulik,1992,0,,270,665883
Ayakulik,1992,0,,271,665883
Ayakulik,1992,0,,272,665883
Ayakulik,1992,0,,273,665883
Ayakulik,1992,0,,274,665883
Ayakulik,1991,0,,152,0
Ayakulik,1991,0,,153,0
Ayakulik,1991,0,,154,0
Ayakulik,1991,0,,155,0
Ayakulik,1991,0,,156,0
Ayakulik,1991,0,,157,0
Ayakulik,1991,0,,158,0
Ayakulik,1991,0,,159,0
Ayakulik,1991,0,,160,0
Ayakulik,1991,0,,161,0
Ayakulik,1991,0,,162,0
Ayakulik,1991,0,,163,0
Ayakulik,1991,0,,164,0
Ayakulik,1991,0,,165,0
Ayakulik,1991,0,,166,0
Ayakulik,1991,0,,167,0
Ayakulik,1991,0,,168,0
Ayakulik,1991,0,,169,0
Ayakulik,1991,0,,170,0
Ayakulik,1991,0,,171,0
Ayakulik,1991,0,,172,0
Ayakulik,1991,0,,173,0
Ayakulik,1991,0,,174,0
Ayakulik,1991,0,,175,0
Ayakulik,1991,0,,176,0
Ayakulik,1991,0,,177,0
Ayakulik,1991,0,,178,0
Ayakulik,1991,0,,179,0
Ayakulik,1991,0,,180,0
Ayakulik,1991,0,,181,0
Ayakulik,1991,1,,182,1
Ayakulik,1991,6,,183,7
Ayakulik,1991,0,,184,7
Ayakulik,1991,17,,185,24
Ayakulik,1991,13,,186,37
Ayakulik,1991,11,,187,48
Ayakulik,1991,27,,188,75
Ayakulik,1991,53,,189,128
Ayakulik,1991,10,,190,138
Ayakulik,1991,87,,191,225
Ayakulik,1991,15,,192,240
Ayakulik,1991,5,,193,245
Ayakulik,1991,68,,194,313
Ayakulik,1991,52,,195,365
Ayakulik,1991,22,,196,387
Ayakulik,1991,18,,197,405
Ayakulik,1991,174,,198,579
Ayakulik,1991,20,,199,599
Ayakulik,1991,24,,200,623
Ayakulik,1991,34,,201,657
Ayakulik,1991,219,,202,876
Ayakulik,1991,320,,203,1196
Ayakulik,1991,226,,204,1422
Ayakulik,1991,189,,205,1611
Ayakulik,1991,208,,206,1819
Ayakulik,1991,81,,207,1900
Ayakulik,1991,650,,208,2550
Ayakulik,1991,173,,209,2723
Ayakulik,1991,294,,210,3017
Ayakulik,1991,421,,211,3438
Ayakulik,1991,181,,212,3619
Ayakulik,1991,31,,213,3650
Ayakulik,1991,85,,214,3735
Ayakulik,1991,356,,215,4091
Ayakulik,1991,508,,216,4599
Ayakulik,1991,461,,217,5060
Ayakulik,1991,600,,218,5660
Ayakulik,1991,652,,219,6312
Ayakulik,1991,690,,220,7002
Ayakulik,1991,687,,221,7689
Ayakulik,1991,1373,,222,9062
Ayakulik,1991,1564,,223,10626
Ayakulik,1991,1215,,224,11841
Ayakulik,1991,1212,,225,13053
Ayakulik,1991,3000,,226,16053
Ayakulik,1991,0,,227,16053
Ayakulik,1991,0,,228,16053
Ayakulik,1991,0,,229,16053
Ayakulik,1991,0,,230,16053
Ayakulik,1991,0,,231,16053
Ayakulik,1991,0,,232,16053
Ayakulik,1991,0,,233,16053
Ayakulik,1991,0,,234,16053
Ayakulik,1991,0,,235,16053
Ayakulik,1991,0,,236,16053
Ayakulik,1991,0,,237,16053
Ayakulik,1991,0,,238,16053
Ayakulik,1991,0,,239,16053
Ayakulik,1991,0,,240,16053
Ayakulik,1991,0,,241,16053
Ayakulik,1991,0,,242,16053
Ayakulik,1991,0,,243,16053
Ayakulik,1991,0,,244,16053
Ayakulik,1991,0,,245,16053
Ayakulik,1991,0,,246,16053
Ayakulik,1991,0,,247,16053
Ayakulik,1991,0,,248,16053
Ayakulik,1991,0,,249,16053
Ayakulik,1991,0,,250,16053
Ayakulik,1991,0,,251,16053
Ayakulik,1991,0,,252,16053
Ayakulik,1991,0,,253,16053
Ayakulik,1991,0,,254,16053
Ayakulik,1991,0,,255,16053
Ayakulik,1991,0,,256,16053
Ayakulik,1991,0,,257,16053
Ayakulik,1991,0,,258,16053
Ayakulik,1991,0,,259,16053
Ayakulik,1991,0,,260,16053
Ayakulik,1991,0,,261,16053
Ayakulik,1991,0,,262,16053
Ayakulik,1991,0,,263,16053
Ayakulik,1991,0,,264,16053
Ayakulik,1991,0,,265,16053
Ayakulik,1991,0,,266,16053
Ayakulik,1991,0,,267,16053
Ayakulik,1991,0,,268,16053
Ayakulik,1991,0,,269,16053
Ayakulik,1991,0,,270,16053
Ayakulik,1991,0,,271,16053
Ayakulik,1991,0,,272,16053
Ayakulik,1991,0,,273,16053
Ayakulik,1990,0,,152,0
Ayakulik,1990,0,,153,0
Ayakulik,1990,0,,154,0
Ayakulik,1990,0,,155,0
Ayakulik,1990,0,,156,0
Ayakulik,1990,0,,157,0
Ayakulik,1990,0,,158,0
Ayakulik,1990,0,,159,0
Ayakulik,1990,0,,160,0
Ayakulik,1990,0,,161,0
Ayakulik,1990,0,,162,0
Ayakulik,1990,0,,163,0
Ayakulik,1990,0,,164,0
Ayakulik,1990,0,,165,0
Ayakulik,1990,0,,166,0
Ayakulik,1990,0,,167,0
Ayakulik,1990,0,,168,0
Ayakulik,1990,0,,169,0
Ayakulik,1990,0,,170,0
Ayakulik,1990,0,,171,0
Ayakulik,1990,0,,172,0
Ayakulik,1990,0,,173,0
Ayakulik,1990,0,,174,0
Ayakulik,1990,0,,175,0
Ayakulik,1990,0,,176,0
Ayakulik,1990,0,,177,0
Ayakulik,1990,0,,178,0
Ayakulik,1990,0,,179,0
Ayakulik,1990,12,,180,12
Ayakulik,1990,41,,181,53
Ayakulik,1990,16,,182,69
Ayakulik,1990,16,,183,85
Ayakulik,1990,31,,184,116
Ayakulik,1990,4,,185,120
Ayakulik,1990,0,,186,120
Ayakulik,1990,20,,187,140
Ayakulik,1990,8,,188,148
Ayakulik,1990,20,,189,168
Ayakulik,1990,16,,190,184
Ayakulik,1990,31,,191,215
Ayakulik,1990,9,,192,224
Ayakulik,1990,55,,193,279
Ayakulik,1990,29,,194,308
Ayakulik,1990,107,,195,415
Ayakulik,1990,88,,196,503
Ayakulik,1990,44,,197,547
Ayakulik,1990,5,,198,552
Ayakulik,1990,10,,199,562
Ayakulik,1990,25,,200,587
Ayakulik,1990,38,,201,625
Ayakulik,1990,253,,202,878
Ayakulik,1990,102,,203,980
Ayakulik,1990,29,,204,1009
Ayakulik,1990,177,,205,1186
Ayakulik,1990,81,,206,1267
Ayakulik,1990,95,,207,1362
Ayakulik,1990,249,,208,1611
Ayakulik,1990,13216,,209,14827
Ayakulik,1990,13990,,210,28817
Ayakulik,1990,29111,,211,57928
Ayakulik,1990,8042,,212,65970
Ayakulik,1990,10362,,213,76332
Ayakulik,1990,27523,,214,103855
Ayakulik,1990,100251,,215,204106
Ayakulik,1990,76545,,216,280651
Ayakulik,1990,42407,,217,323058
Ayakulik,1990,52435,,218,375493
Ayakulik,1990,31596,,219,407089
Ayakulik,1990,38651,,220,445740
Ayakulik,1990,10433,,221,456173
Ayakulik,1990,31688,,222,487861
Ayakulik,1990,12491,,223,500352
Ayakulik,1990,14642,,224,514994
Ayakulik,1990,11202,,225,526196
Ayakulik,1990,20435,,226,546631
Ayakulik,1990,2714,,227,549345
Ayakulik,1990,35484,,228,584829
Ayakulik,1990,13748,,229,598577
Ayakulik,1990,12986,,230,611563
Ayakulik,1990,6122,,231,617685
Ayakulik,1990,15090,,232,632775
Ayakulik,1990,3660,,233,636435
Ayakulik,1990,8770,,234,645205
Ayakulik,1990,22252,,235,667457
Ayakulik,1990,7623,,236,675080
Ayakulik,1990,3883,,237,678963
Ayakulik,1990,2309,,238,681272
Ayakulik,1990,7994,,239,689266
Ayakulik,1990,2489,,240,691755
Ayakulik,1990,772,,241,692527
Ayakulik,1990,790,,242,693317
Ayakulik,1990,2268,,243,695585
Ayakulik,1990,779,,244,696364
Ayakulik,1990,2678,,245,699042
Ayakulik,1990,3817,,246,702859
Ayakulik,1990,2275,,247,705134
Ayakulik,1990,1244,,248,706378
Ayakulik,1990,953,,249,707331
Ayakulik,1990,541,,250,707872
Ayakulik,1990,500,,251,708372
Ayakulik,1990,0,,252,708372
Ayakulik,1990,0,,253,708372
Ayakulik,1990,0,,254,708372
Ayakulik,1990,0,,255,708372
Ayakulik,1990,0,,256,708372
Ayakulik,1990,0,,257,708372
Ayakulik,1990,0,,258,708372
Ayakulik,1990,0,,259,708372
Ayakulik,1990,0,,260,708372
Ayakulik,1990,0,,261,708372
Ayakulik,1990,0,,262,708372
Ayakulik,1990,0,,263,708372
Ayakulik,1990,0,,264,708372
Ayakulik,1990,0,,265,708372
Ayakulik,1990,0,,266,708372
Ayakulik,1990,0,,267,708372
Ayakulik,1990,0,,268,708372
Ayakulik,1990,0,,269,708372
Ayakulik,1990,0,,270,708372
Ayakulik,1990,0,,271,708372
Ayakulik,1990,0,,272,708372
Ayakulik,1990,0,,273,708372
Ayakulik,1989,0,,152,0
Ayakulik,1989,0,,153,0
Ayakulik,1989,0,,154,0
Ayakulik,1989,0,,155,0
Ayakulik,1989,0,,156,0
Ayakulik,1989,0,,157,0
Ayakulik,1989,0,,158,0
Ayakulik,1989,0,,159,0
Ayakulik,1989,0,,160,0
Ayakulik,1989,0,,161,0
Ayakulik,1989,0,,162,0
Ayakulik,1989,0,,163,0
Ayakulik,1989,0,,164,0
Ayakulik,1989,0,,165,0
Ayakulik,1989,0,,166,0
Ayakulik,1989,0,,167,0
Ayakulik,1989,0,,168,0
Ayakulik,1989,0,,169,0
Ayakulik,1989,0,,170,0
Ayakulik,1989,0,,171,0
Ayakulik,1989,0,,172,0
Ayakulik,1989,0,,173,0
Ayakulik,1989,0,,174,0
Ayakulik,1989,0,,175,0
Ayakulik,1989,0,,176,0
Ayakulik,1989,0,,177,0
Ayakulik,1989,3,,178,3
Ayakulik,1989,12,,179,15
Ayakulik,1989,11,,180,26
Ayakulik,1989,6,,181,32
Ayakulik,1989,6,,182,38
Ayakulik,1989,1,,183,39
Ayakulik,1989,17,,184,56
Ayakulik,1989,36,,185,92
Ayakulik,1989,23,,186,115
Ayakulik,1989,12,,187,127
Ayakulik,1989,51,,188,178
Ayakulik,1989,29,,189,207
Ayakulik,1989,6,,190,213
Ayakulik,1989,2,,191,215
Ayakulik,1989,30,,192,245
Ayakulik,1989,101,,193,346
Ayakulik,1989,166,,194,512
Ayakulik,1989,59,,195,571
Ayakulik,1989,89,,196,660
Ayakulik,1989,62,,197,722
Ayakulik,1989,44,,198,766
Ayakulik,1989,68,,199,834
Ayakulik,1989,198,,200,1032
Ayakulik,1989,51,,201,1083
Ayakulik,1989,174,,202,1257
Ayakulik,1989,122,,203,1379
Ayakulik,1989,286,,204,1665
Ayakulik,1989,212,,205,1877
Ayakulik,1989,14,,206,1891
Ayakulik,1989,498,,207,2389
Ayakulik,1989,289,,208,2678
Ayakulik,1989,59,,209,2737
Ayakulik,1989,86,,210,2823
Ayakulik,1989,188,,211,3011
Ayakulik,1989,141,,212,3152
Ayakulik,1989,178,,213,3330
Ayakulik,1989,163,,214,3493
Ayakulik,1989,166,,215,3659
Ayakulik,1989,195,,216,3854
Ayakulik,1989,1228,,217,5082
Ayakulik,1989,1610,,218,6692
Ayakulik,1989,691,,219,7383
Ayakulik,1989,624,,220,8007
Ayakulik,1989,1053,,221,9060
Ayakulik,1989,544,,222,9604
Ayakulik,1989,842,,223,10446
Ayakulik,1989,1362,,224,11808
Ayakulik,1989,1733,,225,13541
Ayakulik,1989,6014,,226,19555
Ayakulik,1989,4713,,227,24268
Ayakulik,1989,444,,228,24712
Ayakulik,1989,2506,,229,27218
Ayakulik,1989,2484,,230,29702
Ayakulik,1989,1675,,231,31377
Ayakulik,1989,1584,,232,32961
Ayakulik,1989,1106,,233,34067
Ayakulik,1989,1544,,234,35611
Ayakulik,1989,283,,235,35894
Ayakulik,1989,4980,,236,40874
Ayakulik,1989,1500,,237,42374
Ayakulik,1989,1500,,238,43874
Ayakulik,1989,249,,239,44123
Ayakulik,1989,413,,240,44536
Ayakulik,1989,505,,241,45041
Ayakulik,1989,90,,242,45131
Ayakulik,1989,524,,243,45655
Ayakulik,1989,0,,244,45655
Ayakulik,1989,0,,245,45655
Ayakulik,1989,0,,246,45655
Ayakulik,1989,0,,247,45655
Ayakulik,1989,0,,248,45655
Ayakulik,1989,0,,249,45655
Ayakulik,1989,0,,250,45655
Ayakulik,1989,0,,251,45655
Ayakulik,1989,0,,252,45655
Ayakulik,1989,0,,253,45655
Ayakulik,1989,0,,254,45655
Ayakulik,1989,0,,255,45655
Ayakulik,1989,0,,256,45655
Ayakulik,1989,0,,257,45655
Ayakulik,1989,0,,258,45655
Ayakulik,1989,0,,259,45655
Ayakulik,1989,0,,260,45655
Ayakulik,1989,0,,261,45655
Ayakulik,1989,0,,262,45655
Ayakulik,1989,0,,263,45655
Ayakulik,1989,0,,264,45655
Ayakulik,1989,0,,265,45655
Ayakulik,1989,0,,266,45655
Ayakulik,1989,0,,267,45655
Ayakulik,1989,0,,268,45655
Ayakulik,1989,0,,269,45655
Ayakulik,1989,0,,270,45655
Ayakulik,1989,0,,271,45655
Ayakulik,1989,0,,272,45655
Ayakulik,1989,0,,273,45655
Ayakulik,1988,0,,153,0
Ayakulik,1988,0,,154,0
Ayakulik,1988,0,,155,0
Ayakulik,1988,0,,156,0
Ayakulik,1988,0,,157,0
Ayakulik,1988,0,,158,0
Ayakulik,1988,0,,159,0
Ayakulik,1988,0,,160,0
Ayakulik,1988,0,,161,0
Ayakulik,1988,0,,162,0
Ayakulik,1988,0,,163,0
Ayakulik,1988,0,,164,0
Ayakulik,1988,0,,165,0
Ayakulik,1988,0,,166,0
Ayakulik,1988,0,,167,0
Ayakulik,1988,0,,168,0
Ayakulik,1988,0,,169,0
Ayakulik,1988,0,,170,0
Ayakulik,1988,0,,171,0
Ayakulik,1988,0,,172,0
Ayakulik,1988,0,,173,0
Ayakulik,1988,0,,174,0
Ayakulik,1988,0,,175,0
Ayakulik,1988,0,,176,0
Ayakulik,1988,0,,177,0
Ayakulik,1988,1,,178,1
Ayakulik,1988,0,,179,1
Ayakulik,1988,0,,180,1
Ayakulik,1988,0,,181,1
Ayakulik,1988,0,,182,1
Ayakulik,1988,3,,183,4
Ayakulik,1988,1,,184,5
Ayakulik,1988,1,,185,6
Ayakulik,1988,1,,186,7
Ayakulik,1988,5,,187,12
Ayakulik,1988,15,,188,27
Ayakulik,1988,54,,189,81
Ayakulik,1988,59,,190,140
Ayakulik,1988,51,,191,191
Ayakulik,1988,3,,192,194
Ayakulik,1988,4,,193,198
Ayakulik,1988,26,,194,224
Ayakulik,1988,21,,195,245
Ayakulik,1988,137,,196,382
Ayakulik,1988,85,,197,467
Ayakulik,1988,86,,198,553
Ayakulik,1988,7,,199,560
Ayakulik,1988,19,,200,579
Ayakulik,1988,38,,201,617
Ayakulik,1988,351,,202,968
Ayakulik,1988,139,,203,1107
Ayakulik,1988,94,,204,1201
Ayakulik,1988,536,,205,1737
Ayakulik,1988,151,,206,1888
Ayakulik,1988,4513,,207,6401
Ayakulik,1988,1284,,208,7685
Ayakulik,1988,330,,209,8015
Ayakulik,1988,730,,210,8745
Ayakulik,1988,1918,,211,10663
Ayakulik,1988,6722,,212,17385
Ayakulik,1988,4408,,213,21793
Ayakulik,1988,3305,,214,25098
Ayakulik,1988,478,,215,25576
Ayakulik,1988,17547,,216,43123
Ayakulik,1988,13601,,217,56724
Ayakulik,1988,5525,,218,62249
Ayakulik,1988,57009,,219,119258
Ayakulik,1988,19634,,220,138892
Ayakulik,1988,8034,,221,146926
Ayakulik,1988,25981,,222,172907
Ayakulik,1988,13873,,223,186780
Ayakulik,1988,32928,,224,219708
Ayakulik,1988,23270,,225,242978
Ayakulik,1988,20280,,226,263258
Ayakulik,1988,33461,,227,296719
Ayakulik,1988,24706,,228,321425
Ayakulik,1988,4090,,229,325515
Ayakulik,1988,5996,,230,331511
Ayakulik,1988,7310,,231,338821
Ayakulik,1988,5377,,232,344198
Ayakulik,1988,5191,,233,349389
Ayakulik,1988,3290,,234,352679
Ayakulik,1988,1904,,235,354583
Ayakulik,1988,5064,,236,359647
Ayakulik,1988,2406,,237,362053
Ayakulik,1988,8560,,238,370613
Ayakulik,1988,7566,,239,378179
Ayakulik,1988,3949,,240,382128
Ayakulik,1988,4088,,241,386216
Ayakulik,1988,4572,,242,390788
Ayakulik,1988,2980,,243,393768
Ayakulik,1988,1287,,244,395055
Ayakulik,1988,870,,245,395925
Ayakulik,1988,984,,246,396909
Ayakulik,1988,500,,247,397409
Ayakulik,1988,0,,248,397409
Ayakulik,1988,0,,249,397409
Ayakulik,1988,0,,250,397409
Ayakulik,1988,0,,251,397409
Ayakulik,1988,0,,252,397409
Ayakulik,1988,0,,253,397409
Ayakulik,1988,0,,254,397409
Ayakulik,1988,0,,255,397409
Ayakulik,1988,0,,256,397409
Ayakulik,1988,0,,257,397409
Ayakulik,1988,0,,258,397409
Ayakulik,1988,0,,259,397409
Ayakulik,1988,0,,260,397409
Ayakulik,1988,0,,261,397409
Ayakulik,1988,0,,262,397409
Ayakulik,1988,0,,263,397409
Ayakulik,1988,0,,264,397409
Ayakulik,1988,0,,265,397409
Ayakulik,1988,0,,266,397409
Ayakulik,1988,0,,267,397409
Ayakulik,1988,0,,268,397409
Ayakulik,1988,0,,269,397409
Ayakulik,1988,0,,270,397409
Ayakulik,1988,0,,271,397409
Ayakulik,1988,0,,272,397409
Ayakulik,1988,0,,273,397409
Ayakulik,1988,0,,274,397409
Ayakulik,1987,0,,152,0
Ayakulik,1987,0,,153,0
Ayakulik,1987,0,,154,0
Ayakulik,1987,0,,155,0
Ayakulik,1987,0,,156,0
Ayakulik,1987,0,,157,0
Ayakulik,1987,0,,158,0
Ayakulik,1987,0,,159,0
Ayakulik,1987,0,,160,0
Ayakulik,1987,0,,161,0
Ayakulik,1987,0,,162,0
Ayakulik,1987,0,,163,0
Ayakulik,1987,0,,164,0
Ayakulik,1987,0,,165,0
Ayakulik,1987,0,,166,0
Ayakulik,1987,0,,167,0
Ayakulik,1987,0,,168,0
Ayakulik,1987,0,,169,0
Ayakulik,1987,0,,170,0
Ayakulik,1987,0,,171,0
Ayakulik,1987,0,,172,0
Ayakulik,1987,0,,173,0
Ayakulik,1987,0,,174,0
Ayakulik,1987,0,,175,0
Ayakulik,1987,0,,176,0
Ayakulik,1987,0,,177,0
Ayakulik,1987,0,,178,0
Ayakulik,1987,0,,179,0
Ayakulik,1987,0,,180,0
Ayakulik,1987,0,,181,0
Ayakulik,1987,0,,182,0
Ayakulik,1987,0,,183,0
Ayakulik,1987,0,,184,0
Ayakulik,1987,2,,185,2
Ayakulik,1987,3,,186,5
Ayakulik,1987,3,,187,8
Ayakulik,1987,3,,188,11
Ayakulik,1987,13,,189,24
Ayakulik,1987,2,,190,26
Ayakulik,1987,3,,191,29
Ayakulik,1987,7,,192,36
Ayakulik,1987,37,,193,73
Ayakulik,1987,12,,194,85
Ayakulik,1987,81,,195,166
Ayakulik,1987,37,,196,203
Ayakulik,1987,9,,197,212
Ayakulik,1987,32,,198,244
Ayakulik,1987,16,,199,260
Ayakulik,1987,17,,200,277
Ayakulik,1987,17,,201,294
Ayakulik,1987,21,,202,315
Ayakulik,1987,10,,203,325
Ayakulik,1987,41,,204,366
Ayakulik,1987,11,,205,377
Ayakulik,1987,133,,206,510
Ayakulik,1987,43,,207,553
Ayakulik,1987,102,,208,655
Ayakulik,1987,75,,209,730
Ayakulik,1987,29,,210,759
Ayakulik,1987,83,,211,842
Ayakulik,1987,72,,212,914
Ayakulik,1987,111,,213,1025
Ayakulik,1987,9,,214,1034
Ayakulik,1987,4,,215,1038
Ayakulik,1987,103,,216,1141
Ayakulik,1987,212,,217,1353
Ayakulik,1987,14,,218,1367
Ayakulik,1987,120,,219,1487
Ayakulik,1987,215,,220,1702
Ayakulik,1987,176,,221,1878
Ayakulik,1987,150,,222,2028
Ayakulik,1987,26,,223,2054
Ayakulik,1987,31,,224,2085
Ayakulik,1987,374,,225,2459
Ayakulik,1987,239,,226,2698
Ayakulik,1987,157,,227,2855
Ayakulik,1987,88,,228,2943
Ayakulik,1987,186,,229,3129
Ayakulik,1987,364,,230,3493
Ayakulik,1987,273,,231,3766
Ayakulik,1987,256,,232,4022
Ayakulik,1987,235,,233,4257
Ayakulik,1987,78,,234,4335
Ayakulik,1987,328,,235,4663
Ayakulik,1987,23,,236,4686
Ayakulik,1987,299,,237,4985
Ayakulik,1987,209,,238,5194
Ayakulik,1987,195,,239,5389
Ayakulik,1987,259,,240,5648
Ayakulik,1987,190,,241,5838
Ayakulik,1987,86,,242,5924
Ayakulik,1987,370,,243,6294
Ayakulik,1987,351,,244,6645
Ayakulik,1987,14,,245,6659
Ayakulik,1987,500,,246,7159
Ayakulik,1987,430,,247,7589
Ayakulik,1987,137,,248,7726
Ayakulik,1987,93,,249,7819
Ayakulik,1987,0,,250,7819
Ayakulik,1987,0,,251,7819
Ayakulik,1987,0,,252,7819
Ayakulik,1987,0,,253,7819
Ayakulik,1987,0,,254,7819
Ayakulik,1987,0,,255,7819
Ayakulik,1987,0,,256,7819
Ayakulik,1987,0,,257,7819
Ayakulik,1987,0,,258,7819
Ayakulik,1987,0,,259,7819
Ayakulik,1987,0,,260,7819
Ayakulik,1987,0,,261,7819
Ayakulik,1987,0,,262,7819
Ayakulik,1987,0,,263,7819
Ayakulik,1987,0,,264,7819
Ayakulik,1987,0,,265,7819
Ayakulik,1987,0,,266,7819
Ayakulik,1987,0,,267,7819
Ayakulik,1987,0,,268,7819
Ayakulik,1987,0,,269,7819
Ayakulik,1987,0,,270,7819
Ayakulik,1987,0,,271,7819
Ayakulik,1987,0,,272,7819
Ayakulik,1987,0,,273,7819
Ayakulik,1986,0,,152,0
Ayakulik,1986,0,,153,0
Ayakulik,1986,0,,154,0
Ayakulik,1986,0,,155,0
Ayakulik,1986,0,,156,0
Ayakulik,1986,0,,157,0
Ayakulik,1986,0,,158,0
Ayakulik,1986,0,,159,0
Ayakulik,1986,0,,160,0
Ayakulik,1986,0,,161,0
Ayakulik,1986,1,,162,1
Ayakulik,1986,0,,163,1
Ayakulik,1986,0,,164,1
Ayakulik,1986,0,,165,1
Ayakulik,1986,0,,166,1
Ayakulik,1986,0,,167,1
Ayakulik,1986,0,,168,1
Ayakulik,1986,0,,169,1
Ayakulik,1986,0,,170,1
Ayakulik,1986,0,,171,1
Ayakulik,1986,0,,172,1
Ayakulik,1986,0,,173,1
Ayakulik,1986,0,,174,1
Ayakulik,1986,0,,175,1
Ayakulik,1986,0,,176,1
Ayakulik,1986,0,,177,1
Ayakulik,1986,0,,178,1
Ayakulik,1986,0,,179,1
Ayakulik,1986,0,,180,1
Ayakulik,1986,0,,181,1
Ayakulik,1986,0,,182,1
Ayakulik,1986,9,,183,10
Ayakulik,1986,8,,184,18
Ayakulik,1986,15,,185,33
Ayakulik,1986,30,,186,63
Ayakulik,1986,33,,187,96
Ayakulik,1986,126,,188,222
Ayakulik,1986,18,,189,240
Ayakulik,1986,621,,190,861
Ayakulik,1986,151,,191,1012
Ayakulik,1986,57,,192,1069
Ayakulik,1986,449,,193,1518
Ayakulik,1986,812,,194,2330
Ayakulik,1986,466,,195,2796
Ayakulik,1986,80,,196,2876
Ayakulik,1986,2290,,197,5166
Ayakulik,1986,1144,,198,6310
Ayakulik,1986,1093,,199,7403
Ayakulik,1986,1210,,200,8613
Ayakulik,1986,4927,,201,13540
Ayakulik,1986,125,,202,13665
Ayakulik,1986,1127,,203,14792
Ayakulik,1986,1250,,204,16042
Ayakulik,1986,1250,,205,17292
Ayakulik,1986,1250,,206,18542
Ayakulik,1986,1250,,207,19792
Ayakulik,1986,1250,,208,21042
Ayakulik,1986,1250,,209,22292
Ayakulik,1986,1250,,210,23542
Ayakulik,1986,1250,,211,24792
Ayakulik,1986,4084,,212,28876
Ayakulik,1986,16633,,213,45509
Ayakulik,1986,16024,,214,61533
Ayakulik,1986,12342,,215,73875
Ayakulik,1986,4971,,216,78846
Ayakulik,1986,2492,,217,81338
Ayakulik,1986,4833,,218,86171
Ayakulik,1986,1982,,219,88153
Ayakulik,1986,36374,,220,124527
Ayakulik,1986,20037,,221,144564
Ayakulik,1986,10906,,222,155470
Ayakulik,1986,58912,,223,214382
Ayakulik,1986,42561,,224,256943
Ayakulik,1986,52599,,225,309542
Ayakulik,1986,37892,,226,347434
Ayakulik,1986,41683,,227,389117
Ayakulik,1986,26285,,228,415402
Ayakulik,1986,90004,,229,505406
Ayakulik,1986,16360,,230,521766
Ayakulik,1986,12484,,231,534250
Ayakulik,1986,3875,,232,538125
Ayakulik,1986,2302,,233,540427
Ayakulik,1986,3270,,234,543697
Ayakulik,1986,2585,,235,546282
Ayakulik,1986,9760,,236,556042
Ayakulik,1986,2000,,237,558042
Ayakulik,1986,768,,238,558810
Ayakulik,1986,200,,239,559010
Ayakulik,1986,200,,240,559210
Ayakulik,1986,100,,241,559310
Ayakulik,1986,900,,242,560210
Ayakulik,1986,0,,243,560210
Ayakulik,1986,0,,244,560210
Ayakulik,1986,0,,245,560210
Ayakulik,1986,0,,246,560210
Ayakulik,1986,0,,247,560210
Ayakulik,1986,0,,248,560210
Ayakulik,1986,0,,249,560210
Ayakulik,1986,0,,250,560210
Ayakulik,1986,0,,251,560210
Ayakulik,1986,0,,252,560210
Ayakulik,1986,0,,253,560210
Ayakulik,1986,0,,254,560210
Ayakulik,1986,0,,255,560210
Ayakulik,1986,0,,256,560210
Ayakulik,1986,0,,257,560210
Ayakulik,1986,0,,258,560210
Ayakulik,1986,0,,259,560210
Ayakulik,1986,0,,260,560210
Ayakulik,1986,0,,261,560210
Ayakulik,1986,0,,262,560210
Ayakulik,1986,0,,263,560210
Ayakulik,1986,0,,264,560210
Ayakulik,1986,0,,265,560210
Ayakulik,1986,0,,266,560210
Ayakulik,1986,0,,267,560210
Ayakulik,1986,0,,268,560210
Ayakulik,1986,0,,269,560210
Ayakulik,1986,0,,270,560210
Ayakulik,1986,0,,271,560210
Ayakulik,1986,0,,272,560210
Ayakulik,1986,0,,273,560210
Ayakulik,1985,0,,152,0
Ayakulik,1985,0,,153,0
Ayakulik,1985,0,,154,0
Ayakulik,1985,0,,155,0
Ayakulik,1985,0,,156,0
Ayakulik,1985,0,,157,0
Ayakulik,1985,0,,158,0
Ayakulik,1985,0,,159,0
Ayakulik,1985,0,,160,0
Ayakulik,1985,0,,161,0
Ayakulik,1985,0,,162,0
Ayakulik,1985,0,,163,0
Ayakulik,1985,0,,164,0
Ayakulik,1985,0,,165,0
Ayakulik,1985,0,,166,0
Ayakulik,1985,0,,167,0
Ayakulik,1985,0,,168,0
Ayakulik,1985,0,,169,0
Ayakulik,1985,0,,170,0
Ayakulik,1985,0,,171,0
Ayakulik,1985,0,,172,0
Ayakulik,1985,0,,173,0
Ayakulik,1985,0,,174,0
Ayakulik,1985,0,,175,0
Ayakulik,1985,0,,176,0
Ayakulik,1985,0,,177,0
Ayakulik,1985,2,,178,2
Ayakulik,1985,0,,179,2
Ayakulik,1985,1,,180,3
Ayakulik,1985,2,,181,5
Ayakulik,1985,3,,182,8
Ayakulik,1985,0,,183,8
Ayakulik,1985,0,,184,8
Ayakulik,1985,0,,185,8
Ayakulik,1985,0,,186,8
Ayakulik,1985,0,,187,8
Ayakulik,1985,0,,188,8
Ayakulik,1985,2,,189,10
Ayakulik,1985,4,,190,14
Ayakulik,1985,15,,191,29
Ayakulik,1985,63,,192,92
Ayakulik,1985,72,,193,164
Ayakulik,1985,172,,194,336
Ayakulik,1985,22,,195,358
Ayakulik,1985,17,,196,375
Ayakulik,1985,5,,197,380
Ayakulik,1985,1,,198,381
Ayakulik,1985,9,,199,390
Ayakulik,1985,10,,200,400
Ayakulik,1985,5,,201,405
Ayakulik,1985,2,,202,407
Ayakulik,1985,5,,203,412
Ayakulik,1985,38,,204,450
Ayakulik,1985,15,,205,465
Ayakulik,1985,12,,206,477
Ayakulik,1985,108,,207,585
Ayakulik,1985,38,,208,623
Ayakulik,1985,67,,209,690
Ayakulik,1985,144,,210,834
Ayakulik,1985,21,,211,855
Ayakulik,1985,1,,212,856
Ayakulik,1985,24,,213,880
Ayakulik,1985,32,,214,912
Ayakulik,1985,71,,215,983
Ayakulik,1985,38,,216,1021
Ayakulik,1985,108,,217,1129
Ayakulik,1985,38,,218,1167
Ayakulik,1985,68,,219,1235
Ayakulik,1985,9,,220,1244
Ayakulik,1985,70,,221,1314
Ayakulik,1985,217,,222,1531
Ayakulik,1985,159,,223,1690
Ayakulik,1985,223,,224,1913
Ayakulik,1985,120,,225,2033
Ayakulik,1985,115,,226,2148
Ayakulik,1985,113,,227,2261
Ayakulik,1985,112,,228,2373
Ayakulik,1985,110,,229,2483
Ayakulik,1985,105,,230,2588
Ayakulik,1985,103,,231,2691
Ayakulik,1985,100,,232,2791
Ayakulik,1985,95,,233,2886
Ayakulik,1985,90,,234,2976
Ayakulik,1985,60,,235,3036
Ayakulik,1985,82,,236,3118
Ayakulik,1985,56,,237,3174
Ayakulik,1985,121,,238,3295
Ayakulik,1985,105,,239,3400
Ayakulik,1985,72,,240,3472
Ayakulik,1985,53,,241,3525
Ayakulik,1985,154,,242,3679
Ayakulik,1985,41,,243,3720
Ayakulik,1985,0,,244,3720
Ayakulik,1985,0,,245,3720
Ayakulik,1985,0,,246,3720
Ayakulik,1985,0,,247,3720
Ayakulik,1985,27,,248,3747
Ayakulik,1985,27,,249,3774
Ayakulik,1985,14,,250,3788
Ayakulik,1985,0,,251,3788
Ayakulik,1985,0,,252,3788
Ayakulik,1985,0,,253,3788
Ayakulik,1985,0,,254,3788
Ayakulik,1985,0,,255,3788
Ayakulik,1985,0,,256,3788
Ayakulik,1985,0,,257,3788
Ayakulik,1985,0,,258,3788
Ayakulik,1985,0,,259,3788
Ayakulik,1985,0,,260,3788
Ayakulik,1985,0,,261,3788
Ayakulik,1985,0,,262,3788
Ayakulik,1985,0,,263,3788
Ayakulik,1985,0,,264,3788
Ayakulik,1985,0,,265,3788
Ayakulik,1985,0,,266,3788
Ayakulik,1985,0,,267,3788
Ayakulik,1985,0,,268,3788
Ayakulik,1985,0,,269,3788
Ayakulik,1985,0,,270,3788
Ayakulik,1985,0,,271,3788
Ayakulik,1985,0,,272,3788
Ayakulik,1985,0,,273,3788
Ayakulik,1984,11,,153,11
Ayakulik,1984,8,,154,19
Ayakulik,1984,5,,155,24
Ayakulik,1984,13,,156,37
Ayakulik,1984,3,,157,40
Ayakulik,1984,3,,158,43
Ayakulik,1984,7,,159,50
Ayakulik,1984,2,,160,52
Ayakulik,1984,0,,161,52
Ayakulik,1984,1,,162,53
Ayakulik,1984,0,,163,53
Ayakulik,1984,2,,164,55
Ayakulik,1984,1,,165,56
Ayakulik,1984,1,,166,57
Ayakulik,1984,0,,167,57
Ayakulik,1984,0,,168,57
Ayakulik,1984,2,,169,59
Ayakulik,1984,1,,170,60
Ayakulik,1984,0,,171,60
Ayakulik,1984,0,,172,60
Ayakulik,1984,0,,173,60
Ayakulik,1984,0,,174,60
Ayakulik,1984,1,,175,61
Ayakulik,1984,2,,176,63
Ayakulik,1984,0,,177,63
Ayakulik,1984,4,,178,67
Ayakulik,1984,31,,179,98
Ayakulik,1984,44,,180,142
Ayakulik,1984,1,,181,143
Ayakulik,1984,20,,182,163
Ayakulik,1984,456,,183,619
Ayakulik,1984,753,,184,1372
Ayakulik,1984,1182,,185,2554
Ayakulik,1984,308,,186,2862
Ayakulik,1984,140,,187,3002
Ayakulik,1984,1088,,188,4090
Ayakulik,1984,827,,189,4917
Ayakulik,1984,149,,190,5066
Ayakulik,1984,742,,191,5808
Ayakulik,1984,2604,,192,8412
Ayakulik,1984,5186,,193,13598
Ayakulik,1984,8089,,194,21687
Ayakulik,1984,9283,,195,30970
Ayakulik,1984,13968,,196,44938
Ayakulik,1984,4568,,197,49506
Ayakulik,1984,1463,,198,50969
Ayakulik,1984,1829,,199,52798
Ayakulik,1984,7884,,200,60682
Ayakulik,1984,16076,,201,76758
Ayakulik,1984,17449,,202,94207
Ayakulik,1984,13634,,203,107841
Ayakulik,1984,4704,,204,112545
Ayakulik,1984,2793,,205,115338
Ayakulik,1984,2621,,206,117959
Ayakulik,1984,3960,,207,121919
Ayakulik,1984,5000,,208,126919
Ayakulik,1984,8989,,209,135908
Ayakulik,1984,31082,,210,166990
Ayakulik,1984,12948,,211,179938
Ayakulik,1984,5573,,212,185511
Ayakulik,1984,5641,,213,191152
Ayakulik,1984,11171,,214,202323
Ayakulik,1984,36410,,215,238733
Ayakulik,1984,73530,,216,312263
Ayakulik,1984,28910,,217,341173
Ayakulik,1984,58368,,218,399541
Ayakulik,1984,57415,,219,456956
Ayakulik,1984,31805,,220,488761
Ayakulik,1984,15800,,221,504561
Ayakulik,1984,21433,,222,525994
Ayakulik,1984,5666,,223,531660
Ayakulik,1984,3178,,224,534838
Ayakulik,1984,2374,,225,537212
Ayakulik,1984,3309,,226,540521
Ayakulik,1984,3174,,227,543695
Ayakulik,1984,8050,,228,551745
Ayakulik,1984,10146,,229,561891
Ayakulik,1984,6656,,230,568547
Ayakulik,1984,11991,,231,580538
Ayakulik,1984,9848,,232,590386
Ayakulik,1984,4748,,233,595134
Ayakulik,1984,5141,,234,600275
Ayakulik,1984,9872,,235,610147
Ayakulik,1984,5565,,236,615712
Ayakulik,1984,9348,,237,625060
Ayakulik,1984,6000,,238,631060
Ayakulik,1984,0,,239,631060
Ayakulik,1984,0,,240,631060
Ayakulik,1984,0,,241,631060
Ayakulik,1984,0,,242,631060
Ayakulik,1984,0,,243,631060
Ayakulik,1984,0,,244,631060
Ayakulik,1984,0,,245,631060
Ayakulik,1984,0,,246,631060
Ayakulik,1984,0,,247,631060
Ayakulik,1984,0,,248,631060
Ayakulik,1984,0,,249,631060
Ayakulik,1984,0,,250,631060
Ayakulik,1984,0,,251,631060
Ayakulik,1984,0,,252,631060
Ayakulik,1984,0,,253,631060
Ayakulik,1984,0,,254,631060
Ayakulik,1984,0,,255,631060
Ayakulik,1984,0,,256,631060
Ayakulik,1984,0,,257,631060
Ayakulik,1984,0,,258,631060
Ayakulik,1984,0,,259,631060
Ayakulik,1984,0,,260,631060
Ayakulik,1984,0,,261,631060
Ayakulik,1984,0,,262,631060
Ayakulik,1984,0,,263,631060
Ayakulik,1984,0,,264,631060
Ayakulik,1984,0,,265,631060
Ayakulik,1984,0,,266,631060
Ayakulik,1984,0,,267,631060
Ayakulik,1984,0,,268,631060
Ayakulik,1984,0,,269,631060
Ayakulik,1984,0,,270,631060
Ayakulik,1984,0,,271,631060
Ayakulik,1984,0,,272,631060
Ayakulik,1984,0,,273,631060
Ayakulik,1984,0,,274,631060
Ayakulik,1983,0,,152,0
Ayakulik,1983,0,,153,0
Ayakulik,1983,0,,154,0
Ayakulik,1983,0,,155,0
Ayakulik,1983,0,,156,0
Ayakulik,1983,0,,157,0
Ayakulik,1983,0,,158,0
Ayakulik,1983,0,,159,0
Ayakulik,1983,0,,160,0
Ayakulik,1983,0,,161,0
Ayakulik,1983,0,,162,0
Ayakulik,1983,0,,163,0
Ayakulik,1983,0,,164,0
Ayakulik,1983,0,,165,0
Ayakulik,1983,0,,166,0
Ayakulik,1983,0,,167,0
Ayakulik,1983,0,,168,0
Ayakulik,1983,0,,169,0
Ayakulik,1983,0,,170,0
Ayakulik,1983,0,,171,0
Ayakulik,1983,0,,172,0
Ayakulik,1983,0,,173,0
Ayakulik,1983,0,,174,0
Ayakulik,1983,0,,175,0
Ayakulik,1983,0,,176,0
Ayakulik,1983,0,,177,0
Ayakulik,1983,0,,178,0
Ayakulik,1983,0,,179,0
Ayakulik,1983,0,,180,0
Ayakulik,1983,0,,181,0
Ayakulik,1983,0,,182,0
Ayakulik,1983,1,,183,1
Ayakulik,1983,0,,184,1
Ayakulik,1983,0,,185,1
Ayakulik,1983,0,,186,1
Ayakulik,1983,0,,187,1
Ayakulik,1983,2,,188,3
Ayakulik,1983,0,,189,3
Ayakulik,1983,0,,190,3
Ayakulik,1983,2,,191,5
Ayakulik,1983,14,,192,19
Ayakulik,1983,89,,193,108
Ayakulik,1983,90,,194,198
Ayakulik,1983,63,,195,261
Ayakulik,1983,23,,196,284
Ayakulik,1983,133,,197,417
Ayakulik,1983,174,,198,591
Ayakulik,1983,36,,199,627
Ayakulik,1983,27,,200,654
Ayakulik,1983,46,,201,700
Ayakulik,1983,51,,202,751
Ayakulik,1983,62,,203,813
Ayakulik,1983,50,,204,863
Ayakulik,1983,25,,205,888
Ayakulik,1983,69,,206,957
Ayakulik,1983,103,,207,1060
Ayakulik,1983,141,,208,1201
Ayakulik,1983,664,,209,1865
Ayakulik,1983,141,,210,2006
Ayakulik,1983,169,,211,2175
Ayakulik,1983,91,,212,2266
Ayakulik,1983,80,,213,2346
Ayakulik,1983,56,,214,2402
Ayakulik,1983,37,,215,2439
Ayakulik,1983,337,,216,2776
Ayakulik,1983,820,,217,3596
Ayakulik,1983,226,,218,3822
Ayakulik,1983,112,,219,3934
Ayakulik,1983,425,,220,4359
Ayakulik,1983,285,,221,4644
Ayakulik,1983,440,,222,5084
Ayakulik,1983,796,,223,5880
Ayakulik,1983,626,,224,6506
Ayakulik,1983,1475,,225,7981
Ayakulik,1983,625,,226,8606
Ayakulik,1983,612,,227,9218
Ayakulik,1983,753,,228,9971
Ayakulik,1983,701,,229,10672
Ayakulik,1983,728,,230,11400
Ayakulik,1983,935,,231,12335
Ayakulik,1983,644,,232,12979
Ayakulik,1983,820,,233,13799
Ayakulik,1983,1017,,234,14816
Ayakulik,1983,1111,,235,15927
Ayakulik,1983,758,,236,16685
Ayakulik,1983,292,,237,16977
Ayakulik,1983,725,,238,17702
Ayakulik,1983,0,,239,17702
Ayakulik,1983,0,,240,17702
Ayakulik,1983,0,,241,17702
Ayakulik,1983,0,,242,17702
Ayakulik,1983,0,,243,17702
Ayakulik,1983,0,,244,17702
Ayakulik,1983,0,,245,17702
Ayakulik,1983,0,,246,17702
Ayakulik,1983,0,,247,17702
Ayakulik,1983,0,,248,17702
Ayakulik,1983,0,,249,17702
Ayakulik,1983,0,,250,17702
Ayakulik,1983,0,,251,17702
Ayakulik,1983,0,,252,17702
Ayakulik,1983,0,,253,17702
Ayakulik,1983,0,,254,17702
Ayakulik,1983,0,,255,17702
Ayakulik,1983,0,,256,17702
Ayakulik,1983,0,,257,17702
Ayakulik,1983,0,,258,17702
Ayakulik,1983,0,,259,17702
Ayakulik,1983,0,,260,17702
Ayakulik,1983,0,,261,17702
Ayakulik,1983,0,,262,17702
Ayakulik,1983,0,,263,17702
Ayakulik,1983,0,,264,17702
Ayakulik,1983,0,,265,17702
Ayakulik,1983,0,,266,17702
Ayakulik,1983,0,,267,17702
Ayakulik,1983,0,,268,17702
Ayakulik,1983,0,,269,17702
Ayakulik,1983,0,,270,17702
Ayakulik,1983,0,,271,17702
Ayakulik,1983,0,,272,17702
Ayakulik,1983,0,,273,17702
Ayakulik,1982,0,,152,0
Ayakulik,1982,0,,153,0
Ayakulik,1982,0,,154,0
Ayakulik,1982,0,,155,0
Ayakulik,1982,0,,156,0
Ayakulik,1982,0,,157,0
Ayakulik,1982,0,,158,0
Ayakulik,1982,0,,159,0
Ayakulik,1982,0,,160,0
Ayakulik,1982,0,,161,0
Ayakulik,1982,0,,162,0
Ayakulik,1982,0,,163,0
Ayakulik,1982,0,,164,0
Ayakulik,1982,0,,165,0
Ayakulik,1982,0,,166,0
Ayakulik,1982,0,,167,0
Ayakulik,1982,0,,168,0
Ayakulik,1982,0,,169,0
Ayakulik,1982,0,,170,0
Ayakulik,1982,0,,171,0
Ayakulik,1982,0,,172,0
Ayakulik,1982,0,,173,0
Ayakulik,1982,0,,174,0
Ayakulik,1982,0,,175,0
Ayakulik,1982,0,,176,0
Ayakulik,1982,4,,177,4
Ayakulik,1982,25,,178,29
Ayakulik,1982,28,,179,57
Ayakulik,1982,90,,180,147
Ayakulik,1982,36,,181,183
Ayakulik,1982,230,,182,413
Ayakulik,1982,21,,183,434
Ayakulik,1982,371,,184,805
Ayakulik,1982,506,,185,1311
Ayakulik,1982,668,,186,1979
Ayakulik,1982,370,,187,2349
Ayakulik,1982,1136,,188,3485
Ayakulik,1982,5546,,189,9031
Ayakulik,1982,5010,,190,14041
Ayakulik,1982,11408,,191,25449
Ayakulik,1982,15326,,192,40775
Ayakulik,1982,13977,,193,54752
Ayakulik,1982,4607,,194,59359
Ayakulik,1982,4668,,195,64027
Ayakulik,1982,14396,,196,78423
Ayakulik,1982,14215,,197,92638
Ayakulik,1982,42310,,198,134948
Ayakulik,1982,11151,,199,146099
Ayakulik,1982,20632,,200,166731
Ayakulik,1982,70875,,201,237606
Ayakulik,1982,22717,,202,260323
Ayakulik,1982,21030,,203,281353
Ayakulik,1982,25000,,204,306353
Ayakulik,1982,25000,,205,331353
Ayakulik,1982,25000,,206,356353
Ayakulik,1982,25000,,207,381353
Ayakulik,1982,25000,,208,406353
Ayakulik,1982,25000,,209,431353
Ayakulik,1982,25000,,210,456353
Ayakulik,1982,25000,,211,481353
Ayakulik,1982,25000,,212,506353
Ayakulik,1982,25000,,213,531353
Ayakulik,1982,27472,,214,558825
Ayakulik,1982,23033,,215,581858
Ayakulik,1982,19607,,216,601465
Ayakulik,1982,16257,,217,617722
Ayakulik,1982,11576,,218,629298
Ayakulik,1982,13277,,219,642575
Ayakulik,1982,10383,,220,652958
Ayakulik,1982,4239,,221,657197
Ayakulik,1982,5500,,222,662697
Ayakulik,1982,3581,,223,666278
Ayakulik,1982,2160,,224,668438
Ayakulik,1982,4618,,225,673056
Ayakulik,1982,5000,,226,678056
Ayakulik,1982,8300,,227,686356
Ayakulik,1982,10007,,228,696363
Ayakulik,1982,10068,,229,706431
Ayakulik,1982,15031,,230,721462
Ayakulik,1982,0,,231,721462
Ayakulik,1982,0,,232,721462
Ayakulik,1982,0,,233,721462
Ayakulik,1982,0,,234,721462
Ayakulik,1982,0,,235,721462
Ayakulik,1982,0,,236,721462
Ayakulik,1982,0,,237,721462
Ayakulik,1982,0,,238,721462
Ayakulik,1982,0,,239,721462
Ayakulik,1982,0,,240,721462
Ayakulik,1982,0,,241,721462
Ayakulik,1982,0,,242,721462
Ayakulik,1982,0,,243,721462
Ayakulik,1982,0,,244,721462
Ayakulik,1982,0,,245,721462
Ayakulik,1982,0,,246,721462
Ayakulik,1982,0,,247,721462
Ayakulik,1982,0,,248,721462
Ayakulik,1982,0,,249,721462
Ayakulik,1982,0,,250,721462
Ayakulik,1982,0,,251,721462
Ayakulik,1982,0,,252,721462
Ayakulik,1982,0,,253,721462
Ayakulik,1982,0,,254,721462
Ayakulik,1982,0,,255,721462
Ayakulik,1982,0,,256,721462
Ayakulik,1982,0,,257,721462
Ayakulik,1982,0,,258,721462
Ayakulik,1982,0,,259,721462
Ayakulik,1982,0,,260,721462
Ayakulik,1982,0,,261,721462
Ayakulik,1982,0,,262,721462
Ayakulik,1982,0,,263,721462
Ayakulik,1982,0,,264,721462
Ayakulik,1982,0,,265,721462
Ayakulik,1982,0,,266,721462
Ayakulik,1982,0,,267,721462
Ayakulik,1982,0,,268,721462
Ayakulik,1982,0,,269,721462
Ayakulik,1982,0,,270,721462
Ayakulik,1982,0,,271,721462
Ayakulik,1982,0,,272,721462
Ayakulik,1982,0,,273,721462
Ayakulik,1981,0,,152,0
Ayakulik,1981,0,,153,0
Ayakulik,1981,0,,154,0
Ayakulik,1981,0,,155,0
Ayakulik,1981,0,,156,0
Ayakulik,1981,0,,157,0
Ayakulik,1981,0,,158,0
Ayakulik,1981,0,,159,0
Ayakulik,1981,0,,160,0
Ayakulik,1981,0,,161,0
Ayakulik,1981,0,,162,0
Ayakulik,1981,0,,163,0
Ayakulik,1981,0,,164,0
Ayakulik,1981,0,,165,0
Ayakulik,1981,0,,166,0
Ayakulik,1981,0,,167,0
Ayakulik,1981,0,,168,0
Ayakulik,1981,0,,169,0
Ayakulik,1981,0,,170,0
Ayakulik,1981,0,,171,0
Ayakulik,1981,0,,172,0
Ayakulik,1981,1,,173,1
Ayakulik,1981,0,,174,1
Ayakulik,1981,0,,175,1
Ayakulik,1981,0,,176,1
Ayakulik,1981,0,,177,1
Ayakulik,1981,0,,178,1
Ayakulik,1981,0,,179,1
Ayakulik,1981,0,,180,1
Ayakulik,1981,1,,181,2
Ayakulik,1981,0,,182,2
Ayakulik,1981,0,,183,2
Ayakulik,1981,0,,184,2
Ayakulik,1981,0,,185,2
Ayakulik,1981,0,,186,2
Ayakulik,1981,0,,187,2
Ayakulik,1981,7,,188,9
Ayakulik,1981,12,,189,21
Ayakulik,1981,0,,190,21
Ayakulik,1981,0,,191,21
Ayakulik,1981,0,,192,21
Ayakulik,1981,0,,193,21
Ayakulik,1981,0,,194,21
Ayakulik,1981,0,,195,21
Ayakulik,1981,0,,196,21
Ayakulik,1981,56,,197,77
Ayakulik,1981,179,,198,256
Ayakulik,1981,158,,199,414
Ayakulik,1981,126,,200,540
Ayakulik,1981,150,,201,690
Ayakulik,1981,102,,202,792
Ayakulik,1981,181,,203,973
Ayakulik,1981,191,,204,1164
Ayakulik,1981,212,,205,1376
Ayakulik,1981,101,,206,1477
Ayakulik,1981,84,,207,1561
Ayakulik,1981,63,,208,1624
Ayakulik,1981,134,,209,1758
Ayakulik,1981,95,,210,1853
Ayakulik,1981,133,,211,1986
Ayakulik,1981,142,,212,2128
Ayakulik,1981,81,,213,2209
Ayakulik,1981,174,,214,2383
Ayakulik,1981,243,,215,2626
Ayakulik,1981,65,,216,2691
Ayakulik,1981,63,,217,2754
Ayakulik,1981,279,,218,3033
Ayakulik,1981,153,,219,3186
Ayakulik,1981,491,,220,3677
Ayakulik,1981,294,,221,3971
Ayakulik,1981,387,,222,4358
Ayakulik,1981,400,,223,4758
Ayakulik,1981,400,,224,5158
Ayakulik,1981,400,,225,5558
Ayakulik,1981,400,,226,5958
Ayakulik,1981,400,,227,6358
Ayakulik,1981,0,,228,6358
Ayakulik,1981,0,,229,6358
Ayakulik,1981,0,,230,6358
Ayakulik,1981,0,,231,6358
Ayakulik,1981,0,,232,6358
Ayakulik,1981,0,,233,6358
Ayakulik,1981,0,,234,6358
Ayakulik,1981,0,,235,6358
Ayakulik,1981,0,,236,6358
Ayakulik,1981,0,,237,6358
Ayakulik,1981,0,,238,6358
Ayakulik,1981,0,,239,6358
Ayakulik,1981,0,,240,6358
Ayakulik,1981,0,,241,6358
Ayakulik,1981,0,,242,6358
Ayakulik,1981,0,,243,6358
Ayakulik,1981,0,,244,6358
Ayakulik,1981,0,,245,6358
Ayakulik,1981,0,,246,6358
Ayakulik,1981,0,,247,6358
Ayakulik,1981,0,,248,6358
Ayakulik,1981,0,,249,6358
Ayakulik,1981,0,,250,6358
Ayakulik,1981,0,,251,6358
Ayakulik,1981,0,,252,6358
Ayakulik,1981,0,,253,6358
Ayakulik,1981,0,,254,6358
Ayakulik,1981,0,,255,6358
Ayakulik,1981,0,,256,6358
Ayakulik,1981,0,,257,6358
Ayakulik,1981,0,,258,6358
Ayakulik,1981,0,,259,6358
Ayakulik,1981,0,,260,6358
Ayakulik,1981,0,,261,6358
Ayakulik,1981,0,,262,6358
Ayakulik,1981,0,,263,6358
Ayakulik,1981,0,,264,6358
Ayakulik,1981,0,,265,6358
Ayakulik,1981,0,,266,6358
Ayakulik,1981,0,,267,6358
Ayakulik,1981,0,,268,6358
Ayakulik,1981,0,,269,6358
Ayakulik,1981,0,,270,6358
Ayakulik,1981,0,,271,6358
Ayakulik,1981,0,,272,6358
Ayakulik,1981,0,,273,6358
Ayakulik,1980,0,,153,0
Ayakulik,1980,0,,154,0
Ayakulik,1980,0,,155,0
Ayakulik,1980,0,,156,0
Ayakulik,1980,0,,157,0
Ayakulik,1980,0,,158,0
Ayakulik,1980,0,,159,0
Ayakulik,1980,0,,160,0
Ayakulik,1980,0,,161,0
Ayakulik,1980,0,,162,0
Ayakulik,1980,0,,163,0
Ayakulik,1980,0,,164,0
Ayakulik,1980,0,,165,0
Ayakulik,1980,0,,166,0
Ayakulik,1980,0,,167,0
Ayakulik,1980,0,,168,0
Ayakulik,1980,0,,169,0
Ayakulik,1980,0,,170,0
Ayakulik,1980,0,,171,0
Ayakulik,1980,0,,172,0
Ayakulik,1980,0,,173,0
Ayakulik,1980,0,,174,0
Ayakulik,1980,0,,175,0
Ayakulik,1980,0,,176,0
Ayakulik,1980,0,,177,0
Ayakulik,1980,0,,178,0
Ayakulik,1980,0,,179,0
Ayakulik,1980,0,,180,0
Ayakulik,1980,0,,181,0
Ayakulik,1980,0,,182,0
Ayakulik,1980,1,,183,1
Ayakulik,1980,0,,184,1
Ayakulik,1980,18,,185,19
Ayakulik,1980,38,,186,57
Ayakulik,1980,43,,187,100
Ayakulik,1980,57,,188,157
Ayakulik,1980,427,,189,584
Ayakulik,1980,2835,,190,3419
Ayakulik,1980,7234,,191,10653
Ayakulik,1980,10292,,192,20945
Ayakulik,1980,33384,,193,54329
Ayakulik,1980,33384,,194,87713
Ayakulik,1980,33384,,195,121097
Ayakulik,1980,33384,,196,154481
Ayakulik,1980,33384,,197,187865
Ayakulik,1980,33384,,198,221249
Ayakulik,1980,33384,,199,254633
Ayakulik,1980,33384,,200,288017
Ayakulik,1980,33383,,201,321400
Ayakulik,1980,48910,,202,370310
Ayakulik,1980,44837,,203,415147
Ayakulik,1980,38247,,204,453394
Ayakulik,1980,42546,,205,495940
Ayakulik,1980,47533,,206,543473
Ayakulik,1980,17052,,207,560525
Ayakulik,1980,13453,,208,573978
Ayakulik,1980,12164,,209,586142
Ayakulik,1980,15894,,210,602036
Ayakulik,1980,17377,,211,619413
Ayakulik,1980,8705,,212,628118
Ayakulik,1980,16991,,213,645109
Ayakulik,1980,26403,,214,671512
Ayakulik,1980,11655,,215,683167
Ayakulik,1980,29175,,216,712342
Ayakulik,1980,29365,,217,741707
Ayakulik,1980,16762,,218,758469
Ayakulik,1980,18434,,219,776903
Ayakulik,1980,18329,,220,795232
Ayakulik,1980,25000,,221,820232
Ayakulik,1980,10000,,222,830232
Ayakulik,1980,7604,,223,837836
Ayakulik,1980,7656,,224,845492
Ayakulik,1980,7487,,225,852979
Ayakulik,1980,2535,,226,855514
Ayakulik,1980,2113,,227,857627
Ayakulik,1980,0,,228,857627
Ayakulik,1980,0,,229,857627
Ayakulik,1980,0,,230,857627
Ayakulik,1980,0,,231,857627
Ayakulik,1980,0,,232,857627
Ayakulik,1980,0,,233,857627
Ayakulik,1980,0,,234,857627
Ayakulik,1980,0,,235,857627
Ayakulik,1980,0,,236,857627
Ayakulik,1980,0,,237,857627
Ayakulik,1980,0,,238,857627
Ayakulik,1980,0,,239,857627
Ayakulik,1980,0,,240,857627
Ayakulik,1980,0,,241,857627
Ayakulik,1980,0,,242,857627
Ayakulik,1980,0,,243,857627
Ayakulik,1980,0,,244,857627
Ayakulik,1980,0,,245,857627
Ayakulik,1980,0,,246,857627
Ayakulik,1980,0,,247,857627
Ayakulik,1980,0,,248,857627
Ayakulik,1980,0,,249,857627
Ayakulik,1980,0,,250,857627
Ayakulik,1980,0,,251,857627
Ayakulik,1980,0,,252,857627
Ayakulik,1980,0,,253,857627
Ayakulik,1980,0,,254,857627
Ayakulik,1980,0,,255,857627
Ayakulik,1980,0,,256,857627
Ayakulik,1980,0,,257,857627
Ayakulik,1980,0,,258,857627
Ayakulik,1980,0,,259,857627
Ayakulik,1980,0,,260,857627
Ayakulik,1980,0,,261,857627
Ayakulik,1980,0,,262,857627
Ayakulik,1980,0,,263,857627
Ayakulik,1980,0,,264,857627
Ayakulik,1980,0,,265,857627
Ayakulik,1980,0,,266,857627
Ayakulik,1980,0,,267,857627
Ayakulik,1980,0,,268,857627
Ayakulik,1980,0,,269,857627
Ayakulik,1980,0,,270,857627
Ayakulik,1980,0,,271,857627
Ayakulik,1980,0,,272,857627
Ayakulik,1980,0,,273,857627
Ayakulik,1980,0,,274,857627
Ayakulik,1979,0,,152,0
Ayakulik,1979,0,,153,0
Ayakulik,1979,0,,154,0
Ayakulik,1979,0,,155,0
Ayakulik,1979,0,,156,0
Ayakulik,1979,0,,157,0
Ayakulik,1979,0,,158,0
Ayakulik,1979,0,,159,0
Ayakulik,1979,0,,160,0
Ayakulik,1979,0,,161,0
Ayakulik,1979,0,,162,0
Ayakulik,1979,0,,163,0
Ayakulik,1979,0,,164,0
Ayakulik,1979,0,,165,0
Ayakulik,1979,0,,166,0
Ayakulik,1979,0,,167,0
Ayakulik,1979,0,,168,0
Ayakulik,1979,0,,169,0
Ayakulik,1979,0,,170,0
Ayakulik,1979,0,,171,0
Ayakulik,1979,0,,172,0
Ayakulik,1979,4,,173,4
Ayakulik,1979,1,,174,5
Ayakulik,1979,7,,175,12
Ayakulik,1979,1,,176,13
Ayakulik,1979,16,,177,29
Ayakulik,1979,29,,178,58
Ayakulik,1979,0,,179,58
Ayakulik,1979,41,,180,99
Ayakulik,1979,9,,181,108
Ayakulik,1979,112,,182,220
Ayakulik,1979,89,,183,309
Ayakulik,1979,170,,184,479
Ayakulik,1979,105,,185,584
Ayakulik,1979,113,,186,697
Ayakulik,1979,74,,187,771
Ayakulik,1979,51,,188,822
Ayakulik,1979,398,,189,1220
Ayakulik,1979,225,,190,1445
Ayakulik,1979,60,,191,1505
Ayakulik,1979,188,,192,1693
Ayakulik,1979,206,,193,1899
Ayakulik,1979,41,,194,1940
Ayakulik,1979,110,,195,2050
Ayakulik,1979,30,,196,2080
Ayakulik,1979,106,,197,2186
Ayakulik,1979,130,,198,2316
Ayakulik,1979,112,,199,2428
Ayakulik,1979,23,,200,2451
Ayakulik,1979,137,,201,2588
Ayakulik,1979,39,,202,2627
Ayakulik,1979,73,,203,2700
Ayakulik,1979,339,,204,3039
Ayakulik,1979,25,,205,3064
Ayakulik,1979,46,,206,3110
Ayakulik,1979,164,,207,3274
Ayakulik,1979,97,,208,3371
Ayakulik,1979,47,,209,3418
Ayakulik,1979,351,,210,3769
Ayakulik,1979,165,,211,3934
Ayakulik,1979,42,,212,3976
Ayakulik,1979,62,,213,4038
Ayakulik,1979,59,,214,4097
Ayakulik,1979,159,,215,4256
Ayakulik,1979,138,,216,4394
Ayakulik,1979,890,,217,5284
Ayakulik,1979,390,,218,5674
Ayakulik,1979,1027,,219,6701
Ayakulik,1979,1327,,220,8028
Ayakulik,1979,381,,221,8409
Ayakulik,1979,375,,222,8784
Ayakulik,1979,283,,223,9067
Ayakulik,1979,184,,224,9251
Ayakulik,1979,171,,225,9422
Ayakulik,1979,363,,226,9785
Ayakulik,1979,493,,227,10278
Ayakulik,1979,0,,228,10278
Ayakulik,1979,0,,229,10278
Ayakulik,1979,0,,230,10278
Ayakulik,1979,0,,231,10278
Ayakulik,1979,0,,232,10278
Ayakulik,1979,0,,233,10278
Ayakulik,1979,0,,234,10278
Ayakulik,1979,0,,235,10278
Ayakulik,1979,0,,236,10278
Ayakulik,1979,0,,237,10278
Ayakulik,1979,0,,238,10278
Ayakulik,1979,0,,239,10278
Ayakulik,1979,0,,240,10278
Ayakulik,1979,0,,241,10278
Ayakulik,1979,0,,242,10278
Ayakulik,1979,0,,243,10278
Ayakulik,1979,0,,244,10278
Ayakulik,1979,0,,245,10278
Ayakulik,1979,0,,246,10278
Ayakulik,1979,0,,247,10278
Ayakulik,1979,0,,248,10278
Ayakulik,1979,0,,249,10278
Ayakulik,1979,0,,250,10278
Ayakulik,1979,0,,251,10278
Ayakulik,1979,0,,252,10278
Ayakulik,1979,0,,253,10278
Ayakulik,1979,0,,254,10278
Ayakulik,1979,0,,255,10278
Ayakulik,1979,0,,256,10278
Ayakulik,1979,0,,257,10278
Ayakulik,1979,0,,258,10278
Ayakulik,1979,0,,259,10278
Ayakulik,1979,0,,260,10278
Ayakulik,1979,0,,261,10278
Ayakulik,1979,0,,262,10278
Ayakulik,1979,0,,263,10278
Ayakulik,1979,0,,264,10278
Ayakulik,1979,0,,265,10278
Ayakulik,1979,0,,266,10278
Ayakulik,1979,0,,267,10278
Ayakulik,1979,0,,268,10278
Ayakulik,1979,0,,269,10278
Ayakulik,1979,0,,270,10278
Ayakulik,1979,0,,271,10278
Ayakulik,1979,0,,272,10278
Ayakulik,1979,0,,273,10278
Ayakulik,1978,0,,152,0
Ayakulik,1978,0,,153,0
Ayakulik,1978,0,,154,0
Ayakulik,1978,0,,155,0
Ayakulik,1978,0,,156,0
Ayakulik,1978,0,,157,0
Ayakulik,1978,0,,158,0
Ayakulik,1978,0,,159,0
Ayakulik,1978,0,,160,0
Ayakulik,1978,0,,161,0
Ayakulik,1978,0,,162,0
Ayakulik,1978,0,,163,0
Ayakulik,1978,0,,164,0
Ayakulik,1978,0,,165,0
Ayakulik,1978,0,,166,0
Ayakulik,1978,0,,167,0
Ayakulik,1978,0,,168,0
Ayakulik,1978,0,,169,0
Ayakulik,1978,0,,170,0
Ayakulik,1978,0,,171,0
Ayakulik,1978,0,,172,0
Ayakulik,1978,0,,173,0
Ayakulik,1978,0,,174,0
Ayakulik,1978,0,,175,0
Ayakulik,1978,0,,176,0
Ayakulik,1978,0,,177,0
Ayakulik,1978,0,,178,0
Ayakulik,1978,0,,179,0
Ayakulik,1978,0,,180,0
Ayakulik,1978,0,,181,0
Ayakulik,1978,75,,182,75
Ayakulik,1978,75,,183,150
Ayakulik,1978,75,,184,225
Ayakulik,1978,75,,185,300
Ayakulik,1978,43,,186,343
Ayakulik,1978,153,,187,496
Ayakulik,1978,25,,188,521
Ayakulik,1978,4,,189,525
Ayakulik,1978,12,,190,537
Ayakulik,1978,107,,191,644
Ayakulik,1978,495,,192,1139
Ayakulik,1978,37,,193,1176
Ayakulik,1978,982,,194,2158
Ayakulik,1978,1701,,195,3859
Ayakulik,1978,1015,,196,4874
Ayakulik,1978,9079,,197,13953
Ayakulik,1978,4505,,198,18458
Ayakulik,1978,5452,,199,23910
Ayakulik,1978,3305,,200,27215
Ayakulik,1978,2509,,201,29724
Ayakulik,1978,3143,,202,32867
Ayakulik,1978,29284,,203,62151
Ayakulik,1978,14330,,204,76481
Ayakulik,1978,23835,,205,100316
Ayakulik,1978,33011,,206,133327
Ayakulik,1978,18778,,207,152105
Ayakulik,1978,26071,,208,178176
Ayakulik,1978,42436,,209,220612
Ayakulik,1978,21435,,210,242047
Ayakulik,1978,75880,,211,317927
Ayakulik,1978,24164,,212,342091
Ayakulik,1978,31884,,213,373975
Ayakulik,1978,31685,,214,405660
Ayakulik,1978,45723,,215,451383
Ayakulik,1978,16166,,216,467549
Ayakulik,1978,15020,,217,482569
Ayakulik,1978,20552,,218,503121
Ayakulik,1978,30060,,219,533181
Ayakulik,1978,19248,,220,552429
Ayakulik,1978,23000,,221,575429
Ayakulik,1978,14542,,222,589971
Ayakulik,1978,26011,,223,615982
Ayakulik,1978,10000,,224,625982
Ayakulik,1978,10657,,225,636639
Ayakulik,1978,13037,,226,649676
Ayakulik,1978,25260,,227,674936
Ayakulik,1978,35417,,228,710353
Ayakulik,1978,49139,,229,759492
Ayakulik,1978,43322,,230,802814
Ayakulik,1978,78720,,231,881534
Ayakulik,1978,30477,,232,912011
Ayakulik,1978,27340,,233,939351
Ayakulik,1978,15000,,234,954351
Ayakulik,1978,15000,,235,969351
Ayakulik,1978,12000,,236,981351
Ayakulik,1978,0,,237,981351
Ayakulik,1978,0,,238,981351
Ayakulik,1978,0,,239,981351
Ayakulik,1978,0,,240,981351
Ayakulik,1978,0,,241,981351
Ayakulik,1978,0,,242,981351
Ayakulik,1978,0,,243,981351
Ayakulik,1978,0,,244,981351
Ayakulik,1978,0,,245,981351
Ayakulik,1978,0,,246,981351
Ayakulik,1978,0,,247,981351
Ayakulik,1978,0,,248,981351
Ayakulik,1978,0,,249,981351
Ayakulik,1978,0,,250,981351
Ayakulik,1978,0,,251,981351
Ayakulik,1978,0,,252,981351
Ayakulik,1978,0,,253,981351
Ayakulik,1978,0,,254,981351
Ayakulik,1978,0,,255,981351
Ayakulik,1978,0,,256,981351
Ayakulik,1978,0,,257,981351
Ayakulik,1978,0,,258,981351
Ayakulik,1978,0,,259,981351
Ayakulik,1978,0,,260,981351
Ayakulik,1978,0,,261,981351
Ayakulik,1978,0,,262,981351
Ayakulik,1978,0,,263,981351
Ayakulik,1978,0,,264,981351
Ayakulik,1978,0,,265,981351
Ayakulik,1978,0,,266,981351
Ayakulik,1978,0,,267,981351
Ayakulik,1978,0,,268,981351
Ayakulik,1978,0,,269,981351
Ayakulik,1978,0,,270,981351
Ayakulik,1978,0,,271,981351
Ayakulik,1978,0,,272,981351
Ayakulik,1978,0,,273,981351
Ayakulik,1977,0,,152,0
Ayakulik,1977,0,,153,0
Ayakulik,1977,0,,154,0
Ayakulik,1977,0,,155,0
Ayakulik,1977,0,,156,0
Ayakulik,1977,0,,157,0
Ayakulik,1977,0,,158,0
Ayakulik,1977,0,,159,0
Ayakulik,1977,0,,160,0
Ayakulik,1977,0,,161,0
Ayakulik,1977,0,,162,0
Ayakulik,1977,0,,163,0
Ayakulik,1977,0,,164,0
Ayakulik,1977,0,,165,0
Ayakulik,1977,0,,166,0
Ayakulik,1977,0,,167,0
Ayakulik,1977,0,,168,0
Ayakulik,1977,0,,169,0
Ayakulik,1977,0,,170,0
Ayakulik,1977,0,,171,0
Ayakulik,1977,0,,172,0
Ayakulik,1977,0,,173,0
Ayakulik,1977,0,,174,0
Ayakulik,1977,0,,175,0
Ayakulik,1977,0,,176,0
Ayakulik,1977,0,,177,0
Ayakulik,1977,0,,178,0
Ayakulik,1977,0,,179,0
Ayakulik,1977,0,,180,0
Ayakulik,1977,0,,181,0
Ayakulik,1977,0,,182,0
Ayakulik,1977,0,,183,0
Ayakulik,1977,0,,184,0
Ayakulik,1977,0,,185,0
Ayakulik,1977,1,,186,1
Ayakulik,1977,0,,187,1
Ayakulik,1977,25,,188,26
Ayakulik,1977,70,,189,96
Ayakulik,1977,392,,190,488
Ayakulik,1977,87,,191,575
Ayakulik,1977,371,,192,946
Ayakulik,1977,295,,193,1241
Ayakulik,1977,234,,194,1475
Ayakulik,1977,351,,195,1826
Ayakulik,1977,249,,196,2075
Ayakulik,1977,103,,197,2178
Ayakulik,1977,164,,198,2342
Ayakulik,1977,148,,199,2490
Ayakulik,1977,157,,200,2647
Ayakulik,1977,140,,201,2787
Ayakulik,1977,312,,202,3099
Ayakulik,1977,182,,203,3281
Ayakulik,1977,196,,204,3477
Ayakulik,1977,40,,205,3517
Ayakulik,1977,13,,206,3530
Ayakulik,1977,186,,207,3716
Ayakulik,1977,0,,208,3716
Ayakulik,1977,0,,209,3716
Ayakulik,1977,0,,210,3716
Ayakulik,1977,0,,211,3716
Ayakulik,1977,0,,212,3716
Ayakulik,1977,0,,213,3716
Ayakulik,1977,0,,214,3716
Ayakulik,1977,0,,215,3716
Ayakulik,1977,0,,216,3716
Ayakulik,1977,0,,217,3716
Ayakulik,1977,0,,218,3716
Ayakulik,1977,0,,219,3716
Ayakulik,1977,0,,220,3716
Ayakulik,1977,0,,221,3716
Ayakulik,1977,0,,222,3716
Ayakulik,1977,0,,223,3716
Ayakulik,1977,0,,224,3716
Ayakulik,1977,0,,225,3716
Ayakulik,1977,0,,226,3716
Ayakulik,1977,0,,227,3716
Ayakulik,1977,0,,228,3716
Ayakulik,1977,0,,229,3716
Ayakulik,1977,0,,230,3716
Ayakulik,1977,0,,231,3716
Ayakulik,1977,0,,232,3716
Ayakulik,1977,0,,233,3716
Ayakulik,1977,0,,234,3716
Ayakulik,1977,0,,235,3716
Ayakulik,1977,0,,236,3716
Ayakulik,1977,0,,237,3716
Ayakulik,1977,0,,238,3716
Ayakulik,1977,0,,239,3716
Ayakulik,1977,0,,240,3716
Ayakulik,1977,0,,241,3716
Ayakulik,1977,0,,242,3716
Ayakulik,1977,0,,243,3716
Ayakulik,1977,0,,244,3716
Ayakulik,1977,0,,245,3716
Ayakulik,1977,0,,246,3716
Ayakulik,1977,0,,247,3716
Ayakulik,1977,0,,248,3716
Ayakulik,1977,0,,249,3716
Ayakulik,1977,0,,250,3716
Ayakulik,1977,0,,251,3716
Ayakulik,1977,0,,252,3716
Ayakulik,1977,0,,253,3716
Ayakulik,1977,0,,254,3716
Ayakulik,1977,0,,255,3716
Ayakulik,1977,0,,256,3716
Ayakulik,1977,0,,257,3716
Ayakulik,1977,0,,258,3716
Ayakulik,1977,0,,259,3716
Ayakulik,1977,0,,260,3716
Ayakulik,1977,0,,261,3716
Ayakulik,1977,0,,262,3716
Ayakulik,1977,0,,263,3716
Ayakulik,1977,0,,264,3716
Ayakulik,1977,0,,265,3716
Ayakulik,1977,0,,266,3716
Ayakulik,1977,0,,267,3716
Ayakulik,1977,0,,268,3716
Ayakulik,1977,0,,269,3716
Ayakulik,1977,0,,270,3716
Ayakulik,1977,0,,271,3716
Ayakulik,1977,0,,272,3716
Ayakulik,1977,0,,273,3716
Ayakulik,1976,0,,153,0
Ayakulik,1976,0,,154,0
Ayakulik,1976,0,,155,0
Ayakulik,1976,0,,156,0
Ayakulik,1976,0,,157,0
Ayakulik,1976,0,,158,0
Ayakulik,1976,0,,159,0
Ayakulik,1976,0,,160,0
Ayakulik,1976,0,,161,0
Ayakulik,1976,0,,162,0
Ayakulik,1976,0,,163,0
Ayakulik,1976,0,,164,0
Ayakulik,1976,0,,165,0
Ayakulik,1976,0,,166,0
Ayakulik,1976,0,,167,0
Ayakulik,1976,0,,168,0
Ayakulik,1976,0,,169,0
Ayakulik,1976,0,,170,0
Ayakulik,1976,0,,171,0
Ayakulik,1976,0,,172,0
Ayakulik,1976,0,,173,0
Ayakulik,1976,0,,174,0
Ayakulik,1976,0,,175,0
Ayakulik,1976,0,,176,0
Ayakulik,1976,0,,177,0
Ayakulik,1976,0,,178,0
Ayakulik,1976,0,,179,0
Ayakulik,1976,0,,180,0
Ayakulik,1976,7,,181,7
Ayakulik,1976,7,,182,14
Ayakulik,1976,2,,183,16
Ayakulik,1976,10,,184,26
Ayakulik,1976,12,,185,38
Ayakulik,1976,11,,186,49
Ayakulik,1976,5,,187,54
Ayakulik,1976,355,,188,409
Ayakulik,1976,1793,,189,2202
Ayakulik,1976,243,,190,2445
Ayakulik,1976,1702,,191,4147
Ayakulik,1976,3297,,192,7444
Ayakulik,1976,4757,,193,12201
Ayakulik,1976,5370,,194,17571
Ayakulik,1976,3539,,195,21110
Ayakulik,1976,1503,,196,22613
Ayakulik,1976,2468,,197,25081
Ayakulik,1976,2444,,198,27525
Ayakulik,1976,2648,,199,30173
Ayakulik,1976,14835,,200,45008
Ayakulik,1976,24504,,201,69512
Ayakulik,1976,21786,,202,91298
Ayakulik,1976,6083,,203,97381
Ayakulik,1976,11620,,204,109001
Ayakulik,1976,13025,,205,122026
Ayakulik,1976,12230,,206,134256
Ayakulik,1976,50000,,207,184256
Ayakulik,1976,40605,,208,224861
Ayakulik,1976,23500,,209,248361
Ayakulik,1976,20000,,210,268361
Ayakulik,1976,22427,,211,290788
Ayakulik,1976,23503,,212,314291
Ayakulik,1976,22567,,213,336858
Ayakulik,1976,25000,,214,361858
Ayakulik,1976,83000,,215,444858
Ayakulik,1976,27011,,216,471869
Ayakulik,1976,46000,,217,517869
Ayakulik,1976,63462,,218,581331
Ayakulik,1976,25600,,219,606931
Ayakulik,1976,29000,,220,635931
Ayakulik,1976,20016,,221,655947
Ayakulik,1976,13000,,222,668947
Ayakulik,1976,5000,,223,673947
Ayakulik,1976,5900,,224,679847
Ayakulik,1976,2003,,225,681850
Ayakulik,1976,3000,,226,684850
Ayakulik,1976,1500,,227,686350
Ayakulik,1976,1200,,228,687550
Ayakulik,1976,1025,,229,688575
Ayakulik,1976,20000,,230,708575
Ayakulik,1976,0,,231,708575
Ayakulik,1976,0,,232,708575
Ayakulik,1976,0,,233,708575
Ayakulik,1976,0,,234,708575
Ayakulik,1976,0,,235,708575
Ayakulik,1976,0,,236,708575
Ayakulik,1976,0,,237,708575
Ayakulik,1976,0,,238,708575
Ayakulik,1976,0,,239,708575
Ayakulik,1976,0,,240,708575
Ayakulik,1976,0,,241,708575
Ayakulik,1976,0,,242,708575
Ayakulik,1976,0,,243,708575
Ayakulik,1976,0,,244,708575
Ayakulik,1976,0,,245,708575
Ayakulik,1976,0,,246,708575
Ayakulik,1976,0,,247,708575
Ayakulik,1976,0,,248,708575
Ayakulik,1976,0,,249,708575
Ayakulik,1976,0,,250,708575
Ayakulik,1976,0,,251,708575
Ayakulik,1976,0,,252,708575
Ayakulik,1976,0,,253,708575
Ayakulik,1976,0,,254,708575
Ayakulik,1976,0,,255,708575
Ayakulik,1976,0,,256,708575
Ayakulik,1976,0,,257,708575
Ayakulik,1976,0,,258,708575
Ayakulik,1976,0,,259,708575
Ayakulik,1976,0,,260,708575
Ayakulik,1976,0,,261,708575
Ayakulik,1976,0,,262,708575
Ayakulik,1976,0,,263,708575
Ayakulik,1976,0,,264,708575
Ayakulik,1976,0,,265,708575
Ayakulik,1976,0,,266,708575
Ayakulik,1976,0,,267,708575
Ayakulik,1976,0,,268,708575
Ayakulik,1976,0,,269,708575
Ayakulik,1976,0,,270,708575
Ayakulik,1976,0,,271,708575
Ayakulik,1976,0,,272,708575
Ayakulik,1976,0,,273,708575
Ayakulik,1976,0,,274,708575
Ayakulik,1975,0,,152,0
Ayakulik,1975,0,,153,0
Ayakulik,1975,0,,154,0
Ayakulik,1975,0,,155,0
Ayakulik,1975,0,,156,0
Ayakulik,1975,0,,157,0
Ayakulik,1975,0,,158,0
Ayakulik,1975,0,,159,0
Ayakulik,1975,0,,160,0
Ayakulik,1975,0,,161,0
Ayakulik,1975,0,,162,0
Ayakulik,1975,0,,163,0
Ayakulik,1975,0,,164,0
Ayakulik,1975,0,,165,0
Ayakulik,1975,0,,166,0
Ayakulik,1975,0,,167,0
Ayakulik,1975,0,,168,0
Ayakulik,1975,0,,169,0
Ayakulik,1975,0,,170,0
Ayakulik,1975,0,,171,0
Ayakulik,1975,0,,172,0
Ayakulik,1975,0,,173,0
Ayakulik,1975,0,,174,0
Ayakulik,1975,0,,175,0
Ayakulik,1975,0,,176,0
Ayakulik,1975,0,,177,0
Ayakulik,1975,0,,178,0
Ayakulik,1975,0,,179,0
Ayakulik,1975,0,,180,0
Ayakulik,1975,0,,181,0
Ayakulik,1975,0,,182,0
Ayakulik,1975,0,,183,0
Ayakulik,1975,0,,184,0
Ayakulik,1975,0,,185,0
Ayakulik,1975,0,,186,0
Ayakulik,1975,0,,187,0
Ayakulik,1975,4,,188,4
Ayakulik,1975,7,,189,11
Ayakulik,1975,5,,190,16
Ayakulik,1975,22,,191,38
Ayakulik,1975,78,,192,116
Ayakulik,1975,31,,193,147
Ayakulik,1975,9,,194,156
Ayakulik,1975,24,,195,180
Ayakulik,1975,21,,196,201
Ayakulik,1975,31,,197,232
Ayakulik,1975,20,,198,252
Ayakulik,1975,18,,199,270
Ayakulik,1975,28,,200,298
Ayakulik,1975,40,,201,338
Ayakulik,1975,33,,202,371
Ayakulik,1975,14,,203,385
Ayakulik,1975,72,,204,457
Ayakulik,1975,80,,205,537
Ayakulik,1975,12,,206,549
Ayakulik,1975,19,,207,568
Ayakulik,1975,83,,208,651
Ayakulik,1975,15,,209,666
Ayakulik,1975,1,,210,667
Ayakulik,1975,138,,211,805
Ayakulik,1975,76,,212,881
Ayakulik,1975,54,,213,935
Ayakulik,1975,60,,214,995
Ayakulik,1975,42,,215,1037
Ayakulik,1975,52,,216,1089
Ayakulik,1975,58,,217,1147
Ayakulik,1975,47,,218,1194
Ayakulik,1975,89,,219,1283
Ayakulik,1975,109,,220,1392
Ayakulik,1975,40,,221,1432
Ayakulik,1975,58,,222,1490
Ayakulik,1975,23,,223,1513
Ayakulik,1975,39,,224,1552
Ayakulik,1975,65,,225,1617
Ayakulik,1975,50,,226,1667
Ayakulik,1975,347,,227,2014
Ayakulik,1975,77,,228,2091
Ayakulik,1975,39,,229,2130
Ayakulik,1975,33,,230,2163
Ayakulik,1975,94,,231,2257
Ayakulik,1975,117,,232,2374
Ayakulik,1975,44,,233,2418
Ayakulik,1975,50,,234,2468
Ayakulik,1975,100,,235,2568
Ayakulik,1975,0,,236,2568
Ayakulik,1975,0,,237,2568
Ayakulik,1975,0,,238,2568
Ayakulik,1975,0,,239,2568
Ayakulik,1975,0,,240,2568
Ayakulik,1975,0,,241,2568
Ayakulik,1975,0,,242,2568
Ayakulik,1975,0,,243,2568
Ayakulik,1975,0,,244,2568
Ayakulik,1975,0,,245,2568
Ayakulik,1975,0,,246,2568
Ayakulik,1975,0,,247,2568
Ayakulik,1975,0,,248,2568
Ayakulik,1975,0,,249,2568
Ayakulik,1975,0,,250,2568
Ayakulik,1975,0,,251,2568
Ayakulik,1975,0,,252,2568
Ayakulik,1975,0,,253,2568
Ayakulik,1975,0,,254,2568
Ayakulik,1975,0,,255,2568
Ayakulik,1975,0,,256,2568
Ayakulik,1975,0,,257,2568
Ayakulik,1975,0,,258,2568
Ayakulik,1975,0,,259,2568
Ayakulik,1975,0,,260,2568
Ayakulik,1975,0,,261,2568
Ayakulik,1975,0,,262,2568
Ayakulik,1975,0,,263,2568
Ayakulik,1975,0,,264,2568
Ayakulik,1975,0,,265,2568
Ayakulik,1975,0,,266,2568
Ayakulik,1975,0,,267,2568
Ayakulik,1975,0,,268,2568
Ayakulik,1975,0,,269,2568
Ayakulik,1975,0,,270,2568
Ayakulik,1975,0,,271,2568
Ayakulik,1975,0,,272,2568
Ayakulik,1975,0,,273,2568
Ayakulik,1972,0,,153,0
Ayakulik,1972,0,,154,0
Ayakulik,1972,0,,155,0
Ayakulik,1972,0,,156,0
Ayakulik,1972,0,,157,0
Ayakulik,1972,0,,158,0
Ayakulik,1972,0,,159,0
Ayakulik,1972,0,,160,0
Ayakulik,1972,0,,161,0
Ayakulik,1972,0,,162,0
Ayakulik,1972,0,,163,0
Ayakulik,1972,0,,164,0
Ayakulik,1972,0,,165,0
Ayakulik,1972,0,,166,0
Ayakulik,1972,0,,167,0
Ayakulik,1972,0,,168,0
Ayakulik,1972,0,,169,0
Ayakulik,1972,0,,170,0
Ayakulik,1972,0,,171,0
Ayakulik,1972,0,,172,0
Ayakulik,1972,0,,173,0
Ayakulik,1972,0,,174,0
Ayakulik,1972,0,,175,0
Ayakulik,1972,0,,176,0
Ayakulik,1972,0,,177,0
Ayakulik,1972,0,,178,0
Ayakulik,1972,0,,179,0
Ayakulik,1972,0,,180,0
Ayakulik,1972,0,,181,0
Ayakulik,1972,0,,182,0
Ayakulik,1972,206,,183,206
Ayakulik,1972,112,,184,318
Ayakulik,1972,108,,185,426
Ayakulik,1972,154,,186,580
Ayakulik,1972,12,,187,592
Ayakulik,1972,0,,188,592
Ayakulik,1972,0,,189,592
Ayakulik,1972,0,,190,592
Ayakulik,1972,618,,191,1210
Ayakulik,1972,840,,192,2050
Ayakulik,1972,508,,193,2558
Ayakulik,1972,1803,,194,4361
Ayakulik,1972,105,,195,4466
Ayakulik,1972,439,,196,4905
Ayakulik,1972,1038,,197,5943
Ayakulik,1972,6480,,198,12423
Ayakulik,1972,1996,,199,14419
Ayakulik,1972,2808,,200,17227
Ayakulik,1972,468,,201,17695
Ayakulik,1972,1176,,202,18871
Ayakulik,1972,976,,203,19847
Ayakulik,1972,6786,,204,26633
Ayakulik,1972,8024,,205,34657
Ayakulik,1972,7830,,206,42487
Ayakulik,1972,4595,,207,47082
Ayakulik,1972,4765,,208,51847
Ayakulik,1972,9674,,209,61521
Ayakulik,1972,9229,,210,70750
Ayakulik,1972,6628,,211,77378
Ayakulik,1972,2281,,212,79659
Ayakulik,1972,6656,,213,86315
Ayakulik,1972,3766,,214,90081
Ayakulik,1972,934,,215,91015
Ayakulik,1972,2496,,216,93511
Ayakulik,1972,3360,,217,96871
Ayakulik,1972,429,,218,97300
Ayakulik,1972,33,,219,97333
Ayakulik,1972,87,,220,97420
Ayakulik,1972,191,,221,97611
Ayakulik,1972,54,,222,97665
Ayakulik,1972,493,,223,98158
Ayakulik,1972,1332,,224,99490
Ayakulik,1972,250,,225,99740
Ayakulik,1972,604,,226,100344
Ayakulik,1972,0,,227,100344
Ayakulik,1972,0,,228,100344
Ayakulik,1972,0,,229,100344
Ayakulik,1972,0,,230,100344
Ayakulik,1972,0,,231,100344
Ayakulik,1972,0,,232,100344
Ayakulik,1972,0,,233,100344
Ayakulik,1972,0,,234,100344
Ayakulik,1972,0,,235,100344
Ayakulik,1972,0,,236,100344
Ayakulik,1972,0,,237,100344
Ayakulik,1972,0,,238,100344
Ayakulik,1972,0,,239,100344
Ayakulik,1972,0,,240,100344
Ayakulik,1972,0,,241,100344
Ayakulik,1972,0,,242,100344
Ayakulik,1972,0,,243,100344
Ayakulik,1972,0,,244,100344
Ayakulik,1972,0,,245,100344
Ayakulik,1972,0,,246,100344
Ayakulik,1972,0,,247,100344
Ayakulik,1972,0,,248,100344
Ayakulik,1972,0,,249,100344
Ayakulik,1972,0,,250,100344
Ayakulik,1972,0,,251,100344
Ayakulik,1972,0,,252,100344
Ayakulik,1972,0,,253,100344
Ayakulik,1972,0,,254,100344
Ayakulik,1972,0,,255,100344
Ayakulik,1972,0,,256,100344
Ayakulik,1972,0,,257,100344
Ayakulik,1972,0,,258,100344
Ayakulik,1972,0,,259,100344
Ayakulik,1972,0,,260,100344
Ayakulik,1972,0,,261,100344
Ayakulik,1972,0,,262,100344
Ayakulik,1972,0,,263,100344
Ayakulik,1972,0,,264,100344
Ayakulik,1972,0,,265,100344
Ayakulik,1972,0,,266,100344
Ayakulik,1972,0,,267,100344
Ayakulik,1972,0,,268,100344
Ayakulik,1972,0,,269,100344
Ayakulik,1972,0,,270,100344
Ayakulik,1972,0,,271,100344
Ayakulik,1972,0,,272,100344
Ayakulik,1972,0,,273,100344
Ayakulik,1972,0,,274,100344
Ayakulik,1970,0,,152,0
Ayakulik,1970,0,,153,0
Ayakulik,1970,0,,154,0
Ayakulik,1970,0,,155,0
Ayakulik,1970,0,,156,0
Ayakulik,1970,0,,157,0
Ayakulik,1970,0,,158,0
Ayakulik,1970,0,,159,0
Ayakulik,1970,0,,160,0
Ayakulik,1970,0,,161,0
Ayakulik,1970,0,,162,0
Ayakulik,1970,0,,163,0
Ayakulik,1970,0,,164,0
Ayakulik,1970,0,,165,0
Ayakulik,1970,0,,166,0
Ayakulik,1970,0,,167,0
Ayakulik,1970,0,,168,0
Ayakulik,1970,0,,169,0
Ayakulik,1970,0,,170,0
Ayakulik,1970,0,,171,0
Ayakulik,1970,0,,172,0
Ayakulik,1970,0,,173,0
Ayakulik,1970,0,,174,0
Ayakulik,1970,0,,175,0
Ayakulik,1970,0,,176,0
Ayakulik,1970,0,,177,0
Ayakulik,1970,0,,178,0
Ayakulik,1970,0,,179,0
Ayakulik,1970,0,,180,0
Ayakulik,1970,0,,181,0
Ayakulik,1970,0,,182,0
Ayakulik,1970,14,,183,14
Ayakulik,1970,115,,184,129
Ayakulik,1970,170,,185,299
Ayakulik,1970,339,,186,638
Ayakulik,1970,126,,187,764
Ayakulik,1970,118,,188,882
Ayakulik,1970,728,,189,1610
Ayakulik,1970,574,,190,2184
Ayakulik,1970,402,,191,2586
Ayakulik,1970,1646,,192,4232
Ayakulik,1970,938,,193,5170
Ayakulik,1970,202,,194,5372
Ayakulik,1970,1563,,195,6935
Ayakulik,1970,100,,196,7035
Ayakulik,1970,19000,,197,26035
Ayakulik,1970,10800,,198,36835
Ayakulik,1970,20039,,199,56874
Ayakulik,1970,20980,,200,77854
Ayakulik,1970,23674,,201,101528
Ayakulik,1970,30250,,202,131778
Ayakulik,1970,14403,,203,146181
Ayakulik,1970,34400,,204,180581
Ayakulik,1970,51986,,205,232567
Ayakulik,1970,24228,,206,256795
Ayakulik,1970,89694,,207,346489
Ayakulik,1970,13850,,208,360339
Ayakulik,1970,64118,,209,424457
Ayakulik,1970,10870,,210,435327
Ayakulik,1970,31774,,211,467101
Ayakulik,1970,57462,,212,524563
Ayakulik,1970,55000,,213,579563
Ayakulik,1970,25000,,214,604563
Ayakulik,1970,25000,,215,629563
Ayakulik,1970,20000,,216,649563
Ayakulik,1970,10684,,217,660247
Ayakulik,1970,24049,,218,684296
Ayakulik,1970,22782,,219,707078
Ayakulik,1970,20126,,220,727204
Ayakulik,1970,10440,,221,737644
Ayakulik,1970,10828,,222,748472
Ayakulik,1970,5616,,223,754088
Ayakulik,1970,5000,,224,759088
Ayakulik,1970,5844,,225,764932
Ayakulik,1970,7008,,226,771940
Ayakulik,1970,0,,227,771940
Ayakulik,1970,0,,228,771940
Ayakulik,1970,0,,229,771940
Ayakulik,1970,0,,230,771940
Ayakulik,1970,0,,231,771940
Ayakulik,1970,0,,232,771940
Ayakulik,1970,0,,233,771940
Ayakulik,1970,0,,234,771940
Ayakulik,1970,0,,235,771940
Ayakulik,1970,0,,236,771940
Ayakulik,1970,0,,237,771940
Ayakulik,1970,0,,238,771940
Ayakulik,1970,0,,239,771940
Ayakulik,1970,0,,240,771940
Ayakulik,1970,0,,241,771940
Ayakulik,1970,0,,242,771940
Ayakulik,1970,0,,243,771940
Ayakulik,1970,0,,244,771940
Ayakulik,1970,0,,245,771940
Ayakulik,1970,0,,246,771940
Ayakulik,1970,0,,247,771940
Ayakulik,1970,0,,248,771940
Ayakulik,1970,0,,249,771940
Ayakulik,1970,0,,250,771940
Ayakulik,1970,0,,251,771940
Ayakulik,1970,0,,252,771940
Ayakulik,1970,0,,253,771940
Ayakulik,1970,0,,254,771940
Ayakulik,1970,0,,255,771940
Ayakulik,1970,0,,256,771940
Ayakulik,1970,0,,257,771940
Ayakulik,1970,0,,258,771940
Ayakulik,1970,0,,259,771940
Ayakulik,1970,0,,260,771940
Ayakulik,1970,0,,261,771940
Ayakulik,1970,0,,262,771940
Ayakulik,1970,0,,263,771940
Ayakulik,1970,0,,264,771940
Ayakulik,1970,0,,265,771940
Ayakulik,1970,0,,266,771940
Ayakulik,1970,0,,267,771940
Ayakulik,1970,0,,268,771940
Ayakulik,1970,0,,269,771940
Ayakulik,1970,0,,270,771940
Ayakulik,1970,0,,271,771940
Ayakulik,1970,0,,272,771940
Ayakulik,1970,0,,273,771940
Ayakulik,1968,0,,153,0
Ayakulik,1968,0,,154,0
Ayakulik,1968,0,,155,0
Ayakulik,1968,0,,156,0
Ayakulik,1968,0,,157,0
Ayakulik,1968,0,,158,0
Ayakulik,1968,0,,159,0
Ayakulik,1968,0,,160,0
Ayakulik,1968,0,,161,0
Ayakulik,1968,0,,162,0
Ayakulik,1968,0,,163,0
Ayakulik,1968,0,,164,0
Ayakulik,1968,0,,165,0
Ayakulik,1968,0,,166,0
Ayakulik,1968,0,,167,0
Ayakulik,1968,0,,168,0
Ayakulik,1968,0,,169,0
Ayakulik,1968,0,,170,0
Ayakulik,1968,0,,171,0
Ayakulik,1968,0,,172,0
Ayakulik,1968,0,,173,0
Ayakulik,1968,0,,174,0
Ayakulik,1968,0,,175,0
Ayakulik,1968,0,,176,0
Ayakulik,1968,0,,177,0
Ayakulik,1968,0,,178,0
Ayakulik,1968,0,,179,0
Ayakulik,1968,0,,180,0
Ayakulik,1968,0,,181,0
Ayakulik,1968,0,,182,0
Ayakulik,1968,0,,183,0
Ayakulik,1968,0,,184,0
Ayakulik,1968,0,,185,0
Ayakulik,1968,0,,186,0
Ayakulik,1968,0,,187,0
Ayakulik,1968,0,,188,0
Ayakulik,1968,0,,189,0
Ayakulik,1968,0,,190,0
Ayakulik,1968,0,,191,0
Ayakulik,1968,0,,192,0
Ayakulik,1968,0,,193,0
Ayakulik,1968,0,,194,0
Ayakulik,1968,0,,195,0
Ayakulik,1968,0,,196,0
Ayakulik,1968,0,,197,0
Ayakulik,1968,0,,198,0
Ayakulik,1968,0,,199,0
Ayakulik,1968,0,,200,0
Ayakulik,1968,0,,201,0
Ayakulik,1968,0,,202,0
Ayakulik,1968,0,,203,0
Ayakulik,1968,0,,204,0
Ayakulik,1968,0,,205,0
Ayakulik,1968,0,,206,0
Ayakulik,1968,0,,207,0
Ayakulik,1968,0,,208,0
Ayakulik,1968,0,,209,0
Ayakulik,1968,0,,210,0
Ayakulik,1968,0,,211,0
Ayakulik,1968,0,,212,0
Ayakulik,1968,0,,213,0
Ayakulik,1968,4,,214,4
Ayakulik,1968,1,,215,5
Ayakulik,1968,0,,216,5
Ayakulik,1968,2,,217,7
Ayakulik,1968,0,,218,7
Ayakulik,1968,0,,219,7
Ayakulik,1968,4,,220,11
Ayakulik,1968,31,,221,42
Ayakulik,1968,937,,222,979
Ayakulik,1968,14631,,223,15610
Ayakulik,1968,76815,,224,92425
Ayakulik,1968,18858,,225,111283
Ayakulik,1968,46,,226,111329
Ayakulik,1968,0,,227,111329
Ayakulik,1968,267,,228,111596
Ayakulik,1968,0,,229,111596
Ayakulik,1968,2271,,230,113867
Ayakulik,1968,0,,231,113867
Ayakulik,1968,2519,,232,116386
Ayakulik,1968,0,,233,116386
Ayakulik,1968,0,,234,116386
Ayakulik,1968,0,,235,116386
Ayakulik,1968,0,,236,116386
Ayakulik,1968,0,,237,116386
Ayakulik,1968,0,,238,116386
Ayakulik,1968,0,,239,116386
Ayakulik,1968,0,,240,116386
Ayakulik,1968,0,,241,116386
Ayakulik,1968,0,,242,116386
Ayakulik,1968,0,,243,116386
Ayakulik,1968,0,,244,116386
Ayakulik,1968,0,,245,116386
Ayakulik,1968,0,,246,116386
Ayakulik,1968,0,,247,116386
Ayakulik,1968,0,,248,116386
Ayakulik,1968,0,,249,116386
Ayakulik,1968,0,,250,116386
Ayakulik,1968,0,,251,116386
Ayakulik,1968,0,,252,116386
Ayakulik,1968,0,,253,116386
Ayakulik,1968,0,,254,116386
Ayakulik,1968,0,,255,116386
Ayakulik,1968,0,,256,116386
Ayakulik,1968,0,,257,116386
Ayakulik,1968,0,,258,116386
Ayakulik,1968,0,,259,116386
Ayakulik,1968,0,,260,116386
Ayakulik,1968,0,,261,116386
Ayakulik,1968,0,,262,116386
Ayakulik,1968,0,,263,116386
Ayakulik,1968,0,,264,116386
Ayakulik,1968,0,,265,116386
Ayakulik,1968,0,,266,116386
Ayakulik,1968,0,,267,116386
Ayakulik,1968,0,,268,116386
Ayakulik,1968,0,,269,116386
Ayakulik,1968,0,,270,116386
Ayakulik,1968,0,,271,116386
Ayakulik,1968,0,,272,116386
Ayakulik,1968,0,,273,116386
Ayakulik,1968,0,,274,116386
Ayakulik,1966,0,,152,0
Ayakulik,1966,0,,153,0
Ayakulik,1966,0,,154,0
Ayakulik,1966,0,,155,0
Ayakulik,1966,0,,156,0
Ayakulik,1966,0,,157,0
Ayakulik,1966,0,,158,0
Ayakulik,1966,0,,159,0
Ayakulik,1966,0,,160,0
Ayakulik,1966,0,,161,0
Ayakulik,1966,0,,162,0
Ayakulik,1966,0,,163,0
Ayakulik,1966,0,,164,0
Ayakulik,1966,0,,165,0
Ayakulik,1966,0,,166,0
Ayakulik,1966,0,,167,0
Ayakulik,1966,0,,168,0
Ayakulik,1966,0,,169,0
Ayakulik,1966,0,,170,0
Ayakulik,1966,0,,171,0
Ayakulik,1966,0,,172,0
Ayakulik,1966,0,,173,0
Ayakulik,1966,0,,174,0
Ayakulik,1966,0,,175,0
Ayakulik,1966,0,,176,0
Ayakulik,1966,0,,177,0
Ayakulik,1966,0,,178,0
Ayakulik,1966,0,,179,0
Ayakulik,1966,0,,180,0
Ayakulik,1966,0,,181,0
Ayakulik,1966,0,,182,0
Ayakulik,1966,0,,183,0
Ayakulik,1966,0,,184,0
Ayakulik,1966,0,,185,0
Ayakulik,1966,0,,186,0
Ayakulik,1966,0,,187,0
Ayakulik,1966,0,,188,0
Ayakulik,1966,0,,189,0
Ayakulik,1966,0,,190,0
Ayakulik,1966,0,,191,0
Ayakulik,1966,0,,192,0
Ayakulik,1966,0,,193,0
Ayakulik,1966,0,,194,0
Ayakulik,1966,0,,195,0
Ayakulik,1966,0,,196,0
Ayakulik,1966,0,,197,0
Ayakulik,1966,0,,198,0
Ayakulik,1966,0,,199,0
Ayakulik,1966,0,,200,0
Ayakulik,1966,0,,201,0
Ayakulik,1966,0,,202,0
Ayakulik,1966,0,,203,0
Ayakulik,1966,0,,204,0
Ayakulik,1966,0,,205,0
Ayakulik,1966,0,,206,0
Ayakulik,1966,0,,207,0
Ayakulik,1966,166,,208,166
Ayakulik,1966,5,,209,171
Ayakulik,1966,0,,210,171
Ayakulik,1966,0,,211,171
Ayakulik,1966,9,,212,180
Ayakulik,1966,1594,,213,1774
Ayakulik,1966,7,,214,1781
Ayakulik,1966,3,,215,1784
Ayakulik,1966,775,,216,2559
Ayakulik,1966,2147,,217,4706
Ayakulik,1966,52,,218,4758
Ayakulik,1966,44,,219,4802
Ayakulik,1966,18,,220,4820
Ayakulik,1966,98,,221,4918
Ayakulik,1966,14,,222,4932
Ayakulik,1966,55,,223,4987
Ayakulik,1966,205,,224,5192
Ayakulik,1966,354,,225,5546
Ayakulik,1966,268,,226,5814
Ayakulik,1966,153,,227,5967
Ayakulik,1966,106,,228,6073
Ayakulik,1966,118,,229,6191
Ayakulik,1966,321,,230,6512
Ayakulik,1966,786,,231,7298
Ayakulik,1966,540,,232,7838
Ayakulik,1966,2285,,233,10123
Ayakulik,1966,3080,,234,13203
Ayakulik,1966,1041,,235,14244
Ayakulik,1966,477,,236,14721
Ayakulik,1966,509,,237,15230
Ayakulik,1966,234,,238,15464
Ayakulik,1966,141,,239,15605
Ayakulik,1966,92,,240,15697
Ayakulik,1966,0,,241,15697
Ayakulik,1966,0,,242,15697
Ayakulik,1966,0,,243,15697
Ayakulik,1966,0,,244,15697
Ayakulik,1966,0,,245,15697
Ayakulik,1966,0,,246,15697
Ayakulik,1966,0,,247,15697
Ayakulik,1966,0,,248,15697
Ayakulik,1966,0,,249,15697
Ayakulik,1966,0,,250,15697
Ayakulik,1966,0,,251,15697
Ayakulik,1966,0,,252,15697
Ayakulik,1966,0,,253,15697
Ayakulik,1966,0,,254,15697
Ayakulik,1966,0,,255,15697
Ayakulik,1966,0,,256,15697
Ayakulik,1966,0,,257,15697
Ayakulik,1966,0,,258,15697
Ayakulik,1966,0,,259,15697
Ayakulik,1966,0,,260,15697
Ayakulik,1966,0,,261,15697
Ayakulik,1966,0,,262,15697
Ayakulik,1966,0,,263,15697
Ayakulik,1966,0,,264,15697
Ayakulik,1966,0,,265,15697
Ayakulik,1966,0,,266,15697
Ayakulik,1966,0,,267,15697
Ayakulik,1966,0,,268,15697
Ayakulik,1966,0,,269,15697
Ayakulik,1966,0,,270,15697
Ayakulik,1966,0,,271,15697
Ayakulik,1966,0,,272,15697
Ayakulik,1966,0,,273,15697
Ayakulik,1964,0,,153,0
Ayakulik,1964,0,,154,0
Ayakulik,1964,0,,155,0
Ayakulik,1964,0,,156,0
Ayakulik,1964,0,,157,0
Ayakulik,1964,0,,158,0
Ayakulik,1964,0,,159,0
Ayakulik,1964,0,,160,0
Ayakulik,1964,0,,161,0
Ayakulik,1964,0,,162,0
Ayakulik,1964,0,,163,0
Ayakulik,1964,0,,164,0
Ayakulik,1964,0,,165,0
Ayakulik,1964,0,,166,0
Ayakulik,1964,0,,167,0
Ayakulik,1964,0,,168,0
Ayakulik,1964,0,,169,0
Ayakulik,1964,0,,170,0
Ayakulik,1964,0,,171,0
Ayakulik,1964,0,,172,0
Ayakulik,1964,0,,173,0
Ayakulik,1964,0,,174,0
Ayakulik,1964,0,,175,0
Ayakulik,1964,0,,176,0
Ayakulik,1964,0,,177,0
Ayakulik,1964,0,,178,0
Ayakulik,1964,0,,179,0
Ayakulik,1964,0,,180,0
Ayakulik,1964,0,,181,0
Ayakulik,1964,0,,182,0
Ayakulik,1964,0,,183,0
Ayakulik,1964,0,,184,0
Ayakulik,1964,0,,185,0
Ayakulik,1964,0,,186,0
Ayakulik,1964,0,,187,0
Ayakulik,1964,0,,188,0
Ayakulik,1964,0,,189,0
Ayakulik,1964,0,,190,0
Ayakulik,1964,0,,191,0
Ayakulik,1964,0,,192,0
Ayakulik,1964,0,,193,0
Ayakulik,1964,0,,194,0
Ayakulik,1964,0,,195,0
Ayakulik,1964,0,,196,0
Ayakulik,1964,0,,197,0
Ayakulik,1964,0,,198,0
Ayakulik,1964,0,,199,0
Ayakulik,1964,0,,200,0
Ayakulik,1964,0,,201,0
Ayakulik,1964,0,,202,0
Ayakulik,1964,0,,203,0
Ayakulik,1964,0,,204,0
Ayakulik,1964,0,,205,0
Ayakulik,1964,0,,206,0
Ayakulik,1964,0,,207,0
Ayakulik,1964,0,,208,0
Ayakulik,1964,0,,209,0
Ayakulik,1964,0,,210,0
Ayakulik,1964,0,,211,0
Ayakulik,1964,0,,212,0
Ayakulik,1964,0,,213,0
Ayakulik,1964,0,,214,0
Ayakulik,1964,0,,215,0
Ayakulik,1964,0,,216,0
Ayakulik,1964,0,,217,0
Ayakulik,1964,0,,218,0
Ayakulik,1964,0,,219,0
Ayakulik,1964,0,,220,0
Ayakulik,1964,0,,221,0
Ayakulik,1964,0,,222,0
Ayakulik,1964,76,,223,76
Ayakulik,1964,130,,224,206
Ayakulik,1964,174,,225,380
Ayakulik,1964,64,,226,444
Ayakulik,1964,18,,227,462
Ayakulik,1964,11,,228,473
Ayakulik,1964,4,,229,477
Ayakulik,1964,5,,230,482
Ayakulik,1964,19,,231,501
Ayakulik,1964,347,,232,848
Ayakulik,1964,306,,233,1154
Ayakulik,1964,93,,234,1247
Ayakulik,1964,51,,235,1298
Ayakulik,1964,30,,236,1328
Ayakulik,1964,0,,237,1328
Ayakulik,1964,0,,238,1328
Ayakulik,1964,0,,239,1328
Ayakulik,1964,0,,240,1328
Ayakulik,1964,0,,241,1328
Ayakulik,1964,0,,242,1328
Ayakulik,1964,0,,243,1328
Ayakulik,1964,0,,244,1328
Ayakulik,1964,0,,245,1328
Ayakulik,1964,0,,246,1328
Ayakulik,1964,0,,247,1328
Ayakulik,1964,0,,248,1328
Ayakulik,1964,0,,249,1328
Ayakulik,1964,0,,250,1328
Ayakulik,1964,0,,251,1328
Ayakulik,1964,0,,252,1328
Ayakulik,1964,0,,253,1328
Ayakulik,1964,0,,254,1328
Ayakulik,1964,0,,255,1328
Ayakulik,1964,0,,256,1328
Ayakulik,1964,0,,257,1328
Ayakulik,1964,0,,258,1328
Ayakulik,1964,0,,259,1328
Ayakulik,1964,0,,260,1328
Ayakulik,1964,0,,261,1328
Ayakulik,1964,0,,262,1328
Ayakulik,1964,0,,263,1328
Ayakulik,1964,0,,264,1328
Ayakulik,1964,0,,265,1328
Ayakulik,1964,0,,266,1328
Ayakulik,1964,0,,267,1328
Ayakulik,1964,0,,268,1328
Ayakulik,1964,0,,269,1328
Ayakulik,1964,0,,270,1328
Ayakulik,1964,0,,271,1328
Ayakulik,1964,0,,272,1328
Ayakulik,1964,0,,273,1328
Ayakulik,1964,0,,274,1328
Ayakulik,1962,0,,152,0
Ayakulik,1962,0,,153,0
Ayakulik,1962,0,,154,0
Ayakulik,1962,0,,155,0
Ayakulik,1962,0,,156,0
Ayakulik,1962,0,,157,0
Ayakulik,1962,0,,158,0
Ayakulik,1962,0,,159,0
Ayakulik,1962,0,,160,0
Ayakulik,1962,0,,161,0
Ayakulik,1962,0,,162,0
Ayakulik,1962,0,,163,0
Ayakulik,1962,0,,164,0
Ayakulik,1962,0,,165,0
Ayakulik,1962,0,,166,0
Ayakulik,1962,0,,167,0
Ayakulik,1962,0,,168,0
Ayakulik,1962,0,,169,0
Ayakulik,1962,0,,170,0
Ayakulik,1962,0,,171,0
Ayakulik,1962,0,,172,0
Ayakulik,1962,0,,173,0
Ayakulik,1962,0,,174,0
Ayakulik,1962,0,,175,0
Ayakulik,1962,0,,176,0
Ayakulik,1962,0,,177,0
Ayakulik,1962,0,,178,0
Ayakulik,1962,0,,179,0
Ayakulik,1962,0,,180,0
Ayakulik,1962,0,,181,0
Ayakulik,1962,0,,182,0
Ayakulik,1962,0,,183,0
Ayakulik,1962,0,,184,0
Ayakulik,1962,0,,185,0
Ayakulik,1962,0,,186,0
Ayakulik,1962,0,,187,0
Ayakulik,1962,0,,188,0
Ayakulik,1962,0,,189,0
Ayakulik,1962,0,,190,0
Ayakulik,1962,0,,191,0
Ayakulik,1962,0,,192,0
Ayakulik,1962,0,,193,0
Ayakulik,1962,0,,194,0
Ayakulik,1962,0,,195,0
Ayakulik,1962,0,,196,0
Ayakulik,1962,0,,197,0
Ayakulik,1962,0,,198,0
Ayakulik,1962,0,,199,0
Ayakulik,1962,1,,200,1
Ayakulik,1962,2,,201,3
Ayakulik,1962,0,,202,3
Ayakulik,1962,0,,203,3
Ayakulik,1962,8,,204,11
Ayakulik,1962,0,,205,11
Ayakulik,1962,0,,206,11
Ayakulik,1962,0,,207,11
Ayakulik,1962,4,,208,15
Ayakulik,1962,0,,209,15
Ayakulik,1962,0,,210,15
Ayakulik,1962,24,,211,39
Ayakulik,1962,6,,212,45
Ayakulik,1962,7,,213,52
Ayakulik,1962,171,,214,223
Ayakulik,1962,7,,215,230
Ayakulik,1962,7,,216,237
Ayakulik,1962,81,,217,318
Ayakulik,1962,124,,218,442
Ayakulik,1962,1225,,219,1667
Ayakulik,1962,2553,,220,4220
Ayakulik,1962,2320,,221,6540
Ayakulik,1962,1095,,222,7635
Ayakulik,1962,984,,223,8619
Ayakulik,1962,2659,,224,11278
Ayakulik,1962,2485,,225,13763
Ayakulik,1962,5735,,226,19498
Ayakulik,1962,9936,,227,29434
Ayakulik,1962,7436,,228,36870
Ayakulik,1962,7362,,229,44232
Ayakulik,1962,4445,,230,48677
Ayakulik,1962,0,,231,48677
Ayakulik,1962,0,,232,48677
Ayakulik,1962,0,,233,48677
Ayakulik,1962,0,,234,48677
Ayakulik,1962,0,,235,48677
Ayakulik,1962,0,,236,48677
Ayakulik,1962,0,,237,48677
Ayakulik,1962,0,,238,48677
Ayakulik,1962,0,,239,48677
Ayakulik,1962,0,,240,48677
Ayakulik,1962,0,,241,48677
Ayakulik,1962,0,,242,48677
Ayakulik,1962,0,,243,48677
Ayakulik,1962,0,,244,48677
Ayakulik,1962,0,,245,48677
Ayakulik,1962,0,,246,48677
Ayakulik,1962,0,,247,48677
Ayakulik,1962,0,,248,48677
Ayakulik,1962,0,,249,48677
Ayakulik,1962,0,,250,48677
Ayakulik,1962,0,,251,48677
Ayakulik,1962,0,,252,48677
Ayakulik,1962,0,,253,48677
Ayakulik,1962,0,,254,48677
Ayakulik,1962,0,,255,48677
Ayakulik,1962,0,,256,48677
Ayakulik,1962,0,,257,48677
Ayakulik,1962,0,,258,48677
Ayakulik,1962,0,,259,48677
Ayakulik,1962,0,,260,48677
Ayakulik,1962,0,,261,48677
Ayakulik,1962,0,,262,48677
Ayakulik,1962,0,,263,48677
Ayakulik,1962,0,,264,48677
Ayakulik,1962,0,,265,48677
Ayakulik,1962,0,,266,48677
Ayakulik,1962,0,,267,48677
Ayakulik,1962,0,,268,48677
Ayakulik,1962,0,,269,48677
Ayakulik,1962,0,,270,48677
Ayakulik,1962,0,,271,48677
Ayakulik,1962,0,,272,48677
Ayakulik,1962,0,,273,48677
Ayakulik,1960,0,,153,0
Ayakulik,1960,0,,154,0
Ayakulik,1960,0,,155,0
Ayakulik,1960,0,,156,0
Ayakulik,1960,0,,157,0
Ayakulik,1960,0,,158,0
Ayakulik,1960,0,,159,0
Ayakulik,1960,0,,160,0
Ayakulik,1960,0,,161,0
Ayakulik,1960,0,,162,0
Ayakulik,1960,0,,163,0
Ayakulik,1960,0,,164,0
Ayakulik,1960,0,,165,0
Ayakulik,1960,0,,166,0
Ayakulik,1960,0,,167,0
Ayakulik,1960,0,,168,0
Ayakulik,1960,0,,169,0
Ayakulik,1960,0,,170,0
Ayakulik,1960,0,,171,0
Ayakulik,1960,0,,172,0
Ayakulik,1960,0,,173,0
Ayakulik,1960,0,,174,0
Ayakulik,1960,0,,175,0
Ayakulik,1960,0,,176,0
Ayakulik,1960,0,,177,0
Ayakulik,1960,0,,178,0
Ayakulik,1960,0,,179,0
Ayakulik,1960,0,,180,0
Ayakulik,1960,0,,181,0
Ayakulik,1960,0,,182,0
Ayakulik,1960,0,,183,0
Ayakulik,1960,0,,184,0
Ayakulik,1960,0,,185,0
Ayakulik,1960,0,,186,0
Ayakulik,1960,0,,187,0
Ayakulik,1960,0,,188,0
Ayakulik,1960,0,,189,0
Ayakulik,1960,0,,190,0
Ayakulik,1960,0,,191,0
Ayakulik,1960,0,,192,0
Ayakulik,1960,0,,193,0
Ayakulik,1960,0,,194,0
Ayakulik,1960,0,,195,0
Ayakulik,1960,0,,196,0
Ayakulik,1960,0,,197,0
Ayakulik,1960,0,,198,0
Ayakulik,1960,0,,199,0
Ayakulik,1960,0,,200,0
Ayakulik,1960,0,,201,0
Ayakulik,1960,0,,202,0
Ayakulik,1960,0,,203,0
Ayakulik,1960,0,,204,0
Ayakulik,1960,0,,205,0
Ayakulik,1960,0,,206,0
Ayakulik,1960,0,,207,0
Ayakulik,1960,5,,208,5
Ayakulik,1960,20,,209,25
Ayakulik,1960,0,,210,25
Ayakulik,1960,0,,211,25
Ayakulik,1960,0,,212,25
Ayakulik,1960,1,,213,26
Ayakulik,1960,123,,214,149
Ayakulik,1960,250,,215,399
Ayakulik,1960,10,,216,409
Ayakulik,1960,58,,217,467
Ayakulik,1960,24,,218,491
Ayakulik,1960,45,,219,536
Ayakulik,1960,243,,220,779
Ayakulik,1960,196,,221,975
Ayakulik,1960,30,,222,1005
Ayakulik,1960,467,,223,1472
Ayakulik,1960,427,,224,1899
Ayakulik,1960,4400,,225,6299
Ayakulik,1960,6043,,226,12342
Ayakulik,1960,11200,,227,23542
Ayakulik,1960,10017,,228,33559
Ayakulik,1960,6017,,229,39576
Ayakulik,1960,2121,,230,41697
Ayakulik,1960,0,,231,41697
Ayakulik,1960,0,,232,41697
Ayakulik,1960,0,,233,41697
Ayakulik,1960,0,,234,41697
Ayakulik,1960,0,,235,41697
Ayakulik,1960,0,,236,41697
Ayakulik,1960,0,,237,41697
Ayakulik,1960,0,,238,41697
Ayakulik,1960,0,,239,41697
Ayakulik,1960,0,,240,41697
Ayakulik,1960,0,,241,41697
Ayakulik,1960,0,,242,41697
Ayakulik,1960,0,,243,41697
Ayakulik,1960,0,,244,41697
Ayakulik,1960,0,,245,41697
Ayakulik,1960,0,,246,41697
Ayakulik,1960,0,,247,41697
Ayakulik,1960,0,,248,41697
Ayakulik,1960,0,,249,41697
Ayakulik,1960,0,,250,41697
Ayakulik,1960,0,,251,41697
Ayakulik,1960,0,,252,41697
Ayakulik,1960,0,,253,41697
Ayakulik,1960,0,,254,41697
Ayakulik,1960,0,,255,41697
Ayakulik,1960,0,,256,41697
Ayakulik,1960,0,,257,41697
Ayakulik,1960,0,,258,41697
Ayakulik,1960,0,,259,41697
Ayakulik,1960,0,,260,41697
Ayakulik,1960,0,,261,41697
Ayakulik,1960,0,,262,41697
Ayakulik,1960,0,,263,41697
Ayakulik,1960,0,,264,41697
Ayakulik,1960,0,,265,41697
Ayakulik,1960,0,,266,41697
Ayakulik,1960,0,,267,41697
Ayakulik,1960,0,,268,41697
Ayakulik,1960,0,,269,41697
Ayakulik,1960,0,,270,41697
Ayakulik,1960,0,,271,41697
Ayakulik,1960,0,,272,41697
Ayakulik,1960,0,,273,41697
Ayakulik,1960,0,,274,41697
Ayakulik,1958,0,,152,0
Ayakulik,1958,0,,153,0
Ayakulik,1958,0,,154,0
Ayakulik,1958,0,,155,0
Ayakulik,1958,0,,156,0
Ayakulik,1958,0,,157,0
Ayakulik,1958,0,,158,0
Ayakulik,1958,0,,159,0
Ayakulik,1958,0,,160,0
Ayakulik,1958,0,,161,0
Ayakulik,1958,0,,162,0
Ayakulik,1958,0,,163,0
Ayakulik,1958,0,,164,0
Ayakulik,1958,0,,165,0
Ayakulik,1958,0,,166,0
Ayakulik,1958,0,,167,0
Ayakulik,1958,0,,168,0
Ayakulik,1958,0,,169,0
Ayakulik,1958,0,,170,0
Ayakulik,1958,0,,171,0
Ayakulik,1958,0,,172,0
Ayakulik,1958,0,,173,0
Ayakulik,1958,0,,174,0
Ayakulik,1958,0,,175,0
Ayakulik,1958,0,,176,0
Ayakulik,1958,0,,177,0
Ayakulik,1958,0,,178,0
Ayakulik,1958,0,,179,0
Ayakulik,1958,0,,180,0
Ayakulik,1958,0,,181,0
Ayakulik,1958,0,,182,0
Ayakulik,1958,0,,183,0
Ayakulik,1958,0,,184,0
Ayakulik,1958,0,,185,0
Ayakulik,1958,0,,186,0
Ayakulik,1958,0,,187,0
Ayakulik,1958,0,,188,0
Ayakulik,1958,0,,189,0
Ayakulik,1958,0,,190,0
Ayakulik,1958,0,,191,0
Ayakulik,1958,0,,192,0
Ayakulik,1958,0,,193,0
Ayakulik,1958,0,,194,0
Ayakulik,1958,0,,195,0
Ayakulik,1958,0,,196,0
Ayakulik,1958,0,,197,0
Ayakulik,1958,0,,198,0
Ayakulik,1958,0,,199,0
Ayakulik,1958,0,,200,0
Ayakulik,1958,0,,201,0
Ayakulik,1958,0,,202,0
Ayakulik,1958,0,,203,0
Ayakulik,1958,0,,204,0
Ayakulik,1958,0,,205,0
Ayakulik,1958,0,,206,0
Ayakulik,1958,0,,207,0
Ayakulik,1958,0,,208,0
Ayakulik,1958,0,,209,0
Ayakulik,1958,0,,210,0
Ayakulik,1958,0,,211,0
Ayakulik,1958,0,,212,0
Ayakulik,1958,0,,213,0
Ayakulik,1958,0,,214,0
Ayakulik,1958,23,,215,23
Ayakulik,1958,9,,216,32
Ayakulik,1958,2360,,217,2392
Ayakulik,1958,1408,,218,3800
Ayakulik,1958,634,,219,4434
Ayakulik,1958,118,,220,4552
Ayakulik,1958,210,,221,4762
Ayakulik,1958,218,,222,4980
Ayakulik,1958,3620,,223,8600
Ayakulik,1958,4148,,224,12748
Ayakulik,1958,3654,,225,16402
Ayakulik,1958,3963,,226,20365
Ayakulik,1958,1679,,227,22044
Ayakulik,1958,1321,,228,23365
Ayakulik,1958,235,,229,23600
Ayakulik,1958,164,,230,23764
Ayakulik,1958,90,,231,23854
Ayakulik,1958,10,,232,23864
Ayakulik,1958,0,,233,23864
Ayakulik,1958,0,,234,23864
Ayakulik,1958,0,,235,23864
Ayakulik,1958,0,,236,23864
Ayakulik,1958,0,,237,23864
Ayakulik,1958,0,,238,23864
Ayakulik,1958,0,,239,23864
Ayakulik,1958,0,,240,23864
Ayakulik,1958,0,,241,23864
Ayakulik,1958,0,,242,23864
Ayakulik,1958,0,,243,23864
Ayakulik,1958,0,,244,23864
Ayakulik,1958,0,,245,23864
Ayakulik,1958,0,,246,23864
Ayakulik,1958,0,,247,23864
Ayakulik,1958,0,,248,23864
Ayakulik,1958,0,,249,23864
Ayakulik,1958,0,,250,23864
Ayakulik,1958,0,,251,23864
Ayakulik,1958,0,,252,23864
Ayakulik,1958,0,,253,23864
Ayakulik,1958,0,,254,23864
Ayakulik,1958,0,,255,23864
Ayakulik,1958,0,,256,23864
Ayakulik,1958,0,,257,23864
Ayakulik,1958,0,,258,23864
Ayakulik,1958,0,,259,23864
Ayakulik,1958,0,,260,23864
Ayakulik,1958,0,,261,23864
Ayakulik,1958,0,,262,23864
Ayakulik,1958,0,,263,23864
Ayakulik,1958,0,,264,23864
Ayakulik,1958,0,,265,23864
Ayakulik,1958,0,,266,23864
Ayakulik,1958,0,,267,23864
Ayakulik,1958,0,,268,23864
Ayakulik,1958,0,,269,23864
Ayakulik,1958,0,,270,23864
Ayakulik,1958,0,,271,23864
Ayakulik,1958,0,,272,23864
Ayakulik,1958,0,,273,23864
Ayakulik,1956,0,,153,0
Ayakulik,1956,0,,154,0
Ayakulik,1956,0,,155,0
Ayakulik,1956,0,,156,0
Ayakulik,1956,0,,157,0
Ayakulik,1956,0,,158,0
Ayakulik,1956,0,,159,0
Ayakulik,1956,0,,160,0
Ayakulik,1956,0,,161,0
Ayakulik,1956,0,,162,0
Ayakulik,1956,0,,163,0
Ayakulik,1956,0,,164,0
Ayakulik,1956,0,,165,0
Ayakulik,1956,0,,166,0
Ayakulik,1956,0,,167,0
Ayakulik,1956,0,,168,0
Ayakulik,1956,0,,169,0
Ayakulik,1956,0,,170,0
Ayakulik,1956,0,,171,0
Ayakulik,1956,0,,172,0
Ayakulik,1956,0,,173,0
Ayakulik,1956,0,,174,0
Ayakulik,1956,0,,175,0
Ayakulik,1956,0,,176,0
Ayakulik,1956,0,,177,0
Ayakulik,1956,0,,178,0
Ayakulik,1956,0,,179,0
Ayakulik,1956,0,,180,0
Ayakulik,1956,0,,181,0
Ayakulik,1956,0,,182,0
Ayakulik,1956,0,,183,0
Ayakulik,1956,0,,184,0
Ayakulik,1956,0,,185,0
Ayakulik,1956,0,,186,0
Ayakulik,1956,0,,187,0
Ayakulik,1956,0,,188,0
Ayakulik,1956,0,,189,0
Ayakulik,1956,0,,190,0
Ayakulik,1956,0,,191,0
Ayakulik,1956,0,,192,0
Ayakulik,1956,0,,193,0
Ayakulik,1956,0,,194,0
Ayakulik,1956,0,,195,0
Ayakulik,1956,0,,196,0
Ayakulik,1956,0,,197,0
Ayakulik,1956,0,,198,0
Ayakulik,1956,0,,199,0
Ayakulik,1956,0,,200,0
Ayakulik,1956,0,,201,0
Ayakulik,1956,0,,202,0
Ayakulik,1956,0,,203,0
Ayakulik,1956,0,,204,0
Ayakulik,1956,0,,205,0
Ayakulik,1956,0,,206,0
Ayakulik,1956,0,,207,0
Ayakulik,1956,0,,208,0
Ayakulik,1956,0,,209,0
Ayakulik,1956,0,,210,0
Ayakulik,1956,0,,211,0
Ayakulik,1956,0,,212,0
Ayakulik,1956,0,,213,0
Ayakulik,1956,0,,214,0
Ayakulik,1956,0,,215,0
Ayakulik,1956,0,,216,0
Ayakulik,1956,0,,217,0
Ayakulik,1956,0,,218,0
Ayakulik,1956,0,,219,0
Ayakulik,1956,0,,220,0
Ayakulik,1956,0,,221,0
Ayakulik,1956,0,,222,0
Ayakulik,1956,0,,223,0
Ayakulik,1956,0,,224,0
Ayakulik,1956,27,,225,27
Ayakulik,1956,318,,226,345
Ayakulik,1956,1672,,227,2017
Ayakulik,1956,744,,228,2761
Ayakulik,1956,370,,229,3131
Ayakulik,1956,163,,230,3294
Ayakulik,1956,17,,231,3311
Ayakulik,1956,0,,232,3311
Ayakulik,1956,0,,233,3311
Ayakulik,1956,0,,234,3311
Ayakulik,1956,0,,235,3311
Ayakulik,1956,0,,236,3311
Ayakulik,1956,0,,237,3311
Ayakulik,1956,0,,238,3311
Ayakulik,1956,0,,239,3311
Ayakulik,1956,0,,240,3311
Ayakulik,1956,0,,241,3311
Ayakulik,1956,0,,242,3311
Ayakulik,1956,0,,243,3311
Ayakulik,1956,0,,244,3311
Ayakulik,1956,0,,245,3311
Ayakulik,1956,0,,246,3311
Ayakulik,1956,0,,247,3311
Ayakulik,1956,0,,248,3311
Ayakulik,1956,0,,249,3311
Ayakulik,1956,0,,250,3311
Ayakulik,1956,0,,251,3311
Ayakulik,1956,0,,252,3311
Ayakulik,1956,0,,253,3311
Ayakulik,1956,0,,254,3311
Ayakulik,1956,0,,255,3311
Ayakulik,1956,0,,256,3311
Ayakulik,1956,0,,257,3311
Ayakulik,1956,0,,258,3311
Ayakulik,1956,0,,259,3311
Ayakulik,1956,0,,260,3311
Ayakulik,1956,0,,261,3311
Ayakulik,1956,0,,262,3311
Ayakulik,1956,0,,263,3311
Ayakulik,1956,0,,264,3311
Ayakulik,1956,0,,265,3311
Ayakulik,1956,0,,266,3311
Ayakulik,1956,0,,267,3311
Ayakulik,1956,0,,268,3311
Ayakulik,1956,0,,269,3311
Ayakulik,1956,0,,270,3311
Ayakulik,1956,0,,271,3311
Ayakulik,1956,0,,272,3311
Ayakulik,1956,0,,273,3311
Ayakulik,1956,0,,274,3311
Ayakulik,1954,0,,152,0
Ayakulik,1954,0,,153,0
Ayakulik,1954,0,,154,0
Ayakulik,1954,0,,155,0
Ayakulik,1954,0,,156,0
Ayakulik,1954,0,,157,0
Ayakulik,1954,0,,158,0
Ayakulik,1954,0,,159,0
Ayakulik,1954,0,,160,0
Ayakulik,1954,0,,161,0
Ayakulik,1954,0,,162,0
Ayakulik,1954,0,,163,0
Ayakulik,1954,0,,164,0
Ayakulik,1954,0,,165,0
Ayakulik,1954,0,,166,0
Ayakulik,1954,0,,167,0
Ayakulik,1954,0,,168,0
Ayakulik,1954,0,,169,0
Ayakulik,1954,0,,170,0
Ayakulik,1954,0,,171,0
Ayakulik,1954,0,,172,0
Ayakulik,1954,0,,173,0
Ayakulik,1954,0,,174,0
Ayakulik,1954,0,,175,0
Ayakulik,1954,0,,176,0
Ayakulik,1954,0,,177,0
Ayakulik,1954,0,,178,0
Ayakulik,1954,0,,179,0
Ayakulik,1954,0,,180,0
Ayakulik,1954,0,,181,0
Ayakulik,1954,0,,182,0
Ayakulik,1954,0,,183,0
Ayakulik,1954,0,,184,0
Ayakulik,1954,0,,185,0
Ayakulik,1954,0,,186,0
Ayakulik,1954,0,,187,0
Ayakulik,1954,0,,188,0
Ayakulik,1954,0,,189,0
Ayakulik,1954,0,,190,0
Ayakulik,1954,0,,191,0
Ayakulik,1954,0,,192,0
Ayakulik,1954,0,,193,0
Ayakulik,1954,0,,194,0
Ayakulik,1954,0,,195,0
Ayakulik,1954,0,,196,0
Ayakulik,1954,0,,197,0
Ayakulik,1954,0,,198,0
Ayakulik,1954,0,,199,0
Ayakulik,1954,0,,200,0
Ayakulik,1954,0,,201,0
Ayakulik,1954,0,,202,0
Ayakulik,1954,0,,203,0
Ayakulik,1954,0,,204,0
Ayakulik,1954,0,,205,0
Ayakulik,1954,0,,206,0
Ayakulik,1954,0,,207,0
Ayakulik,1954,0,,208,0
Ayakulik,1954,0,,209,0
Ayakulik,1954,0,,210,0
Ayakulik,1954,0,,211,0
Ayakulik,1954,0,,212,0
Ayakulik,1954,2164,,213,2164
Ayakulik,1954,643,,214,2807
Ayakulik,1954,65,,215,2872
Ayakulik,1954,0,,216,2872
Ayakulik,1954,37,,217,2909
Ayakulik,1954,0,,218,2909
Ayakulik,1954,0,,219,2909
Ayakulik,1954,187,,220,3096
Ayakulik,1954,934,,221,4030
Ayakulik,1954,174,,222,4204
Ayakulik,1954,3156,,223,7360
Ayakulik,1954,4322,,224,11682
Ayakulik,1954,3840,,225,15522
Ayakulik,1954,227,,226,15749
Ayakulik,1954,0,,227,15749
Ayakulik,1954,0,,228,15749
Ayakulik,1954,0,,229,15749
Ayakulik,1954,0,,230,15749
Ayakulik,1954,0,,231,15749
Ayakulik,1954,0,,232,15749
Ayakulik,1954,0,,233,15749
Ayakulik,1954,0,,234,15749
Ayakulik,1954,0,,235,15749
Ayakulik,1954,0,,236,15749
Ayakulik,1954,0,,237,15749
Ayakulik,1954,0,,238,15749
Ayakulik,1954,0,,239,15749
Ayakulik,1954,0,,240,15749
Ayakulik,1954,0,,241,15749
Ayakulik,1954,0,,242,15749
Ayakulik,1954,0,,243,15749
Ayakulik,1954,0,,244,15749
Ayakulik,1954,0,,245,15749
Ayakulik,1954,0,,246,15749
Ayakulik,1954,0,,247,15749
Ayakulik,1954,0,,248,15749
Ayakulik,1954,0,,249,15749
Ayakulik,1954,0,,250,15749
Ayakulik,1954,0,,251,15749
Ayakulik,1954,0,,252,15749
Ayakulik,1954,0,,253,15749
Ayakulik,1954,0,,254,15749
Ayakulik,1954,0,,255,15749
Ayakulik,1954,0,,256,15749
Ayakulik,1954,0,,257,15749
Ayakulik,1954,0,,258,15749
Ayakulik,1954,0,,259,15749
Ayakulik,1954,0,,260,15749
Ayakulik,1954,0,,261,15749
Ayakulik,1954,0,,262,15749
Ayakulik,1954,0,,263,15749
Ayakulik,1954,0,,264,15749
Ayakulik,1954,0,,265,15749
Ayakulik,1954,0,,266,15749
Ayakulik,1954,0,,267,15749
Ayakulik,1954,0,,268,15749
Ayakulik,1954,0,,269,15749
Ayakulik,1954,0,,270,15749
Ayakulik,1954,0,,271,15749
Ayakulik,1954,0,,272,15749
Ayakulik,1954,0,,273,15749
Ayakulik,1952,0,,153,0
Ayakulik,1952,0,,154,0
Ayakulik,1952,0,,155,0
Ayakulik,1952,0,,156,0
Ayakulik,1952,0,,157,0
Ayakulik,1952,0,,158,0
Ayakulik,1952,0,,159,0
Ayakulik,1952,0,,160,0
Ayakulik,1952,0,,161,0
Ayakulik,1952,0,,162,0
Ayakulik,1952,0,,163,0
Ayakulik,1952,0,,164,0
Ayakulik,1952,0,,165,0
Ayakulik,1952,0,,166,0
Ayakulik,1952,0,,167,0
Ayakulik,1952,0,,168,0
Ayakulik,1952,0,,169,0
Ayakulik,1952,0,,170,0
Ayakulik,1952,0,,171,0
Ayakulik,1952,0,,172,0
Ayakulik,1952,0,,173,0
Ayakulik,1952,0,,174,0
Ayakulik,1952,0,,175,0
Ayakulik,1952,0,,176,0
Ayakulik,1952,0,,177,0
Ayakulik,1952,0,,178,0
Ayakulik,1952,0,,179,0
Ayakulik,1952,0,,180,0
Ayakulik,1952,0,,181,0
Ayakulik,1952,0,,182,0
Ayakulik,1952,0,,183,0
Ayakulik,1952,0,,184,0
Ayakulik,1952,0,,185,0
Ayakulik,1952,0,,186,0
Ayakulik,1952,0,,187,0
Ayakulik,1952,0,,188,0
Ayakulik,1952,0,,189,0
Ayakulik,1952,0,,190,0
Ayakulik,1952,0,,191,0
Ayakulik,1952,0,,192,0
Ayakulik,1952,0,,193,0
Ayakulik,1952,0,,194,0
Ayakulik,1952,0,,195,0
Ayakulik,1952,0,,196,0
Ayakulik,1952,0,,197,0
Ayakulik,1952,0,,198,0
Ayakulik,1952,0,,199,0
Ayakulik,1952,0,,200,0
Ayakulik,1952,0,,201,0
Ayakulik,1952,0,,202,0
Ayakulik,1952,0,,203,0
Ayakulik,1952,0,,204,0
Ayakulik,1952,0,,205,0
Ayakulik,1952,0,,206,0
Ayakulik,1952,0,,207,0
Ayakulik,1952,0,,208,0
Ayakulik,1952,0,,209,0
Ayakulik,1952,24,,210,24
Ayakulik,1952,19,,211,43
Ayakulik,1952,6,,212,49
Ayakulik,1952,0,,213,49
Ayakulik,1952,0,,214,49
Ayakulik,1952,0,,215,49
Ayakulik,1952,0,,216,49
Ayakulik,1952,14,,217,63
Ayakulik,1952,9,,218,72
Ayakulik,1952,16,,219,88
Ayakulik,1952,330,,220,418
Ayakulik,1952,260,,221,678
Ayakulik,1952,67,,222,745
Ayakulik,1952,463,,223,1208
Ayakulik,1952,340,,224,1548
Ayakulik,1952,285,,225,1833
Ayakulik,1952,361,,226,2194
Ayakulik,1952,85,,227,2279
Ayakulik,1952,73,,228,2352
Ayakulik,1952,24,,229,2376
Ayakulik,1952,0,,230,2376
Ayakulik,1952,0,,231,2376
Ayakulik,1952,0,,232,2376
Ayakulik,1952,0,,233,2376
Ayakulik,1952,0,,234,2376
Ayakulik,1952,0,,235,2376
Ayakulik,1952,0,,236,2376
Ayakulik,1952,0,,237,2376
Ayakulik,1952,0,,238,2376
Ayakulik,1952,0,,239,2376
Ayakulik,1952,0,,240,2376
Ayakulik,1952,0,,241,2376
Ayakulik,1952,0,,242,2376
Ayakulik,1952,0,,243,2376
Ayakulik,1952,0,,244,2376
Ayakulik,1952,0,,245,2376
Ayakulik,1952,0,,246,2376
Ayakulik,1952,0,,247,2376
Ayakulik,1952,0,,248,2376
Ayakulik,1952,0,,249,2376
Ayakulik,1952,0,,250,2376
Ayakulik,1952,0,,251,2376
Ayakulik,1952,0,,252,2376
Ayakulik,1952,0,,253,2376
Ayakulik,1952,0,,254,2376
Ayakulik,1952,0,,255,2376
Ayakulik,1952,0,,256,2376
Ayakulik,1952,0,,257,2376
Ayakulik,1952,0,,258,2376
Ayakulik,1952,0,,259,2376
Ayakulik,1952,0,,260,2376
Ayakulik,1952,0,,261,2376
Ayakulik,1952,0,,262,2376
Ayakulik,1952,0,,263,2376
Ayakulik,1952,0,,264,2376
Ayakulik,1952,0,,265,2376
Ayakulik,1952,0,,266,2376
Ayakulik,1952,0,,267,2376
Ayakulik,1952,0,,268,2376
Ayakulik,1952,0,,269,2376
Ayakulik,1952,0,,270,2376
Ayakulik,1952,0,,271,2376
Ayakulik,1952,0,,272,2376
Ayakulik,1952,0,,273,2376
Ayakulik,1952,0,,274,2376
Ayakulik,1950,0,,152,0
Ayakulik,1950,0,,153,0
Ayakulik,1950,0,,154,0
Ayakulik,1950,0,,155,0
Ayakulik,1950,0,,156,0
Ayakulik,1950,0,,157,0
Ayakulik,1950,0,,158,0
Ayakulik,1950,0,,159,0
Ayakulik,1950,0,,160,0
Ayakulik,1950,0,,161,0
Ayakulik,1950,0,,162,0
Ayakulik,1950,0,,163,0
Ayakulik,1950,0,,164,0
Ayakulik,1950,0,,165,0
Ayakulik,1950,0,,166,0
Ayakulik,1950,0,,167,0
Ayakulik,1950,0,,168,0
Ayakulik,1950,0,,169,0
Ayakulik,1950,0,,170,0
Ayakulik,1950,0,,171,0
Ayakulik,1950,0,,172,0
Ayakulik,1950,0,,173,0
Ayakulik,1950,0,,174,0
Ayakulik,1950,0,,175,0
Ayakulik,1950,0,,176,0
Ayakulik,1950,0,,177,0
Ayakulik,1950,0,,178,0
Ayakulik,1950,0,,179,0
Ayakulik,1950,0,,180,0
Ayakulik,1950,0,,181,0
Ayakulik,1950,0,,182,0
Ayakulik,1950,0,,183,0
Ayakulik,1950,0,,184,0
Ayakulik,1950,0,,185,0
Ayakulik,1950,0,,186,0
Ayakulik,1950,0,,187,0
Ayakulik,1950,2,,188,2
Ayakulik,1950,0,,189,2
Ayakulik,1950,0,,190,2
Ayakulik,1950,0,,191,2
Ayakulik,1950,0,,192,2
Ayakulik,1950,0,,193,2
Ayakulik,1950,0,,194,2
Ayakulik,1950,0,,195,2
Ayakulik,1950,0,,196,2
Ayakulik,1950,0,,197,2
Ayakulik,1950,0,,198,2
Ayakulik,1950,0,,199,2
Ayakulik,1950,0,,200,2
Ayakulik,1950,0,,201,2
Ayakulik,1950,0,,202,2
Ayakulik,1950,0,,203,2
Ayakulik,1950,0,,204,2
Ayakulik,1950,0,,205,2
Ayakulik,1950,53,,206,55
Ayakulik,1950,21,,207,76
Ayakulik,1950,0,,208,76
Ayakulik,1950,0,,209,76
Ayakulik,1950,0,,210,76
Ayakulik,1950,3,,211,79
Ayakulik,1950,0,,212,79
Ayakulik,1950,0,,213,79
Ayakulik,1950,12,,214,91
Ayakulik,1950,14,,215,105
Ayakulik,1950,4,,216,109
Ayakulik,1950,0,,217,109
Ayakulik,1950,5,,218,114
Ayakulik,1950,7,,219,121
Ayakulik,1950,4,,220,125
Ayakulik,1950,25,,221,150
Ayakulik,1950,6,,222,156
Ayakulik,1950,8,,223,164
Ayakulik,1950,3,,224,167
Ayakulik,1950,3,,225,170
Ayakulik,1950,4,,226,174
Ayakulik,1950,1,,227,175
Ayakulik,1950,10,,228,185
Ayakulik,1950,9,,229,194
Ayakulik,1950,9,,230,203
Ayakulik,1950,96,,231,299
Ayakulik,1950,1225,,232,1524
Ayakulik,1950,374,,233,1898
Ayakulik,1950,2029,,234,3927
Ayakulik,1950,1322,,235,5249
Ayakulik,1950,1271,,236,6520
Ayakulik,1950,689,,237,7209
Ayakulik,1950,366,,238,7575
Ayakulik,1950,948,,239,8523
Ayakulik,1950,3528,,240,12051
Ayakulik,1950,715,,241,12766
Ayakulik,1950,455,,242,13221
Ayakulik,1950,639,,243,13860
Ayakulik,1950,426,,244,14286
Ayakulik,1950,564,,245,14850
Ayakulik,1950,1536,,246,16386
Ayakulik,1950,1329,,247,17715
Ayakulik,1950,3272,,248,20987
Ayakulik,1950,380,,249,21367
Ayakulik,1950,0,,250,21367
Ayakulik,1950,0,,251,21367
Ayakulik,1950,0,,252,21367
Ayakulik,1950,0,,253,21367
Ayakulik,1950,0,,254,21367
Ayakulik,1950,0,,255,21367
Ayakulik,1950,0,,256,21367
Ayakulik,1950,0,,257,21367
Ayakulik,1950,0,,258,21367
Ayakulik,1950,0,,259,21367
Ayakulik,1950,0,,260,21367
Ayakulik,1950,0,,261,21367
Ayakulik,1950,0,,262,21367
Ayakulik,1950,0,,263,21367
Ayakulik,1950,0,,264,21367
Ayakulik,1950,0,,265,21367
Ayakulik,1950,0,,266,21367
Ayakulik,1950,0,,267,21367
Ayakulik,1950,0,,268,21367
Ayakulik,1950,0,,269,21367
Ayakulik,1950,0,,270,21367
Ayakulik,1950,0,,271,21367
Ayakulik,1950,0,,272,21367
Ayakulik,1950,0,,273,21367
Ayakulik,1949,0,,152,0
Ayakulik,1949,0,,153,0
Ayakulik,1949,0,,154,0
Ayakulik,1949,0,,155,0
Ayakulik,1949,0,,156,0
Ayakulik,1949,0,,157,0
Ayakulik,1949,0,,158,0
Ayakulik,1949,0,,159,0
Ayakulik,1949,0,,160,0
Ayakulik,1949,0,,161,0
Ayakulik,1949,0,,162,0
Ayakulik,1949,0,,163,0
Ayakulik,1949,0,,164,0
Ayakulik,1949,0,,165,0
Ayakulik,1949,0,,166,0
Ayakulik,1949,0,,167,0
Ayakulik,1949,0,,168,0
Ayakulik,1949,0,,169,0
Ayakulik,1949,0,,170,0
Ayakulik,1949,0,,171,0
Ayakulik,1949,0,,172,0
Ayakulik,1949,0,,173,0
Ayakulik,1949,0,,174,0
Ayakulik,1949,0,,175,0
Ayakulik,1949,0,,176,0
Ayakulik,1949,0,,177,0
Ayakulik,1949,0,,178,0
Ayakulik,1949,0,,179,0
Ayakulik,1949,0,,180,0
Ayakulik,1949,0,,181,0
Ayakulik,1949,0,,182,0
Ayakulik,1949,0,,183,0
Ayakulik,1949,0,,184,0
Ayakulik,1949,0,,185,0
Ayakulik,1949,0,,186,0
Ayakulik,1949,0,,187,0
Ayakulik,1949,0,,188,0
Ayakulik,1949,0,,189,0
Ayakulik,1949,0,,190,0
Ayakulik,1949,0,,191,0
Ayakulik,1949,0,,192,0
Ayakulik,1949,0,,193,0
Ayakulik,1949,0,,194,0
Ayakulik,1949,0,,195,0
Ayakulik,1949,0,,196,0
Ayakulik,1949,0,,197,0
Ayakulik,1949,0,,198,0
Ayakulik,1949,0,,199,0
Ayakulik,1949,0,,200,0
Ayakulik,1949,0,,201,0
Ayakulik,1949,0,,202,0
Ayakulik,1949,0,,203,0
Ayakulik,1949,0,,204,0
Ayakulik,1949,0,,205,0
Ayakulik,1949,0,,206,0
Ayakulik,1949,0,,207,0
Ayakulik,1949,0,,208,0
Ayakulik,1949,0,,209,0
Ayakulik,1949,0,,210,0
Ayakulik,1949,0,,211,0
Ayakulik,1949,0,,212,0
Ayakulik,1949,0,,213,0
Ayakulik,1949,0,,214,0
Ayakulik,1949,0,,215,0
Ayakulik,1949,0,,216,0
Ayakulik,1949,0,,217,0
Ayakulik,1949,0,,218,0
Ayakulik,1949,0,,219,0
Ayakulik,1949,0,,220,0
Ayakulik,1949,0,,221,0
Ayakulik,1949,0,,222,0
Ayakulik,1949,0,,223,0
Ayakulik,1949,0,,224,0
Ayakulik,1949,0,,225,0
Ayakulik,1949,0,,226,0
Ayakulik,1949,0,,227,0
Ayakulik,1949,0,,228,0
Ayakulik,1949,0,,229,0
Ayakulik,1949,0,,230,0
Ayakulik,1949,1,,231,1
Ayakulik,1949,0,,232,1
Ayakulik,1949,0,,233,1
Ayakulik,1949,0,,234,1
Ayakulik,1949,0,,235,1
Ayakulik,1949,0,,236,1
Ayakulik,1949,0,,237,1
Ayakulik,1949,0,,238,1
Ayakulik,1949,0,,239,1
Ayakulik,1949,0,,240,1
Ayakulik,1949,0,,241,1
Ayakulik,1949,0,,242,1
Ayakulik,1949,1,,243,2
Ayakulik,1949,0,,244,2
Ayakulik,1949,0,,245,2
Ayakulik,1949,0,,246,2
Ayakulik,1949,0,,247,2
Ayakulik,1949,0,,248,2
Ayakulik,1949,0,,249,2
Ayakulik,1949,0,,250,2
Ayakulik,1949,0,,251,2
Ayakulik,1949,0,,252,2
Ayakulik,1949,0,,253,2
Ayakulik,1949,0,,254,2
Ayakulik,1949,0,,255,2
Ayakulik,1949,0,,256,2
Ayakulik,1949,0,,257,2
Ayakulik,1949,0,,258,2
Ayakulik,1949,0,,259,2
Ayakulik,1949,0,,260,2
Ayakulik,1949,0,,261,2
Ayakulik,1949,0,,262,2
Ayakulik,1949,0,,263,2
Ayakulik,1949,0,,264,2
Ayakulik,1949,0,,265,2
Ayakulik,1949,0,,266,2
Ayakulik,1949,0,,267,2
Ayakulik,1949,0,,268,2
Ayakulik,1949,0,,269,2
Ayakulik,1949,0,,270,2
Ayakulik,1949,0,,271,2
Ayakulik,1949,0,,272,2
Ayakulik,1949,0,,273,2
Ayakulik,1948,0,,153,0
Ayakulik,1948,0,,154,0
Ayakulik,1948,0,,155,0
Ayakulik,1948,0,,156,0
Ayakulik,1948,0,,157,0
Ayakulik,1948,0,,158,0
Ayakulik,1948,0,,159,0
Ayakulik,1948,0,,160,0
Ayakulik,1948,0,,161,0
Ayakulik,1948,0,,162,0
Ayakulik,1948,0,,163,0
Ayakulik,1948,0,,164,0
Ayakulik,1948,0,,165,0
Ayakulik,1948,0,,166,0
Ayakulik,1948,0,,167,0
Ayakulik,1948,0,,168,0
Ayakulik,1948,0,,169,0
Ayakulik,1948,0,,170,0
Ayakulik,1948,0,,171,0
Ayakulik,1948,0,,172,0
Ayakulik,1948,0,,173,0
Ayakulik,1948,0,,174,0
Ayakulik,1948,0,,175,0
Ayakulik,1948,0,,176,0
Ayakulik,1948,0,,177,0
Ayakulik,1948,0,,178,0
Ayakulik,1948,0,,179,0
Ayakulik,1948,0,,180,0
Ayakulik,1948,0,,181,0
Ayakulik,1948,0,,182,0
Ayakulik,1948,0,,183,0
Ayakulik,1948,0,,184,0
Ayakulik,1948,0,,185,0
Ayakulik,1948,0,,186,0
Ayakulik,1948,0,,187,0
Ayakulik,1948,0,,188,0
Ayakulik,1948,0,,189,0
Ayakulik,1948,0,,190,0
Ayakulik,1948,0,,191,0
Ayakulik,1948,0,,192,0
Ayakulik,1948,0,,193,0
Ayakulik,1948,0,,194,0
Ayakulik,1948,0,,195,0
Ayakulik,1948,0,,196,0
Ayakulik,1948,0,,197,0
Ayakulik,1948,0,,198,0
Ayakulik,1948,0,,199,0
Ayakulik,1948,0,,200,0
Ayakulik,1948,0,,201,0
Ayakulik,1948,0,,202,0
Ayakulik,1948,0,,203,0
Ayakulik,1948,0,,204,0
Ayakulik,1948,0,,205,0
Ayakulik,1948,0,,206,0
Ayakulik,1948,0,,207,0
Ayakulik,1948,72,,208,72
Ayakulik,1948,0,,209,72
Ayakulik,1948,0,,210,72
Ayakulik,1948,3,,211,75
Ayakulik,1948,0,,212,75
Ayakulik,1948,0,,213,75
Ayakulik,1948,2,,214,77
Ayakulik,1948,0,,215,77
Ayakulik,1948,8,,216,85
Ayakulik,1948,29,,217,114
Ayakulik,1948,3905,,218,4019
Ayakulik,1948,1008,,219,5027
Ayakulik,1948,0,,220,5027
Ayakulik,1948,53,,221,5080
Ayakulik,1948,93,,222,5173
Ayakulik,1948,22,,223,5195
Ayakulik,1948,149,,224,5344
Ayakulik,1948,0,,225,5344
Ayakulik,1948,442,,226,5786
Ayakulik,1948,7727,,227,13513
Ayakulik,1948,21459,,228,34972
Ayakulik,1948,8377,,229,43349
Ayakulik,1948,4695,,230,48044
Ayakulik,1948,728,,231,48772
Ayakulik,1948,938,,232,49710
Ayakulik,1948,1130,,233,50840
Ayakulik,1948,721,,234,51561
Ayakulik,1948,882,,235,52443
Ayakulik,1948,3823,,236,56266
Ayakulik,1948,3318,,237,59584
Ayakulik,1948,1916,,238,61500
Ayakulik,1948,1187,,239,62687
Ayakulik,1948,675,,240,63362
Ayakulik,1948,223,,241,63585
Ayakulik,1948,408,,242,63993
Ayakulik,1948,1140,,243,65133
Ayakulik,1948,711,,244,65844
Ayakulik,1948,873,,245,66717
Ayakulik,1948,517,,246,67234
Ayakulik,1948,377,,247,67611
Ayakulik,1948,486,,248,68097
Ayakulik,1948,266,,249,68363
Ayakulik,1948,341,,250,68704
Ayakulik,1948,174,,251,68878
Ayakulik,1948,62,,252,68940
Ayakulik,1948,51,,253,68991
Ayakulik,1948,64,,254,69055
Ayakulik,1948,41,,255,69096
Ayakulik,1948,8,,256,69104
Ayakulik,1948,3,,257,69107
Ayakulik,1948,1,,258,69108
Ayakulik,1948,0,,259,69108
Ayakulik,1948,0,,260,69108
Ayakulik,1948,0,,261,69108
Ayakulik,1948,0,,262,69108
Ayakulik,1948,0,,263,69108
Ayakulik,1948,0,,264,69108
Ayakulik,1948,0,,265,69108
Ayakulik,1948,0,,266,69108
Ayakulik,1948,0,,267,69108
Ayakulik,1948,0,,268,69108
Ayakulik,1948,0,,269,69108
Ayakulik,1948,0,,270,69108
Ayakulik,1948,0,,271,69108
Ayakulik,1948,0,,272,69108
Ayakulik,1948,0,,273,69108
Ayakulik,1948,0,,274,69108
Ayakulik,1946,0,,152,0
Ayakulik,1946,0,,153,0
Ayakulik,1946,0,,154,0
Ayakulik,1946,0,,155,0
Ayakulik,1946,0,,156,0
Ayakulik,1946,0,,157,0
Ayakulik,1946,0,,158,0
Ayakulik,1946,0,,159,0
Ayakulik,1946,0,,160,0
Ayakulik,1946,0,,161,0
Ayakulik,1946,0,,162,0
Ayakulik,1946,0,,163,0
Ayakulik,1946,0,,164,0
Ayakulik,1946,0,,165,0
Ayakulik,1946,0,,166,0
Ayakulik,1946,0,,167,0
Ayakulik,1946,0,,168,0
Ayakulik,1946,0,,169,0
Ayakulik,1946,0,,170,0
Ayakulik,1946,0,,171,0
Ayakulik,1946,0,,172,0
Ayakulik,1946,0,,173,0
Ayakulik,1946,0,,174,0
Ayakulik,1946,0,,175,0
Ayakulik,1946,0,,176,0
Ayakulik,1946,0,,177,0
Ayakulik,1946,0,,178,0
Ayakulik,1946,0,,179,0
Ayakulik,1946,0,,180,0
Ayakulik,1946,0,,181,0
Ayakulik,1946,0,,182,0
Ayakulik,1946,0,,183,0
Ayakulik,1946,0,,184,0
Ayakulik,1946,0,,185,0
Ayakulik,1946,0,,186,0
Ayakulik,1946,0,,187,0
Ayakulik,1946,0,,188,0
Ayakulik,1946,0,,189,0
Ayakulik,1946,0,,190,0
Ayakulik,1946,0,,191,0
Ayakulik,1946,0,,192,0
Ayakulik,1946,42,,193,42
Ayakulik,1946,101,,194,143
Ayakulik,1946,346,,195,489
Ayakulik,1946,203,,196,692
Ayakulik,1946,527,,197,1219
Ayakulik,1946,1113,,198,2332
Ayakulik,1946,1624,,199,3956
Ayakulik,1946,4583,,200,8539
Ayakulik,1946,3856,,201,12395
Ayakulik,1946,2090,,202,14485
Ayakulik,1946,135,,203,14620
Ayakulik,1946,5445,,204,20065
Ayakulik,1946,7204,,205,27269
Ayakulik,1946,9320,,206,36589
Ayakulik,1946,9461,,207,46050
Ayakulik,1946,33926,,208,79976
Ayakulik,1946,25365,,209,105341
Ayakulik,1946,6182,,210,111523
Ayakulik,1946,1102,,211,112625
Ayakulik,1946,43089,,212,155714
Ayakulik,1946,45684,,213,201398
Ayakulik,1946,9000,,214,210398
Ayakulik,1946,1503,,215,211901
Ayakulik,1946,57612,,216,269513
Ayakulik,1946,40072,,217,309585
Ayakulik,1946,11124,,218,320709
Ayakulik,1946,9580,,219,330289
Ayakulik,1946,32763,,220,363052
Ayakulik,1946,3157,,221,366209
Ayakulik,1946,7701,,222,373910
Ayakulik,1946,4035,,223,377945
Ayakulik,1946,2588,,224,380533
Ayakulik,1946,1957,,225,382490
Ayakulik,1946,5368,,226,387858
Ayakulik,1946,6000,,227,393858
Ayakulik,1946,0,,228,393858
Ayakulik,1946,5000,,229,398858
Ayakulik,1946,1562,,230,400420
Ayakulik,1946,0,,231,400420
Ayakulik,1946,0,,232,400420
Ayakulik,1946,0,,233,400420
Ayakulik,1946,0,,234,400420
Ayakulik,1946,0,,235,400420
Ayakulik,1946,0,,236,400420
Ayakulik,1946,0,,237,400420
Ayakulik,1946,0,,238,400420
Ayakulik,1946,0,,239,400420
Ayakulik,1946,0,,240,400420
Ayakulik,1946,0,,241,400420
Ayakulik,1946,0,,242,400420
Ayakulik,1946,0,,243,400420
Ayakulik,1946,0,,244,400420
Ayakulik,1946,0,,245,400420
Ayakulik,1946,0,,246,400420
Ayakulik,1946,0,,247,400420
Ayakulik,1946,0,,248,400420
Ayakulik,1946,0,,249,400420
Ayakulik,1946,0,,250,400420
Ayakulik,1946,0,,251,400420
Ayakulik,1946,0,,252,400420
Ayakulik,1946,0,,253,400420
Ayakulik,1946,0,,254,400420
Ayakulik,1946,0,,255,400420
Ayakulik,1946,0,,256,400420
Ayakulik,1946,0,,257,400420
Ayakulik,1946,0,,258,400420
Ayakulik,1946,0,,259,400420
Ayakulik,1946,0,,260,400420
Ayakulik,1946,0,,261,400420
Ayakulik,1946,0,,262,400420
Ayakulik,1946,0,,263,400420
Ayakulik,1946,0,,264,400420
Ayakulik,1946,0,,265,400420
Ayakulik,1946,0,,266,400420
Ayakulik,1946,0,,267,400420
Ayakulik,1946,0,,268,400420
Ayakulik,1946,0,,269,400420
Ayakulik,1946,0,,270,400420
Ayakulik,1946,0,,271,400420
Ayakulik,1946,0,,272,400420
Ayakulik,1946,0,,273,400420
Ayakulik,1945,0,,152,0
Ayakulik,1945,0,,153,0
Ayakulik,1945,0,,154,0
Ayakulik,1945,0,,155,0
Ayakulik,1945,0,,156,0
Ayakulik,1945,0,,157,0
Ayakulik,1945,0,,158,0
Ayakulik,1945,0,,159,0
Ayakulik,1945,0,,160,0
Ayakulik,1945,0,,161,0
Ayakulik,1945,0,,162,0
Ayakulik,1945,0,,163,0
Ayakulik,1945,0,,164,0
Ayakulik,1945,0,,165,0
Ayakulik,1945,0,,166,0
Ayakulik,1945,0,,167,0
Ayakulik,1945,0,,168,0
Ayakulik,1945,0,,169,0
Ayakulik,1945,0,,170,0
Ayakulik,1945,0,,171,0
Ayakulik,1945,0,,172,0
Ayakulik,1945,0,,173,0
Ayakulik,1945,0,,174,0
Ayakulik,1945,0,,175,0
Ayakulik,1945,0,,176,0
Ayakulik,1945,0,,177,0
Ayakulik,1945,0,,178,0
Ayakulik,1945,0,,179,0
Ayakulik,1945,0,,180,0
Ayakulik,1945,0,,181,0
Ayakulik,1945,0,,182,0
Ayakulik,1945,0,,183,0
Ayakulik,1945,0,,184,0
Ayakulik,1945,0,,185,0
Ayakulik,1945,0,,186,0
Ayakulik,1945,0,,187,0
Ayakulik,1945,0,,188,0
Ayakulik,1945,0,,189,0
Ayakulik,1945,0,,190,0
Ayakulik,1945,0,,191,0
Ayakulik,1945,0,,192,0
Ayakulik,1945,0,,193,0
Ayakulik,1945,0,,194,0
Ayakulik,1945,0,,195,0
Ayakulik,1945,0,,196,0
Ayakulik,1945,0,,197,0
Ayakulik,1945,122,,198,122
Ayakulik,1945,48,,199,170
Ayakulik,1945,4,,200,174
Ayakulik,1945,35,,201,209
Ayakulik,1945,2,,202,211
Ayakulik,1945,0,,203,211
Ayakulik,1945,0,,204,211
Ayakulik,1945,112,,205,323
Ayakulik,1945,252,,206,575
Ayakulik,1945,169,,207,744
Ayakulik,1945,37,,208,781
Ayakulik,1945,83,,209,864
Ayakulik,1945,95,,210,959
Ayakulik,1945,22,,211,981
Ayakulik,1945,47,,212,1028
Ayakulik,1945,71,,213,1099
Ayakulik,1945,192,,214,1291
Ayakulik,1945,7,,215,1298
Ayakulik,1945,190,,216,1488
Ayakulik,1945,300,,217,1788
Ayakulik,1945,76,,218,1864
Ayakulik,1945,18,,219,1882
Ayakulik,1945,11,,220,1893
Ayakulik,1945,9,,221,1902
Ayakulik,1945,8,,222,1910
Ayakulik,1945,0,,223,1910
Ayakulik,1945,0,,224,1910
Ayakulik,1945,0,,225,1910
Ayakulik,1945,0,,226,1910
Ayakulik,1945,0,,227,1910
Ayakulik,1945,0,,228,1910
Ayakulik,1945,0,,229,1910
Ayakulik,1945,0,,230,1910
Ayakulik,1945,0,,231,1910
Ayakulik,1945,0,,232,1910
Ayakulik,1945,0,,233,1910
Ayakulik,1945,0,,234,1910
Ayakulik,1945,0,,235,1910
Ayakulik,1945,0,,236,1910
Ayakulik,1945,0,,237,1910
Ayakulik,1945,0,,238,1910
Ayakulik,1945,0,,239,1910
Ayakulik,1945,0,,240,1910
Ayakulik,1945,0,,241,1910
Ayakulik,1945,0,,242,1910
Ayakulik,1945,0,,243,1910
Ayakulik,1945,0,,244,1910
Ayakulik,1945,0,,245,1910
Ayakulik,1945,0,,246,1910
Ayakulik,1945,0,,247,1910
Ayakulik,1945,0,,248,1910
Ayakulik,1945,0,,249,1910
Ayakulik,1945,0,,250,1910
Ayakulik,1945,0,,251,1910
Ayakulik,1945,0,,252,1910
Ayakulik,1945,0,,253,1910
Ayakulik,1945,0,,254,1910
Ayakulik,1945,0,,255,1910
Ayakulik,1945,0,,256,1910
Ayakulik,1945,0,,257,1910
Ayakulik,1945,0,,258,1910
Ayakulik,1945,0,,259,1910
Ayakulik,1945,0,,260,1910
Ayakulik,1945,0,,261,1910
Ayakulik,1945,0,,262,1910
Ayakulik,1945,0,,263,1910
Ayakulik,1945,0,,264,1910
Ayakulik,1945,0,,265,1910
Ayakulik,1945,0,,266,1910
Ayakulik,1945,0,,267,1910
Ayakulik,1945,0,,268,1910
Ayakulik,1945,0,,269,1910
Ayakulik,1945,0,,270,1910
Ayakulik,1945,0,,271,1910
Ayakulik,1945,0,,272,1910
Ayakulik,1945,0,,273,1910
Ayakulik,1942,0,,152,0
Ayakulik,1942,0,,153,0
Ayakulik,1942,0,,154,0
Ayakulik,1942,0,,155,0
Ayakulik,1942,0,,156,0
Ayakulik,1942,0,,157,0
Ayakulik,1942,0,,158,0
Ayakulik,1942,0,,159,0
Ayakulik,1942,0,,160,0
Ayakulik,1942,0,,161,0
Ayakulik,1942,0,,162,0
Ayakulik,1942,0,,163,0
Ayakulik,1942,0,,164,0
Ayakulik,1942,0,,165,0
Ayakulik,1942,0,,166,0
Ayakulik,1942,0,,167,0
Ayakulik,1942,0,,168,0
Ayakulik,1942,0,,169,0
Ayakulik,1942,0,,170,0
Ayakulik,1942,0,,171,0
Ayakulik,1942,0,,172,0
Ayakulik,1942,0,,173,0
Ayakulik,1942,0,,174,0
Ayakulik,1942,0,,175,0
Ayakulik,1942,0,,176,0
Ayakulik,1942,0,,177,0
Ayakulik,1942,0,,178,0
Ayakulik,1942,0,,179,0
Ayakulik,1942,0,,180,0
Ayakulik,1942,0,,181,0
Ayakulik,1942,0,,182,0
Ayakulik,1942,0,,183,0
Ayakulik,1942,0,,184,0
Ayakulik,1942,0,,185,0
Ayakulik,1942,0,,186,0
Ayakulik,1942,0,,187,0
Ayakulik,1942,0,,188,0
Ayakulik,1942,2,,189,2
Ayakulik,1942,8,,190,10
Ayakulik,1942,24,,191,34
Ayakulik,1942,54,,192,88
Ayakulik,1942,115,,193,203
Ayakulik,1942,495,,194,698
Ayakulik,1942,798,,195,1496
Ayakulik,1942,833,,196,2329
Ayakulik,1942,862,,197,3191
Ayakulik,1942,2481,,198,5672
Ayakulik,1942,3598,,199,9270
Ayakulik,1942,4237,,200,13507
Ayakulik,1942,8025,,201,21532
Ayakulik,1942,6564,,202,28096
Ayakulik,1942,13900,,203,41996
Ayakulik,1942,9910,,204,51906
Ayakulik,1942,8340,,205,60246
Ayakulik,1942,18422,,206,78668
Ayakulik,1942,31163,,207,109831
Ayakulik,1942,37947,,208,147778
Ayakulik,1942,41366,,209,189144
Ayakulik,1942,22152,,210,211296
Ayakulik,1942,51248,,211,262544
Ayakulik,1942,26441,,212,288985
Ayakulik,1942,32759,,213,321744
Ayakulik,1942,53365,,214,375109
Ayakulik,1942,56421,,215,431530
Ayakulik,1942,54126,,216,485656
Ayakulik,1942,43814,,217,529470
Ayakulik,1942,32536,,218,562006
Ayakulik,1942,31606,,219,593612
Ayakulik,1942,22752,,220,616364
Ayakulik,1942,27841,,221,644205
Ayakulik,1942,12765,,222,656970
Ayakulik,1942,19580,,223,676550
Ayakulik,1942,18851,,224,695401
Ayakulik,1942,22328,,225,717729
Ayakulik,1942,19430,,226,737159
Ayakulik,1942,14270,,227,751429
Ayakulik,1942,8521,,228,759950
Ayakulik,1942,4987,,229,764937
Ayakulik,1942,3628,,230,768565
Ayakulik,1942,2316,,231,770881
Ayakulik,1942,2572,,232,773453
Ayakulik,1942,3360,,233,776813
Ayakulik,1942,2840,,234,779653
Ayakulik,1942,0,,235,779653
Ayakulik,1942,0,,236,779653
Ayakulik,1942,0,,237,779653
Ayakulik,1942,0,,238,779653
Ayakulik,1942,0,,239,779653
Ayakulik,1942,0,,240,779653
Ayakulik,1942,0,,241,779653
Ayakulik,1942,0,,242,779653
Ayakulik,1942,0,,243,779653
Ayakulik,1942,0,,244,779653
Ayakulik,1942,0,,245,779653
Ayakulik,1942,0,,246,779653
Ayakulik,1942,0,,247,779653
Ayakulik,1942,0,,248,779653
Ayakulik,1942,0,,249,779653
Ayakulik,1942,0,,250,779653
Ayakulik,1942,0,,251,779653
Ayakulik,1942,0,,252,779653
Ayakulik,1942,0,,253,779653
Ayakulik,1942,0,,254,779653
Ayakulik,1942,0,,255,779653
Ayakulik,1942,0,,256,779653
Ayakulik,1942,0,,257,779653
Ayakulik,1942,0,,258,779653
Ayakulik,1942,0,,259,779653
Ayakulik,1942,0,,260,779653
Ayakulik,1942,0,,261,779653
Ayakulik,1942,0,,262,779653
Ayakulik,1942,0,,263,779653
Ayakulik,1942,0,,264,779653
Ayakulik,1942,0,,265,779653
Ayakulik,1942,0,,266,779653
Ayakulik,1942,0,,267,779653
Ayakulik,1942,0,,268,779653
Ayakulik,1942,0,,269,779653
Ayakulik,1942,0,,270,779653
Ayakulik,1942,0,,271,779653
Ayakulik,1942,0,,272,779653
Ayakulik,1942,0,,273,779653
Ayakulik,1941,0,,152,0
Ayakulik,1941,0,,153,0
Ayakulik,1941,0,,154,0
Ayakulik,1941,0,,155,0
Ayakulik,1941,0,,156,0
Ayakulik,1941,0,,157,0
Ayakulik,1941,0,,158,0
Ayakulik,1941,0,,159,0
Ayakulik,1941,0,,160,0
Ayakulik,1941,0,,161,0
Ayakulik,1941,0,,162,0
Ayakulik,1941,0,,163,0
Ayakulik,1941,0,,164,0
Ayakulik,1941,0,,165,0
Ayakulik,1941,0,,166,0
Ayakulik,1941,0,,167,0
Ayakulik,1941,0,,168,0
Ayakulik,1941,0,,169,0
Ayakulik,1941,0,,170,0
Ayakulik,1941,0,,171,0
Ayakulik,1941,0,,172,0
Ayakulik,1941,0,,173,0
Ayakulik,1941,0,,174,0
Ayakulik,1941,0,,175,0
Ayakulik,1941,0,,176,0
Ayakulik,1941,0,,177,0
Ayakulik,1941,0,,178,0
Ayakulik,1941,0,,179,0
Ayakulik,1941,0,,180,0
Ayakulik,1941,0,,181,0
Ayakulik,1941,0,,182,0
Ayakulik,1941,0,,183,0
Ayakulik,1941,0,,184,0
Ayakulik,1941,0,,185,0
Ayakulik,1941,0,,186,0
Ayakulik,1941,0,,187,0
Ayakulik,1941,0,,188,0
Ayakulik,1941,0,,189,0
Ayakulik,1941,168,,190,168
Ayakulik,1941,250,,191,418
Ayakulik,1941,608,,192,1026
Ayakulik,1941,430,,193,1456
Ayakulik,1941,514,,194,1970
Ayakulik,1941,1139,,195,3109
Ayakulik,1941,1191,,196,4300
Ayakulik,1941,340,,197,4640
Ayakulik,1941,209,,198,4849
Ayakulik,1941,151,,199,5000
Ayakulik,1941,104,,200,5104
Ayakulik,1941,491,,201,5595
Ayakulik,1941,406,,202,6001
Ayakulik,1941,139,,203,6140
Ayakulik,1941,1342,,204,7482
Ayakulik,1941,115,,205,7597
Ayakulik,1941,930,,206,8527
Ayakulik,1941,398,,207,8925
Ayakulik,1941,609,,208,9534
Ayakulik,1941,389,,209,9923
Ayakulik,1941,190,,210,10113
Ayakulik,1941,240,,211,10353
Ayakulik,1941,322,,212,10675
Ayakulik,1941,613,,213,11288
Ayakulik,1941,299,,214,11587
Ayakulik,1941,611,,215,12198
Ayakulik,1941,329,,216,12527
Ayakulik,1941,530,,217,13057
Ayakulik,1941,517,,218,13574
Ayakulik,1941,623,,219,14197
Ayakulik,1941,715,,220,14912
Ayakulik,1941,606,,221,15518
Ayakulik,1941,504,,222,16022
Ayakulik,1941,729,,223,16751
Ayakulik,1941,307,,224,17058
Ayakulik,1941,441,,225,17499
Ayakulik,1941,281,,226,17780
Ayakulik,1941,186,,227,17966
Ayakulik,1941,418,,228,18384
Ayakulik,1941,322,,229,18706
Ayakulik,1941,542,,230,19248
Ayakulik,1941,300,,231,19548
Ayakulik,1941,200,,232,19748
Ayakulik,1941,0,,233,19748
Ayakulik,1941,0,,234,19748
Ayakulik,1941,0,,235,19748
Ayakulik,1941,0,,236,19748
Ayakulik,1941,0,,237,19748
Ayakulik,1941,0,,238,19748
Ayakulik,1941,0,,239,19748
Ayakulik,1941,0,,240,19748
Ayakulik,1941,0,,241,19748
Ayakulik,1941,0,,242,19748
Ayakulik,1941,0,,243,19748
Ayakulik,1941,0,,244,19748
Ayakulik,1941,0,,245,19748
Ayakulik,1941,0,,246,19748
Ayakulik,1941,0,,247,19748
Ayakulik,1941,0,,248,19748
Ayakulik,1941,0,,249,19748
Ayakulik,1941,0,,250,19748
Ayakulik,1941,0,,251,19748
Ayakulik,1941,0,,252,19748
Ayakulik,1941,0,,253,19748
Ayakulik,1941,0,,254,19748
Ayakulik,1941,0,,255,19748
Ayakulik,1941,0,,256,19748
Ayakulik,1941,0,,257,19748
Ayakulik,1941,0,,258,19748
Ayakulik,1941,0,,259,19748
Ayakulik,1941,0,,260,19748
Ayakulik,1941,0,,261,19748
Ayakulik,1941,0,,262,19748
Ayakulik,1941,0,,263,19748
Ayakulik,1941,0,,264,19748
Ayakulik,1941,0,,265,19748
Ayakulik,1941,0,,266,19748
Ayakulik,1941,0,,267,19748
Ayakulik,1941,0,,268,19748
Ayakulik,1941,0,,269,19748
Ayakulik,1941,0,,270,19748
Ayakulik,1941,0,,271,19748
Ayakulik,1941,0,,272,19748
Ayakulik,1941,0,,273,19748
Ayakulik,1940,0,,153,0
Ayakulik,1940,0,,154,0
Ayakulik,1940,0,,155,0
Ayakulik,1940,0,,156,0
Ayakulik,1940,0,,157,0
Ayakulik,1940,0,,158,0
Ayakulik,1940,0,,159,0
Ayakulik,1940,0,,160,0
Ayakulik,1940,0,,161,0
Ayakulik,1940,0,,162,0
Ayakulik,1940,0,,163,0
Ayakulik,1940,0,,164,0
Ayakulik,1940,0,,165,0
Ayakulik,1940,0,,166,0
Ayakulik,1940,0,,167,0
Ayakulik,1940,0,,168,0
Ayakulik,1940,0,,169,0
Ayakulik,1940,0,,170,0
Ayakulik,1940,0,,171,0
Ayakulik,1940,0,,172,0
Ayakulik,1940,0,,173,0
Ayakulik,1940,0,,174,0
Ayakulik,1940,0,,175,0
Ayakulik,1940,0,,176,0
Ayakulik,1940,0,,177,0
Ayakulik,1940,0,,178,0
Ayakulik,1940,0,,179,0
Ayakulik,1940,0,,180,0
Ayakulik,1940,0,,181,0
Ayakulik,1940,0,,182,0
Ayakulik,1940,0,,183,0
Ayakulik,1940,0,,184,0
Ayakulik,1940,0,,185,0
Ayakulik,1940,0,,186,0
Ayakulik,1940,0,,187,0
Ayakulik,1940,0,,188,0
Ayakulik,1940,0,,189,0
Ayakulik,1940,0,,190,0
Ayakulik,1940,0,,191,0
Ayakulik,1940,0,,192,0
Ayakulik,1940,0,,193,0
Ayakulik,1940,0,,194,0
Ayakulik,1940,0,,195,0
Ayakulik,1940,5332,,196,5332
Ayakulik,1940,10039,,197,15371
Ayakulik,1940,16292,,198,31663
Ayakulik,1940,6391,,199,38054
Ayakulik,1940,14564,,200,52618
Ayakulik,1940,31238,,201,83856
Ayakulik,1940,18567,,202,102423
Ayakulik,1940,29874,,203,132297
Ayakulik,1940,42651,,204,174948
Ayakulik,1940,55473,,205,230421
Ayakulik,1940,62747,,206,293168
Ayakulik,1940,53834,,207,347002
Ayakulik,1940,56090,,208,403092
Ayakulik,1940,35657,,209,438749
Ayakulik,1940,23114,,210,461863
Ayakulik,1940,28565,,211,490428
Ayakulik,1940,66037,,212,556465
Ayakulik,1940,30318,,213,586783
Ayakulik,1940,39642,,214,626425
Ayakulik,1940,38721,,215,665146
Ayakulik,1940,15493,,216,680639
Ayakulik,1940,25826,,217,706465
Ayakulik,1940,16830,,218,723295
Ayakulik,1940,8383,,219,731678
Ayakulik,1940,4568,,220,736246
Ayakulik,1940,5000,,221,741246
Ayakulik,1940,4281,,222,745527
Ayakulik,1940,2497,,223,748024
Ayakulik,1940,5620,,224,753644
Ayakulik,1940,1860,,225,755504
Ayakulik,1940,4980,,226,760484
Ayakulik,1940,3521,,227,764005
Ayakulik,1940,0,,228,764005
Ayakulik,1940,0,,229,764005
Ayakulik,1940,0,,230,764005
Ayakulik,1940,0,,231,764005
Ayakulik,1940,0,,232,764005
Ayakulik,1940,0,,233,764005
Ayakulik,1940,0,,234,764005
Ayakulik,1940,0,,235,764005
Ayakulik,1940,0,,236,764005
Ayakulik,1940,0,,237,764005
Ayakulik,1940,0,,238,764005
Ayakulik,1940,0,,239,764005
Ayakulik,1940,0,,240,764005
Ayakulik,1940,0,,241,764005
Ayakulik,1940,0,,242,764005
Ayakulik,1940,0,,243,764005
Ayakulik,1940,0,,244,764005
Ayakulik,1940,0,,245,764005
Ayakulik,1940,0,,246,764005
Ayakulik,1940,0,,247,764005
Ayakulik,1940,0,,248,764005
Ayakulik,1940,0,,249,764005
Ayakulik,1940,0,,250,764005
Ayakulik,1940,0,,251,764005
Ayakulik,1940,0,,252,764005
Ayakulik,1940,0,,253,764005
Ayakulik,1940,0,,254,764005
Ayakulik,1940,0,,255,764005
Ayakulik,1940,0,,256,764005
Ayakulik,1940,0,,257,764005
Ayakulik,1940,0,,258,764005
Ayakulik,1940,0,,259,764005
Ayakulik,1940,0,,260,764005
Ayakulik,1940,0,,261,764005
Ayakulik,1940,0,,262,764005
Ayakulik,1940,0,,263,764005
Ayakulik,1940,0,,264,764005
Ayakulik,1940,0,,265,764005
Ayakulik,1940,0,,266,764005
Ayakulik,1940,0,,267,764005
Ayakulik,1940,0,,268,764005
Ayakulik,1940,0,,269,764005
Ayakulik,1940,0,,270,764005
Ayakulik,1940,0,,271,764005
Ayakulik,1940,0,,272,764005
Ayakulik,1940,0,,273,764005
Ayakulik,1940,0,,274,764005
Ayakulik,1939,0,,152,0
Ayakulik,1939,0,,153,0
Ayakulik,1939,0,,154,0
Ayakulik,1939,0,,155,0
Ayakulik,1939,0,,156,0
Ayakulik,1939,0,,157,0
Ayakulik,1939,0,,158,0
Ayakulik,1939,0,,159,0
Ayakulik,1939,0,,160,0
Ayakulik,1939,0,,161,0
Ayakulik,1939,0,,162,0
Ayakulik,1939,0,,163,0
Ayakulik,1939,0,,164,0
Ayakulik,1939,0,,165,0
Ayakulik,1939,0,,166,0
Ayakulik,1939,0,,167,0
Ayakulik,1939,0,,168,0
Ayakulik,1939,0,,169,0
Ayakulik,1939,0,,170,0
Ayakulik,1939,0,,171,0
Ayakulik,1939,0,,172,0
Ayakulik,1939,0,,173,0
Ayakulik,1939,0,,174,0
Ayakulik,1939,0,,175,0
Ayakulik,1939,0,,176,0
Ayakulik,1939,0,,177,0
Ayakulik,1939,0,,178,0
Ayakulik,1939,0,,179,0
Ayakulik,1939,0,,180,0
Ayakulik,1939,0,,181,0
Ayakulik,1939,0,,182,0
Ayakulik,1939,0,,183,0
Ayakulik,1939,0,,184,0
Ayakulik,1939,0,,185,0
Ayakulik,1939,0,,186,0
Ayakulik,1939,0,,187,0
Ayakulik,1939,0,,188,0
Ayakulik,1939,0,,189,0
Ayakulik,1939,0,,190,0
Ayakulik,1939,0,,191,0
Ayakulik,1939,0,,192,0
Ayakulik,1939,31,,193,31
Ayakulik,1939,38,,194,69
Ayakulik,1939,8,,195,77
Ayakulik,1939,0,,196,77
Ayakulik,1939,40,,197,117
Ayakulik,1939,32,,198,149
Ayakulik,1939,91,,199,240
Ayakulik,1939,52,,200,292
Ayakulik,1939,20,,201,312
Ayakulik,1939,14,,202,326
Ayakulik,1939,7,,203,333
Ayakulik,1939,61,,204,394
Ayakulik,1939,115,,205,509
Ayakulik,1939,61,,206,570
Ayakulik,1939,14,,207,584
Ayakulik,1939,52,,208,636
Ayakulik,1939,76,,209,712
Ayakulik,1939,37,,210,749
Ayakulik,1939,67,,211,816
Ayakulik,1939,1065,,212,1881
Ayakulik,1939,297,,213,2178
Ayakulik,1939,95,,214,2273
Ayakulik,1939,498,,215,2771
Ayakulik,1939,165,,216,2936
Ayakulik,1939,80,,217,3016
Ayakulik,1939,165,,218,3181
Ayakulik,1939,123,,219,3304
Ayakulik,1939,315,,220,3619
Ayakulik,1939,275,,221,3894
Ayakulik,1939,12,,222,3906
Ayakulik,1939,92,,223,3998
Ayakulik,1939,33,,224,4031
Ayakulik,1939,221,,225,4252
Ayakulik,1939,176,,226,4428
Ayakulik,1939,537,,227,4965
Ayakulik,1939,459,,228,5424
Ayakulik,1939,117,,229,5541
Ayakulik,1939,73,,230,5614
Ayakulik,1939,35,,231,5649
Ayakulik,1939,0,,232,5649
Ayakulik,1939,0,,233,5649
Ayakulik,1939,0,,234,5649
Ayakulik,1939,0,,235,5649
Ayakulik,1939,0,,236,5649
Ayakulik,1939,0,,237,5649
Ayakulik,1939,0,,238,5649
Ayakulik,1939,0,,239,5649
Ayakulik,1939,0,,240,5649
Ayakulik,1939,0,,241,5649
Ayakulik,1939,0,,242,5649
Ayakulik,1939,0,,243,5649
Ayakulik,1939,0,,244,5649
Ayakulik,1939,0,,245,5649
Ayakulik,1939,0,,246,5649
Ayakulik,1939,0,,247,5649
Ayakulik,1939,0,,248,5649
Ayakulik,1939,0,,249,5649
Ayakulik,1939,0,,250,5649
Ayakulik,1939,0,,251,5649
Ayakulik,1939,0,,252,5649
Ayakulik,1939,0,,253,5649
Ayakulik,1939,0,,254,5649
Ayakulik,1939,0,,255,5649
Ayakulik,1939,0,,256,5649
Ayakulik,1939,0,,257,5649
Ayakulik,1939,0,,258,5649
Ayakulik,1939,0,,259,5649
Ayakulik,1939,0,,260,5649
Ayakulik,1939,0,,261,5649
Ayakulik,1939,0,,262,5649
Ayakulik,1939,0,,263,5649
Ayakulik,1939,0,,264,5649
Ayakulik,1939,0,,265,5649
Ayakulik,1939,0,,266,5649
Ayakulik,1939,0,,267,5649
Ayakulik,1939,0,,268,5649
Ayakulik,1939,0,,269,5649
Ayakulik,1939,0,,270,5649
Ayakulik,1939,0,,271,5649
Ayakulik,1939,0,,272,5649
Ayakulik,1939,0,,273,5649
Ayakulik,1938,0,,152,0
Ayakulik,1938,0,,153,0
Ayakulik,1938,0,,154,0
Ayakulik,1938,0,,155,0
Ayakulik,1938,0,,156,0
Ayakulik,1938,0,,157,0
Ayakulik,1938,0,,158,0
Ayakulik,1938,0,,159,0
Ayakulik,1938,0,,160,0
Ayakulik,1938,0,,161,0
Ayakulik,1938,0,,162,0
Ayakulik,1938,0,,163,0
Ayakulik,1938,0,,164,0
Ayakulik,1938,0,,165,0
Ayakulik,1938,0,,166,0
Ayakulik,1938,0,,167,0
Ayakulik,1938,0,,168,0
Ayakulik,1938,0,,169,0
Ayakulik,1938,0,,170,0
Ayakulik,1938,0,,171,0
Ayakulik,1938,0,,172,0
Ayakulik,1938,0,,173,0
Ayakulik,1938,0,,174,0
Ayakulik,1938,0,,175,0
Ayakulik,1938,0,,176,0
Ayakulik,1938,0,,177,0
Ayakulik,1938,0,,178,0
Ayakulik,1938,0,,179,0
Ayakulik,1938,0,,180,0
Ayakulik,1938,0,,181,0
Ayakulik,1938,0,,182,0
Ayakulik,1938,0,,183,0
Ayakulik,1938,0,,184,0
Ayakulik,1938,0,,185,0
Ayakulik,1938,0,,186,0
Ayakulik,1938,0,,187,0
Ayakulik,1938,0,,188,0
Ayakulik,1938,0,,189,0
Ayakulik,1938,0,,190,0
Ayakulik,1938,0,,191,0
Ayakulik,1938,0,,192,0
Ayakulik,1938,0,,193,0
Ayakulik,1938,0,,194,0
Ayakulik,1938,0,,195,0
Ayakulik,1938,0,,196,0
Ayakulik,1938,0,,197,0
Ayakulik,1938,3231,,198,3231
Ayakulik,1938,1870,,199,5101
Ayakulik,1938,6834,,200,11935
Ayakulik,1938,16582,,201,28517
Ayakulik,1938,15554,,202,44071
Ayakulik,1938,6409,,203,50480
Ayakulik,1938,13085,,204,63565
Ayakulik,1938,17008,,205,80573
Ayakulik,1938,11161,,206,91734
Ayakulik,1938,21585,,207,113319
Ayakulik,1938,18794,,208,132113
Ayakulik,1938,18851,,209,150964
Ayakulik,1938,31934,,210,182898
Ayakulik,1938,24000,,211,206898
Ayakulik,1938,27707,,212,234605
Ayakulik,1938,22627,,213,257232
Ayakulik,1938,17696,,214,274928
Ayakulik,1938,14650,,215,289578
Ayakulik,1938,12039,,216,301617
Ayakulik,1938,11165,,217,312782
Ayakulik,1938,13830,,218,326612
Ayakulik,1938,17387,,219,343999
Ayakulik,1938,6809,,220,350808
Ayakulik,1938,1926,,221,352734
Ayakulik,1938,11103,,222,363837
Ayakulik,1938,6795,,223,370632
Ayakulik,1938,3338,,224,373970
Ayakulik,1938,2987,,225,376957
Ayakulik,1938,3804,,226,380761
Ayakulik,1938,2218,,227,382979
Ayakulik,1938,3225,,228,386204
Ayakulik,1938,4257,,229,390461
Ayakulik,1938,1226,,230,391687
Ayakulik,1938,1851,,231,393538
Ayakulik,1938,1663,,232,395201
Ayakulik,1938,4051,,233,399252
Ayakulik,1938,4568,,234,403820
Ayakulik,1938,2029,,235,405849
Ayakulik,1938,1034,,236,406883
Ayakulik,1938,0,,237,406883
Ayakulik,1938,0,,238,406883
Ayakulik,1938,0,,239,406883
Ayakulik,1938,0,,240,406883
Ayakulik,1938,0,,241,406883
Ayakulik,1938,0,,242,406883
Ayakulik,1938,0,,243,406883
Ayakulik,1938,0,,244,406883
Ayakulik,1938,0,,245,406883
Ayakulik,1938,0,,246,406883
Ayakulik,1938,0,,247,406883
Ayakulik,1938,0,,248,406883
Ayakulik,1938,0,,249,406883
Ayakulik,1938,0,,250,406883
Ayakulik,1938,0,,251,406883
Ayakulik,1938,0,,252,406883
Ayakulik,1938,0,,253,406883
Ayakulik,1938,0,,254,406883
Ayakulik,1938,0,,255,406883
Ayakulik,1938,0,,256,406883
Ayakulik,1938,0,,257,406883
Ayakulik,1938,0,,258,406883
Ayakulik,1938,0,,259,406883
Ayakulik,1938,0,,260,406883
Ayakulik,1938,0,,261,406883
Ayakulik,1938,0,,262,406883
Ayakulik,1938,0,,263,406883
Ayakulik,1938,0,,264,406883
Ayakulik,1938,0,,265,406883
Ayakulik,1938,0,,266,406883
Ayakulik,1938,0,,267,406883
Ayakulik,1938,0,,268,406883
Ayakulik,1938,0,,269,406883
Ayakulik,1938,0,,270,406883
Ayakulik,1938,0,,271,406883
Ayakulik,1938,0,,272,406883
Ayakulik,1938,0,,273,406883
Ayakulik,1936,0,,153,0
Ayakulik,1936,0,,154,0
Ayakulik,1936,0,,155,0
Ayakulik,1936,0,,156,0
Ayakulik,1936,0,,157,0
Ayakulik,1936,0,,158,0
Ayakulik,1936,0,,159,0
Ayakulik,1936,0,,160,0
Ayakulik,1936,0,,161,0
Ayakulik,1936,0,,162,0
Ayakulik,1936,0,,163,0
Ayakulik,1936,0,,164,0
Ayakulik,1936,0,,165,0
Ayakulik,1936,0,,166,0
Ayakulik,1936,0,,167,0
Ayakulik,1936,0,,168,0
Ayakulik,1936,0,,169,0
Ayakulik,1936,0,,170,0
Ayakulik,1936,0,,171,0
Ayakulik,1936,0,,172,0
Ayakulik,1936,0,,173,0
Ayakulik,1936,0,,174,0
Ayakulik,1936,0,,175,0
Ayakulik,1936,0,,176,0
Ayakulik,1936,0,,177,0
Ayakulik,1936,0,,178,0
Ayakulik,1936,0,,179,0
Ayakulik,1936,0,,180,0
Ayakulik,1936,0,,181,0
Ayakulik,1936,0,,182,0
Ayakulik,1936,0,,183,0
Ayakulik,1936,0,,184,0
Ayakulik,1936,0,,185,0
Ayakulik,1936,0,,186,0
Ayakulik,1936,0,,187,0
Ayakulik,1936,0,,188,0
Ayakulik,1936,0,,189,0
Ayakulik,1936,1066,,190,1066
Ayakulik,1936,489,,191,1555
Ayakulik,1936,1811,,192,3366
Ayakulik,1936,1700,,193,5066
Ayakulik,1936,3890,,194,8956
Ayakulik,1936,2981,,195,11937
Ayakulik,1936,3174,,196,15111
Ayakulik,1936,3564,,197,18675
Ayakulik,1936,1888,,198,20563
Ayakulik,1936,931,,199,21494
Ayakulik,1936,1147,,200,22641
Ayakulik,1936,18654,,201,41295
Ayakulik,1936,20256,,202,61551
Ayakulik,1936,17664,,203,79215
Ayakulik,1936,5884,,204,85099
Ayakulik,1936,8778,,205,93877
Ayakulik,1936,4225,,206,98102
Ayakulik,1936,5115,,207,103217
Ayakulik,1936,6402,,208,109619
Ayakulik,1936,14659,,209,124278
Ayakulik,1936,10145,,210,134423
Ayakulik,1936,2529,,211,136952
Ayakulik,1936,2244,,212,139196
Ayakulik,1936,3537,,213,142733
Ayakulik,1936,3125,,214,145858
Ayakulik,1936,3558,,215,149416
Ayakulik,1936,6504,,216,155920
Ayakulik,1936,10018,,217,165938
Ayakulik,1936,11166,,218,177104
Ayakulik,1936,1584,,219,178688
Ayakulik,1936,2615,,220,181303
Ayakulik,1936,2017,,221,183320
Ayakulik,1936,1492,,222,184812
Ayakulik,1936,11448,,223,196260
Ayakulik,1936,10925,,224,207185
Ayakulik,1936,1706,,225,208891
Ayakulik,1936,992,,226,209883
Ayakulik,1936,5768,,227,215651
Ayakulik,1936,8016,,228,223667
Ayakulik,1936,966,,229,224633
Ayakulik,1936,600,,230,225233
Ayakulik,1936,0,,231,225233
Ayakulik,1936,0,,232,225233
Ayakulik,1936,0,,233,225233
Ayakulik,1936,0,,234,225233
Ayakulik,1936,0,,235,225233
Ayakulik,1936,0,,236,225233
Ayakulik,1936,0,,237,225233
Ayakulik,1936,0,,238,225233
Ayakulik,1936,0,,239,225233
Ayakulik,1936,0,,240,225233
Ayakulik,1936,0,,241,225233
Ayakulik,1936,0,,242,225233
Ayakulik,1936,0,,243,225233
Ayakulik,1936,0,,244,225233
Ayakulik,1936,0,,245,225233
Ayakulik,1936,0,,246,225233
Ayakulik,1936,0,,247,225233
Ayakulik,1936,0,,248,225233
Ayakulik,1936,0,,249,225233
Ayakulik,1936,0,,250,225233
Ayakulik,1936,0,,251,225233
Ayakulik,1936,0,,252,225233
Ayakulik,1936,0,,253,225233
Ayakulik,1936,0,,254,225233
Ayakulik,1936,0,,255,225233
Ayakulik,1936,0,,256,225233
Ayakulik,1936,0,,257,225233
Ayakulik,1936,0,,258,225233
Ayakulik,1936,0,,259,225233
Ayakulik,1936,0,,260,225233
Ayakulik,1936,0,,261,225233
Ayakulik,1936,0,,262,225233
Ayakulik,1936,0,,263,225233
Ayakulik,1936,0,,264,225233
Ayakulik,1936,0,,265,225233
Ayakulik,1936,0,,266,225233
Ayakulik,1936,0,,267,225233
Ayakulik,1936,0,,268,225233
Ayakulik,1936,0,,269,225233
Ayakulik,1936,0,,270,225233
Ayakulik,1936,0,,271,225233
Ayakulik,1936,0,,272,225233
Ayakulik,1936,0,,273,225233
Ayakulik,1936,0,,274,225233
Ayakulik,1935,0,,152,0
Ayakulik,1935,0,,153,0
Ayakulik,1935,0,,154,0
Ayakulik,1935,0,,155,0
Ayakulik,1935,0,,156,0
Ayakulik,1935,0,,157,0
Ayakulik,1935,0,,158,0
Ayakulik,1935,0,,159,0
Ayakulik,1935,0,,160,0
Ayakulik,1935,0,,161,0
Ayakulik,1935,0,,162,0
Ayakulik,1935,0,,163,0
Ayakulik,1935,0,,164,0
Ayakulik,1935,0,,165,0
Ayakulik,1935,0,,166,0
Ayakulik,1935,0,,167,0
Ayakulik,1935,0,,168,0
Ayakulik,1935,0,,169,0
Ayakulik,1935,0,,170,0
Ayakulik,1935,0,,171,0
Ayakulik,1935,0,,172,0
Ayakulik,1935,0,,173,0
Ayakulik,1935,0,,174,0
Ayakulik,1935,0,,175,0
Ayakulik,1935,0,,176,0
Ayakulik,1935,0,,177,0
Ayakulik,1935,0,,178,0
Ayakulik,1935,0,,179,0
Ayakulik,1935,0,,180,0
Ayakulik,1935,0,,181,0
Ayakulik,1935,0,,182,0
Ayakulik,1935,0,,183,0
Ayakulik,1935,0,,184,0
Ayakulik,1935,0,,185,0
Ayakulik,1935,0,,186,0
Ayakulik,1935,0,,187,0
Ayakulik,1935,0,,188,0
Ayakulik,1935,0,,189,0
Ayakulik,1935,0,,190,0
Ayakulik,1935,0,,191,0
Ayakulik,1935,0,,192,0
Ayakulik,1935,0,,193,0
Ayakulik,1935,0,,194,0
Ayakulik,1935,0,,195,0
Ayakulik,1935,0,,196,0
Ayakulik,1935,0,,197,0
Ayakulik,1935,0,,198,0
Ayakulik,1935,0,,199,0
Ayakulik,1935,250,,200,250
Ayakulik,1935,176,,201,426
Ayakulik,1935,115,,202,541
Ayakulik,1935,178,,203,719
Ayakulik,1935,35,,204,754
Ayakulik,1935,424,,205,1178
Ayakulik,1935,134,,206,1312
Ayakulik,1935,373,,207,1685
Ayakulik,1935,239,,208,1924
Ayakulik,1935,165,,209,2089
Ayakulik,1935,121,,210,2210
Ayakulik,1935,178,,211,2388
Ayakulik,1935,151,,212,2539
Ayakulik,1935,163,,213,2702
Ayakulik,1935,163,,214,2865
Ayakulik,1935,186,,215,3051
Ayakulik,1935,51,,216,3102
Ayakulik,1935,85,,217,3187
Ayakulik,1935,111,,218,3298
Ayakulik,1935,154,,219,3452
Ayakulik,1935,235,,220,3687
Ayakulik,1935,117,,221,3804
Ayakulik,1935,285,,222,4089
Ayakulik,1935,0,,223,4089
Ayakulik,1935,0,,224,4089
Ayakulik,1935,0,,225,4089
Ayakulik,1935,0,,226,4089
Ayakulik,1935,0,,227,4089
Ayakulik,1935,0,,228,4089
Ayakulik,1935,0,,229,4089
Ayakulik,1935,0,,230,4089
Ayakulik,1935,0,,231,4089
Ayakulik,1935,0,,232,4089
Ayakulik,1935,0,,233,4089
Ayakulik,1935,0,,234,4089
Ayakulik,1935,0,,235,4089
Ayakulik,1935,0,,236,4089
Ayakulik,1935,0,,237,4089
Ayakulik,1935,0,,238,4089
Ayakulik,1935,0,,239,4089
Ayakulik,1935,0,,240,4089
Ayakulik,1935,0,,241,4089
Ayakulik,1935,0,,242,4089
Ayakulik,1935,0,,243,4089
Ayakulik,1935,0,,244,4089
Ayakulik,1935,0,,245,4089
Ayakulik,1935,0,,246,4089
Ayakulik,1935,0,,247,4089
Ayakulik,1935,0,,248,4089
Ayakulik,1935,0,,249,4089
Ayakulik,1935,0,,250,4089
Ayakulik,1935,0,,251,4089
Ayakulik,1935,0,,252,4089
Ayakulik,1935,0,,253,4089
Ayakulik,1935,0,,254,4089
Ayakulik,1935,0,,255,4089
Ayakulik,1935,0,,256,4089
Ayakulik,1935,0,,257,4089
Ayakulik,1935,0,,258,4089
Ayakulik,1935,0,,259,4089
Ayakulik,1935,0,,260,4089
Ayakulik,1935,0,,261,4089
Ayakulik,1935,0,,262,4089
Ayakulik,1935,0,,263,4089
Ayakulik,1935,0,,264,4089
Ayakulik,1935,0,,265,4089
Ayakulik,1935,0,,266,4089
Ayakulik,1935,0,,267,4089
Ayakulik,1935,0,,268,4089
Ayakulik,1935,0,,269,4089
Ayakulik,1935,0,,270,4089
Ayakulik,1935,0,,271,4089
Ayakulik,1935,0,,272,4089
Ayakulik,1935,0,,273,4089
Ayakulik,1934,0,,152,0
Ayakulik,1934,0,,153,0
Ayakulik,1934,0,,154,0
Ayakulik,1934,0,,155,0
Ayakulik,1934,0,,156,0
Ayakulik,1934,0,,157,0
Ayakulik,1934,0,,158,0
Ayakulik,1934,0,,159,0
Ayakulik,1934,0,,160,0
Ayakulik,1934,0,,161,0
Ayakulik,1934,0,,162,0
Ayakulik,1934,0,,163,0
Ayakulik,1934,0,,164,0
Ayakulik,1934,0,,165,0
Ayakulik,1934,0,,166,0
Ayakulik,1934,0,,167,0
Ayakulik,1934,0,,168,0
Ayakulik,1934,0,,169,0
Ayakulik,1934,0,,170,0
Ayakulik,1934,0,,171,0
Ayakulik,1934,0,,172,0
Ayakulik,1934,0,,173,0
Ayakulik,1934,0,,174,0
Ayakulik,1934,0,,175,0
Ayakulik,1934,0,,176,0
Ayakulik,1934,0,,177,0
Ayakulik,1934,0,,178,0
Ayakulik,1934,0,,179,0
Ayakulik,1934,0,,180,0
Ayakulik,1934,0,,181,0
Ayakulik,1934,0,,182,0
Ayakulik,1934,0,,183,0
Ayakulik,1934,0,,184,0
Ayakulik,1934,0,,185,0
Ayakulik,1934,0,,186,0
Ayakulik,1934,0,,187,0
Ayakulik,1934,0,,188,0
Ayakulik,1934,0,,189,0
Ayakulik,1934,819,,190,819
Ayakulik,1934,674,,191,1493
Ayakulik,1934,7881,,192,9374
Ayakulik,1934,3551,,193,12925
Ayakulik,1934,3367,,194,16292
Ayakulik,1934,26073,,195,42365
Ayakulik,1934,2382,,196,44747
Ayakulik,1934,5213,,197,49960
Ayakulik,1934,27039,,198,76999
Ayakulik,1934,56451,,199,133450
Ayakulik,1934,28753,,200,162203
Ayakulik,1934,33189,,201,195392
Ayakulik,1934,4721,,202,200113
Ayakulik,1934,6700,,203,206813
Ayakulik,1934,12563,,204,219376
Ayakulik,1934,4477,,205,223853
Ayakulik,1934,27984,,206,251837
Ayakulik,1934,19972,,207,271809
Ayakulik,1934,19972,,208,291781
Ayakulik,1934,9848,,209,301629
Ayakulik,1934,76526,,210,378155
Ayakulik,1934,101701,,211,479856
Ayakulik,1934,114000,,212,593856
Ayakulik,1934,62996,,213,656852
Ayakulik,1934,264180,,214,921032
Ayakulik,1934,164547,,215,1085579
Ayakulik,1934,133124,,216,1218703
Ayakulik,1934,14732,,217,1233435
Ayakulik,1934,926,,218,1234361
Ayakulik,1934,4974,,219,1239335
Ayakulik,1934,3224,,220,1242559
Ayakulik,1934,4342,,221,1246901
Ayakulik,1934,10351,,222,1257252
Ayakulik,1934,18461,,223,1275713
Ayakulik,1934,6786,,224,1282499
Ayakulik,1934,10932,,225,1293431
Ayakulik,1934,10155,,226,1303586
Ayakulik,1934,5762,,227,1309348
Ayakulik,1934,0,,228,1309348
Ayakulik,1934,0,,229,1309348
Ayakulik,1934,0,,230,1309348
Ayakulik,1934,0,,231,1309348
Ayakulik,1934,0,,232,1309348
Ayakulik,1934,0,,233,1309348
Ayakulik,1934,0,,234,1309348
Ayakulik,1934,0,,235,1309348
Ayakulik,1934,0,,236,1309348
Ayakulik,1934,0,,237,1309348
Ayakulik,1934,0,,238,1309348
Ayakulik,1934,0,,239,1309348
Ayakulik,1934,0,,240,1309348
Ayakulik,1934,0,,241,1309348
Ayakulik,1934,0,,242,1309348
Ayakulik,1934,0,,243,1309348
Ayakulik,1934,0,,244,1309348
Ayakulik,1934,0,,245,1309348
Ayakulik,1934,0,,246,1309348
Ayakulik,1934,0,,247,1309348
Ayakulik,1934,0,,248,1309348
Ayakulik,1934,0,,249,1309348
Ayakulik,1934,0,,250,1309348
Ayakulik,1934,0,,251,1309348
Ayakulik,1934,0,,252,1309348
Ayakulik,1934,0,,253,1309348
Ayakulik,1934,0,,254,1309348
Ayakulik,1934,0,,255,1309348
Ayakulik,1934,0,,256,1309348
Ayakulik,1934,0,,257,1309348
Ayakulik,1934,0,,258,1309348
Ayakulik,1934,0,,259,1309348
Ayakulik,1934,0,,260,1309348
Ayakulik,1934,0,,261,1309348
Ayakulik,1934,0,,262,1309348
Ayakulik,1934,0,,263,1309348
Ayakulik,1934,0,,264,1309348
Ayakulik,1934,0,,265,1309348
Ayakulik,1934,0,,266,1309348
Ayakulik,1934,0,,267,1309348
Ayakulik,1934,0,,268,1309348
Ayakulik,1934,0,,269,1309348
Ayakulik,1934,0,,270,1309348
Ayakulik,1934,0,,271,1309348
Ayakulik,1934,0,,272,1309348
Ayakulik,1934,0,,273,1309348
Ayakulik,1932,0,,153,0
Ayakulik,1932,0,,154,0
Ayakulik,1932,0,,155,0
Ayakulik,1932,0,,156,0
Ayakulik,1932,0,,157,0
Ayakulik,1932,0,,158,0
Ayakulik,1932,0,,159,0
Ayakulik,1932,0,,160,0
Ayakulik,1932,0,,161,0
Ayakulik,1932,0,,162,0
Ayakulik,1932,0,,163,0
Ayakulik,1932,0,,164,0
Ayakulik,1932,0,,165,0
Ayakulik,1932,0,,166,0
Ayakulik,1932,0,,167,0
Ayakulik,1932,0,,168,0
Ayakulik,1932,0,,169,0
Ayakulik,1932,0,,170,0
Ayakulik,1932,0,,171,0
Ayakulik,1932,0,,172,0
Ayakulik,1932,0,,173,0
Ayakulik,1932,0,,174,0
Ayakulik,1932,0,,175,0
Ayakulik,1932,0,,176,0
Ayakulik,1932,0,,177,0
Ayakulik,1932,0,,178,0
Ayakulik,1932,0,,179,0
Ayakulik,1932,0,,180,0
Ayakulik,1932,0,,181,0
Ayakulik,1932,0,,182,0
Ayakulik,1932,0,,183,0
Ayakulik,1932,0,,184,0
Ayakulik,1932,0,,185,0
Ayakulik,1932,0,,186,0
Ayakulik,1932,0,,187,0
Ayakulik,1932,0,,188,0
Ayakulik,1932,0,,189,0
Ayakulik,1932,326,,190,326
Ayakulik,1932,210,,191,536
Ayakulik,1932,777,,192,1313
Ayakulik,1932,834,,193,2147
Ayakulik,1932,683,,194,2830
Ayakulik,1932,7517,,195,10347
Ayakulik,1932,3521,,196,13868
Ayakulik,1932,6652,,197,20520
Ayakulik,1932,12384,,198,32904
Ayakulik,1932,25438,,199,58342
Ayakulik,1932,24875,,200,83217
Ayakulik,1932,23038,,201,106255
Ayakulik,1932,26386,,202,132641
Ayakulik,1932,63585,,203,196226
Ayakulik,1932,85742,,204,281968
Ayakulik,1932,90258,,205,372226
Ayakulik,1932,96442,,206,468668
Ayakulik,1932,47462,,207,516130
Ayakulik,1932,78558,,208,594688
Ayakulik,1932,98387,,209,693075
Ayakulik,1932,135493,,210,828568
Ayakulik,1932,112394,,211,940962
Ayakulik,1932,53000,,212,993962
Ayakulik,1932,137183,,213,1131145
Ayakulik,1932,88525,,214,1219670
Ayakulik,1932,69660,,215,1289330
Ayakulik,1932,112171,,216,1401501
Ayakulik,1932,46300,,217,1447801
Ayakulik,1932,100500,,218,1548301
Ayakulik,1932,118058,,219,1666359
Ayakulik,1932,77196,,220,1743555
Ayakulik,1932,15063,,221,1758618
Ayakulik,1932,105770,,222,1864388
Ayakulik,1932,121159,,223,1985547
Ayakulik,1932,144886,,224,2130433
Ayakulik,1932,161646,,225,2292079
Ayakulik,1932,144172,,226,2436251
Ayakulik,1932,107535,,227,2543786
Ayakulik,1932,108535,,228,2652321
Ayakulik,1932,107325,,229,2759646
Ayakulik,1932,106459,,230,2866105
Ayakulik,1932,0,,231,2866105
Ayakulik,1932,0,,232,2866105
Ayakulik,1932,0,,233,2866105
Ayakulik,1932,0,,234,2866105
Ayakulik,1932,0,,235,2866105
Ayakulik,1932,0,,236,2866105
Ayakulik,1932,0,,237,2866105
Ayakulik,1932,0,,238,2866105
Ayakulik,1932,0,,239,2866105
Ayakulik,1932,0,,240,2866105
Ayakulik,1932,0,,241,2866105
Ayakulik,1932,0,,242,2866105
Ayakulik,1932,0,,243,2866105
Ayakulik,1932,0,,244,2866105
Ayakulik,1932,0,,245,2866105
Ayakulik,1932,0,,246,2866105
Ayakulik,1932,0,,247,2866105
Ayakulik,1932,0,,248,2866105
Ayakulik,1932,0,,249,2866105
Ayakulik,1932,0,,250,2866105
Ayakulik,1932,0,,251,2866105
Ayakulik,1932,0,,252,2866105
Ayakulik,1932,0,,253,2866105
Ayakulik,1932,0,,254,2866105
Ayakulik,1932,0,,255,2866105
Ayakulik,1932,0,,256,2866105
Ayakulik,1932,0,,257,2866105
Ayakulik,1932,0,,258,2866105
Ayakulik,1932,0,,259,2866105
Ayakulik,1932,0,,260,2866105
Ayakulik,1932,0,,261,2866105
Ayakulik,1932,0,,262,2866105
Ayakulik,1932,0,,263,2866105
Ayakulik,1932,0,,264,2866105
Ayakulik,1932,0,,265,2866105
Ayakulik,1932,0,,266,2866105
Ayakulik,1932,0,,267,2866105
Ayakulik,1932,0,,268,2866105
Ayakulik,1932,0,,269,2866105
Ayakulik,1932,0,,270,2866105
Ayakulik,1932,0,,271,2866105
Ayakulik,1932,0,,272,2866105
Ayakulik,1932,0,,273,2866105
Ayakulik,1932,0,,274,2866105
Ayakulik,1931,0,,152,0
Ayakulik,1931,0,,153,0
Ayakulik,1931,0,,154,0
Ayakulik,1931,0,,155,0
Ayakulik,1931,0,,156,0
Ayakulik,1931,0,,157,0
Ayakulik,1931,0,,158,0
Ayakulik,1931,0,,159,0
Ayakulik,1931,0,,160,0
Ayakulik,1931,0,,161,0
Ayakulik,1931,0,,162,0
Ayakulik,1931,0,,163,0
Ayakulik,1931,0,,164,0
Ayakulik,1931,0,,165,0
Ayakulik,1931,0,,166,0
Ayakulik,1931,0,,167,0
Ayakulik,1931,0,,168,0
Ayakulik,1931,0,,169,0
Ayakulik,1931,0,,170,0
Ayakulik,1931,0,,171,0
Ayakulik,1931,0,,172,0
Ayakulik,1931,0,,173,0
Ayakulik,1931,0,,174,0
Ayakulik,1931,0,,175,0
Ayakulik,1931,0,,176,0
Ayakulik,1931,0,,177,0
Ayakulik,1931,0,,178,0
Ayakulik,1931,0,,179,0
Ayakulik,1931,0,,180,0
Ayakulik,1931,0,,181,0
Ayakulik,1931,0,,182,0
Ayakulik,1931,0,,183,0
Ayakulik,1931,0,,184,0
Ayakulik,1931,0,,185,0
Ayakulik,1931,0,,186,0
Ayakulik,1931,0,,187,0
Ayakulik,1931,0,,188,0
Ayakulik,1931,0,,189,0
Ayakulik,1931,0,,190,0
Ayakulik,1931,0,,191,0
Ayakulik,1931,0,,192,0
Ayakulik,1931,0,,193,0
Ayakulik,1931,0,,194,0
Ayakulik,1931,0,,195,0
Ayakulik,1931,0,,196,0
Ayakulik,1931,0,,197,0
Ayakulik,1931,0,,198,0
Ayakulik,1931,0,,199,0
Ayakulik,1931,0,,200,0
Ayakulik,1931,0,,201,0
Ayakulik,1931,0,,202,0
Ayakulik,1931,0,,203,0
Ayakulik,1931,0,,204,0
Ayakulik,1931,0,,205,0
Ayakulik,1931,0,,206,0
Ayakulik,1931,1800,,207,1800
Ayakulik,1931,36,,208,1836
Ayakulik,1931,250,,209,2086
Ayakulik,1931,525,,210,2611
Ayakulik,1931,322,,211,2933
Ayakulik,1931,4450,,212,7383
Ayakulik,1931,3615,,213,10998
Ayakulik,1931,247,,214,11245
Ayakulik,1931,83,,215,11328
Ayakulik,1931,75,,216,11403
Ayakulik,1931,28,,217,11431
Ayakulik,1931,330,,218,11761
Ayakulik,1931,1848,,219,13609
Ayakulik,1931,150,,220,13759
Ayakulik,1931,144,,221,13903
Ayakulik,1931,136,,222,14039
Ayakulik,1931,70,,223,14109
Ayakulik,1931,57,,224,14166
Ayakulik,1931,0,,225,14166
Ayakulik,1931,0,,226,14166
Ayakulik,1931,0,,227,14166
Ayakulik,1931,0,,228,14166
Ayakulik,1931,0,,229,14166
Ayakulik,1931,0,,230,14166
Ayakulik,1931,0,,231,14166
Ayakulik,1931,0,,232,14166
Ayakulik,1931,0,,233,14166
Ayakulik,1931,0,,234,14166
Ayakulik,1931,0,,235,14166
Ayakulik,1931,0,,236,14166
Ayakulik,1931,0,,237,14166
Ayakulik,1931,0,,238,14166
Ayakulik,1931,0,,239,14166
Ayakulik,1931,0,,240,14166
Ayakulik,1931,0,,241,14166
Ayakulik,1931,0,,242,14166
Ayakulik,1931,0,,243,14166
Ayakulik,1931,0,,244,14166
Ayakulik,1931,0,,245,14166
Ayakulik,1931,0,,246,14166
Ayakulik,1931,0,,247,14166
Ayakulik,1931,0,,248,14166
Ayakulik,1931,0,,249,14166
Ayakulik,1931,0,,250,14166
Ayakulik,1931,0,,251,14166
Ayakulik,1931,0,,252,14166
Ayakulik,1931,0,,253,14166
Ayakulik,1931,0,,254,14166
Ayakulik,1931,0,,255,14166
Ayakulik,1931,0,,256,14166
Ayakulik,1931,0,,257,14166
Ayakulik,1931,0,,258,14166
Ayakulik,1931,0,,259,14166
Ayakulik,1931,0,,260,14166
Ayakulik,1931,0,,261,14166
Ayakulik,1931,0,,262,14166
Ayakulik,1931,0,,263,14166
Ayakulik,1931,0,,264,14166
Ayakulik,1931,0,,265,14166
Ayakulik,1931,0,,266,14166
Ayakulik,1931,0,,267,14166
Ayakulik,1931,0,,268,14166
Ayakulik,1931,0,,269,14166
Ayakulik,1931,0,,270,14166
Ayakulik,1931,0,,271,14166
Ayakulik,1931,0,,272,14166
Ayakulik,1931,0,,273,14166
Ayakulik,1930,0,,152,0
Ayakulik,1930,0,,153,0
Ayakulik,1930,0,,154,0
Ayakulik,1930,0,,155,0
Ayakulik,1930,0,,156,0
Ayakulik,1930,0,,157,0
Ayakulik,1930,0,,158,0
Ayakulik,1930,0,,159,0
Ayakulik,1930,0,,160,0
Ayakulik,1930,0,,161,0
Ayakulik,1930,0,,162,0
Ayakulik,1930,0,,163,0
Ayakulik,1930,0,,164,0
Ayakulik,1930,0,,165,0
Ayakulik,1930,0,,166,0
Ayakulik,1930,0,,167,0
Ayakulik,1930,0,,168,0
Ayakulik,1930,0,,169,0
Ayakulik,1930,0,,170,0
Ayakulik,1930,0,,171,0
Ayakulik,1930,0,,172,0
Ayakulik,1930,0,,173,0
Ayakulik,1930,0,,174,0
Ayakulik,1930,0,,175,0
Ayakulik,1930,0,,176,0
Ayakulik,1930,0,,177,0
Ayakulik,1930,0,,178,0
Ayakulik,1930,0,,179,0
Ayakulik,1930,0,,180,0
Ayakulik,1930,0,,181,0
Ayakulik,1930,0,,182,0
Ayakulik,1930,0,,183,0
Ayakulik,1930,75,,184,75
Ayakulik,1930,73,,185,148
Ayakulik,1930,25,,186,173
Ayakulik,1930,34,,187,207
Ayakulik,1930,664,,188,871
Ayakulik,1930,26,,189,897
Ayakulik,1930,1920,,190,2817
Ayakulik,1930,3762,,191,6579
Ayakulik,1930,7662,,192,14241
Ayakulik,1930,15063,,193,29304
Ayakulik,1930,18014,,194,47318
Ayakulik,1930,11920,,195,59238
Ayakulik,1930,17604,,196,76842
Ayakulik,1930,21278,,197,98120
Ayakulik,1930,14760,,198,112880
Ayakulik,1930,25825,,199,138705
Ayakulik,1930,17835,,200,156540
Ayakulik,1930,23708,,201,180248
Ayakulik,1930,36757,,202,217005
Ayakulik,1930,43447,,203,260452
Ayakulik,1930,28358,,204,288810
Ayakulik,1930,25691,,205,314501
Ayakulik,1930,43806,,206,358307
Ayakulik,1930,25758,,207,384065
Ayakulik,1930,10135,,208,394200
Ayakulik,1930,24876,,209,419076
Ayakulik,1930,19829,,210,438905
Ayakulik,1930,34508,,211,473413
Ayakulik,1930,18445,,212,491858
Ayakulik,1930,3953,,213,495811
Ayakulik,1930,17682,,214,513493
Ayakulik,1930,10425,,215,523918
Ayakulik,1930,5321,,216,529239
Ayakulik,1930,2262,,217,531501
Ayakulik,1930,7827,,218,539328
Ayakulik,1930,2737,,219,542065
Ayakulik,1930,3993,,220,546058
Ayakulik,1930,4371,,221,550429
Ayakulik,1930,4857,,222,555286
Ayakulik,1930,4995,,223,560281
Ayakulik,1930,16547,,224,576828
Ayakulik,1930,12088,,225,588916
Ayakulik,1930,1329,,226,590245
Ayakulik,1930,512,,227,590757
Ayakulik,1930,239,,228,590996
Ayakulik,1930,574,,229,591570
Ayakulik,1930,822,,230,592392
Ayakulik,1930,1868,,231,594260
Ayakulik,1930,1198,,232,595458
Ayakulik,1930,3679,,233,599137
Ayakulik,1930,3145,,234,602282
Ayakulik,1930,1637,,235,603919
Ayakulik,1930,1598,,236,605517
Ayakulik,1930,2296,,237,607813
Ayakulik,1930,678,,238,608491
Ayakulik,1930,387,,239,608878
Ayakulik,1930,442,,240,609320
Ayakulik,1930,190,,241,609510
Ayakulik,1930,208,,242,609718
Ayakulik,1930,148,,243,609866
Ayakulik,1930,81,,244,609947
Ayakulik,1930,0,,245,609947
Ayakulik,1930,0,,246,609947
Ayakulik,1930,0,,247,609947
Ayakulik,1930,0,,248,609947
Ayakulik,1930,0,,249,609947
Ayakulik,1930,0,,250,609947
Ayakulik,1930,0,,251,609947
Ayakulik,1930,0,,252,609947
Ayakulik,1930,0,,253,609947
Ayakulik,1930,0,,254,609947
Ayakulik,1930,0,,255,609947
Ayakulik,1930,0,,256,609947
Ayakulik,1930,0,,257,609947
Ayakulik,1930,0,,258,609947
Ayakulik,1930,0,,259,609947
Ayakulik,1930,0,,260,609947
Ayakulik,1930,0,,261,609947
Ayakulik,1930,0,,262,609947
Ayakulik,1930,0,,263,609947
Ayakulik,1930,0,,264,609947
Ayakulik,1930,0,,265,609947
Ayakulik,1930,0,,266,609947
Ayakulik,1930,0,,267,609947
Ayakulik,1930,0,,268,609947
Ayakulik,1930,0,,269,609947
Ayakulik,1930,0,,270,609947
Ayakulik,1930,0,,271,609947
Ayakulik,1930,0,,272,609947
Ayakulik,1930,0,,273,609947
Ayakulik,1929,0,,152,0
Ayakulik,1929,0,,153,0
Ayakulik,1929,0,,154,0
Ayakulik,1929,0,,155,0
Ayakulik,1929,0,,156,0
Ayakulik,1929,0,,157,0
Ayakulik,1929,0,,158,0
Ayakulik,1929,0,,159,0
Ayakulik,1929,0,,160,0
Ayakulik,1929,0,,161,0
Ayakulik,1929,0,,162,0
Ayakulik,1929,0,,163,0
Ayakulik,1929,0,,164,0
Ayakulik,1929,0,,165,0
Ayakulik,1929,0,,166,0
Ayakulik,1929,0,,167,0
Ayakulik,1929,0,,168,0
Ayakulik,1929,0,,169,0
Ayakulik,1929,0,,170,0
Ayakulik,1929,0,,171,0
Ayakulik,1929,0,,172,0
Ayakulik,1929,0,,173,0
Ayakulik,1929,0,,174,0
Ayakulik,1929,0,,175,0
Ayakulik,1929,0,,176,0
Ayakulik,1929,0,,177,0
Ayakulik,1929,0,,178,0
Ayakulik,1929,0,,179,0
Ayakulik,1929,0,,180,0
Ayakulik,1929,0,,181,0
Ayakulik,1929,0,,182,0
Ayakulik,1929,0,,183,0
Ayakulik,1929,0,,184,0
Ayakulik,1929,0,,185,0
Ayakulik,1929,0,,186,0
Ayakulik,1929,0,,187,0
Ayakulik,1929,0,,188,0
Ayakulik,1929,0,,189,0
Ayakulik,1929,0,,190,0
Ayakulik,1929,0,,191,0
Ayakulik,1929,0,,192,0
Ayakulik,1929,30,,193,30
Ayakulik,1929,5,,194,35
Ayakulik,1929,6,,195,41
Ayakulik,1929,1,,196,42
Ayakulik,1929,20,,197,62
Ayakulik,1929,15,,198,77
Ayakulik,1929,11,,199,88
Ayakulik,1929,3,,200,91
Ayakulik,1929,16,,201,107
Ayakulik,1929,9,,202,116
Ayakulik,1929,37,,203,153
Ayakulik,1929,15,,204,168
Ayakulik,1929,14,,205,182
Ayakulik,1929,32,,206,214
Ayakulik,1929,21,,207,235
Ayakulik,1929,278,,208,513
Ayakulik,1929,196,,209,709
Ayakulik,1929,28,,210,737
Ayakulik,1929,15,,211,752
Ayakulik,1929,125,,212,877
Ayakulik,1929,64,,213,941
Ayakulik,1929,59,,214,1000
Ayakulik,1929,64,,215,1064
Ayakulik,1929,226,,216,1290
Ayakulik,1929,91,,217,1381
Ayakulik,1929,177,,218,1558
Ayakulik,1929,227,,219,1785
Ayakulik,1929,50,,220,1835
Ayakulik,1929,40,,221,1875
Ayakulik,1929,270,,222,2145
Ayakulik,1929,193,,223,2338
Ayakulik,1929,152,,224,2490
Ayakulik,1929,50,,225,2540
Ayakulik,1929,158,,226,2698
Ayakulik,1929,14,,227,2712
Ayakulik,1929,42,,228,2754
Ayakulik,1929,80,,229,2834
Ayakulik,1929,36,,230,2870
Ayakulik,1929,30,,231,2900
Ayakulik,1929,50,,232,2950
Ayakulik,1929,25,,233,2975
Ayakulik,1929,15,,234,2990
Ayakulik,1929,0,,235,2990
Ayakulik,1929,0,,236,2990
Ayakulik,1929,0,,237,2990
Ayakulik,1929,0,,238,2990
Ayakulik,1929,0,,239,2990
Ayakulik,1929,0,,240,2990
Ayakulik,1929,0,,241,2990
Ayakulik,1929,0,,242,2990
Ayakulik,1929,0,,243,2990
Ayakulik,1929,0,,244,2990
Ayakulik,1929,0,,245,2990
Ayakulik,1929,0,,246,2990
Ayakulik,1929,0,,247,2990
Ayakulik,1929,0,,248,2990
Ayakulik,1929,0,,249,2990
Ayakulik,1929,0,,250,2990
Ayakulik,1929,0,,251,2990
Ayakulik,1929,0,,252,2990
Ayakulik,1929,0,,253,2990
Ayakulik,1929,0,,254,2990
Ayakulik,1929,0,,255,2990
Ayakulik,1929,0,,256,2990
Ayakulik,1929,0,,257,2990
Ayakulik,1929,0,,258,2990
Ayakulik,1929,0,,259,2990
Ayakulik,1929,0,,260,2990
Ayakulik,1929,0,,261,2990
Ayakulik,1929,0,,262,2990
Ayakulik,1929,0,,263,2990
Ayakulik,1929,0,,264,2990
Ayakulik,1929,0,,265,2990
Ayakulik,1929,0,,266,2990
Ayakulik,1929,0,,267,2990
Ayakulik,1929,0,,268,2990
Ayakulik,1929,0,,269,2990
Ayakulik,1929,0,,270,2990
Ayakulik,1929,0,,271,2990
Ayakulik,1929,0,,272,2990
Ayakulik,1929,0,,273,2990
Karluk,2012,0,,155,0
Karluk,2012,0,,156,0
Karluk,2012,0,,157,0
Karluk,2012,0,,158,0
Karluk,2012,0,,159,0
Karluk,2012,0,,160,0
Karluk,2012,0,,161,0
Karluk,2012,0,,162,0
Karluk,2012,0,,163,0
Karluk,2012,0,,164,0
Karluk,2012,0,,165,0
Karluk,2012,0,,166,0
Karluk,2012,0,,167,0
Karluk,2012,0,,168,0
Karluk,2012,0,,169,0
Karluk,2012,0,,170,0
Karluk,2012,0,,171,0
Karluk,2012,0,,172,0
Karluk,2012,0,,173,0
Karluk,2012,0,,174,0
Karluk,2012,4,,175,4
Karluk,2012,0,,176,4
Karluk,2012,0,,177,4
Karluk,2012,20,,178,24
Karluk,2012,10,,179,34
Karluk,2012,6,,180,40
Karluk,2012,4,,181,44
Karluk,2012,3,,182,47
Karluk,2012,3,,183,50
Karluk,2012,0,,184,50
Karluk,2012,1,,185,51
Karluk,2012,0,,186,51
Karluk,2012,10,,187,61
Karluk,2012,16,,188,77
Karluk,2012,57,,189,134
Karluk,2012,6,,190,140
Karluk,2012,7,,191,147
Karluk,2012,17,,192,164
Karluk,2012,2,,193,166
Karluk,2012,187,,194,353
Karluk,2012,20,,195,373
Karluk,2012,20,,196,393
Karluk,2012,2,,197,395
Karluk,2012,0,,198,395
Karluk,2012,1,,199,396
Karluk,2012,10,,200,406
Karluk,2012,1,,201,407
Karluk,2012,1,,202,408
Karluk,2012,0,,203,408
Karluk,2012,1,,204,409
Karluk,2012,0,,205,409
Karluk,2012,11,,206,420
Karluk,2012,28,,207,448
Karluk,2012,103,,208,551
Karluk,2012,355,,209,906
Karluk,2012,717,,210,1623
Karluk,2012,551,,211,2174
Karluk,2012,2535,,212,4709
Karluk,2012,258,,213,4967
Karluk,2012,43,,214,5010
Karluk,2012,6103,,215,11113
Karluk,2012,4701,,216,15814
Karluk,2012,2148,,217,17962
Karluk,2012,4091,,218,22053
Karluk,2012,22985,,219,45038
Karluk,2012,7690,,220,52728
Karluk,2012,36103,,221,88831
Karluk,2012,41646,,222,130477
Karluk,2012,38782,,223,169259
Karluk,2012,2576,,224,171835
Karluk,2012,15875,,225,187710
Karluk,2012,18111,,226,205821
Karluk,2012,19161,,227,224982
Karluk,2012,118072,,228,343054
Karluk,2012,39918,,229,382972
Karluk,2012,45185,,230,428157
Karluk,2012,36765,,231,464922
Karluk,2012,97292,,232,562214
Karluk,2012,95416,,233,657630
Karluk,2012,31489,,234,689119
Karluk,2012,6574,,235,695693
Karluk,2012,112388,,236,808081
Karluk,2012,46159,,237,854240
Karluk,2012,20476,,238,874716
Karluk,2012,23904,,239,898620
Karluk,2012,17898,,240,916518
Karluk,2012,10860,,241,927378
Karluk,2012,32412,,242,959790
Karluk,2012,40258,,243,1000048
Karluk,2012,12565,,244,1012613
Karluk,2012,4063,,245,1016676
Karluk,2012,6321,,246,1022997
Karluk,2012,7101,,247,1030098
Karluk,2012,4712,,248,1034810
Karluk,2012,5000,,249,1039810
Karluk,2012,5000,,250,1044810
Karluk,2012,1013,,251,1045823
Karluk,2012,1000,,252,1046823
Karluk,2012,330,,253,1047153
Karluk,2012,163,,254,1047316
Karluk,2012,513,,255,1047829
Karluk,2012,957,,256,1048786
Karluk,2012,178,,257,1048964
Karluk,2012,446,,258,1049410
Karluk,2012,287,,259,1049697
Karluk,2012,200,,260,1049897
Karluk,2012,0,,261,1049897
Karluk,2012,0,,262,1049897
Karluk,2012,0,,263,1049897
Karluk,2012,0,,264,1049897
Karluk,2012,0,,265,1049897
Karluk,2012,0,,266,1049897
Karluk,2012,0,,267,1049897
Karluk,2012,0,,268,1049897
Karluk,2012,0,,269,1049897
Karluk,2012,0,,270,1049897
Karluk,2012,0,,271,1049897
Karluk,2012,0,,272,1049897
Karluk,2012,0,,273,1049897
Karluk,2012,0,,274,1049897
Karluk,2012,0,,275,1049897
Karluk,2012,0,,276,1049897
Karluk,2012,0,,277,1049897
Karluk,2012,0,,278,1049897
Karluk,2012,0,,279,1049897
Karluk,2012,0,,280,1049897
Karluk,2012,0,,281,1049897
Karluk,2012,0,,282,1049897
Karluk,2012,0,,283,1049897
Karluk,2012,0,,284,1049897
Karluk,2012,0,,285,1049897
Karluk,2012,0,,286,1049897
Karluk,2011,0,,154,0
Karluk,2011,0,,155,0
Karluk,2011,0,,156,0
Karluk,2011,0,,157,0
Karluk,2011,0,,158,0
Karluk,2011,0,,159,0
Karluk,2011,0,,160,0
Karluk,2011,0,,161,0
Karluk,2011,0,,162,0
Karluk,2011,0,,163,0
Karluk,2011,0,,164,0
Karluk,2011,0,,165,0
Karluk,2011,0,,166,0
Karluk,2011,0,,167,0
Karluk,2011,0,,168,0
Karluk,2011,0,,169,0
Karluk,2011,0,,170,0
Karluk,2011,0,,171,0
Karluk,2011,0,,172,0
Karluk,2011,0,,173,0
Karluk,2011,0,,174,0
Karluk,2011,0,,175,0
Karluk,2011,0,,176,0
Karluk,2011,0,,177,0
Karluk,2011,0,,178,0
Karluk,2011,0,,179,0
Karluk,2011,1,,180,1
Karluk,2011,0,,181,1
Karluk,2011,6,,182,7
Karluk,2011,0,,183,7
Karluk,2011,0,,184,7
Karluk,2011,0,,185,7
Karluk,2011,1,,186,8
Karluk,2011,0,,187,8
Karluk,2011,0,,188,8
Karluk,2011,0,,189,8
Karluk,2011,0,,190,8
Karluk,2011,0,,191,8
Karluk,2011,0,,192,8
Karluk,2011,15,,193,23
Karluk,2011,1,,194,24
Karluk,2011,2,,195,26
Karluk,2011,0,,196,26
Karluk,2011,3,,197,29
Karluk,2011,3,,198,32
Karluk,2011,3,,199,35
Karluk,2011,5,,200,40
Karluk,2011,3,,201,43
Karluk,2011,2,,202,45
Karluk,2011,3,,203,48
Karluk,2011,8,,204,56
Karluk,2011,18,,205,74
Karluk,2011,6,,206,80
Karluk,2011,10,,207,90
Karluk,2011,211,,208,301
Karluk,2011,18,,209,319
Karluk,2011,33,,210,352
Karluk,2011,198,,211,550
Karluk,2011,565,,212,1115
Karluk,2011,60,,213,1175
Karluk,2011,3068,,214,4243
Karluk,2011,527,,215,4770
Karluk,2011,19,,216,4789
Karluk,2011,40,,217,4829
Karluk,2011,87,,218,4916
Karluk,2011,1995,,219,6911
Karluk,2011,610,,220,7521
Karluk,2011,859,,221,8380
Karluk,2011,2164,,222,10544
Karluk,2011,1806,,223,12350
Karluk,2011,649,,224,12999
Karluk,2011,951,,225,13950
Karluk,2011,4093,,226,18043
Karluk,2011,85,,227,18128
Karluk,2011,936,,228,19064
Karluk,2011,1614,,229,20678
Karluk,2011,2907,,230,23585
Karluk,2011,14399,,231,37984
Karluk,2011,1816,,232,39800
Karluk,2011,2136,,233,41936
Karluk,2011,1041,,234,42977
Karluk,2011,2083,,235,45060
Karluk,2011,2806,,236,47866
Karluk,2011,5934,,237,53800
Karluk,2011,4658,,238,58458
Karluk,2011,8437,,239,66895
Karluk,2011,13953,,240,80848
Karluk,2011,2903,,241,83751
Karluk,2011,6778,,242,90529
Karluk,2011,9454,,243,99983
Karluk,2011,5040,,244,105023
Karluk,2011,11695,,245,116718
Karluk,2011,7752,,246,124470
Karluk,2011,1530,,247,126000
Karluk,2011,3143,,248,129143
Karluk,2011,8427,,249,137570
Karluk,2011,2408,,250,139978
Karluk,2011,4090,,251,144068
Karluk,2011,3725,,252,147793
Karluk,2011,1823,,253,149616
Karluk,2011,1096,,254,150712
Karluk,2011,597,,255,151309
Karluk,2011,425,,256,151734
Karluk,2011,340,,257,152074
Karluk,2011,1850,,258,153924
Karluk,2011,355,,259,154279
Karluk,2011,139,,260,154418
Karluk,2011,66,,261,154484
Karluk,2011,44,,262,154528
Karluk,2011,1048,,263,155576
Karluk,2011,79,,264,155655
Karluk,2011,3085,,265,158740
Karluk,2011,0,,266,158740
Karluk,2011,0,,267,158740
Karluk,2011,0,,268,158740
Karluk,2011,0,,269,158740
Karluk,2011,0,,270,158740
Karluk,2011,0,,271,158740
Karluk,2011,0,,272,158740
Karluk,2011,0,,273,158740
Karluk,2011,0,,274,158740
Karluk,2011,0,,275,158740
Karluk,2011,0,,276,158740
Karluk,2011,0,,277,158740
Karluk,2011,0,,278,158740
Karluk,2011,0,,279,158740
Karluk,2011,0,,280,158740
Karluk,2011,0,,281,158740
Karluk,2011,0,,282,158740
Karluk,2011,0,,283,158740
Karluk,2011,0,,284,158740
Karluk,2011,0,,285,158740
Karluk,2010,0,,154,0
Karluk,2010,0,,155,0
Karluk,2010,0,,156,0
Karluk,2010,0,,157,0
Karluk,2010,0,,158,0
Karluk,2010,0,,159,0
Karluk,2010,0,,160,0
Karluk,2010,0,,161,0
Karluk,2010,0,,162,0
Karluk,2010,0,,163,0
Karluk,2010,0,,164,0
Karluk,2010,0,,165,0
Karluk,2010,0,,166,0
Karluk,2010,0,,167,0
Karluk,2010,0,,168,0
Karluk,2010,0,,169,0
Karluk,2010,0,,170,0
Karluk,2010,0,,171,0
Karluk,2010,0,,172,0
Karluk,2010,0,,173,0
Karluk,2010,0,,174,0
Karluk,2010,0,,175,0
Karluk,2010,0,,176,0
Karluk,2010,0,,177,0
Karluk,2010,0,,178,0
Karluk,2010,0,,179,0
Karluk,2010,0,,180,0
Karluk,2010,0,,181,0
Karluk,2010,0,,182,0
Karluk,2010,0,,183,0
Karluk,2010,0,,184,0
Karluk,2010,0,,185,0
Karluk,2010,0,,186,0
Karluk,2010,0,,187,0
Karluk,2010,0,,188,0
Karluk,2010,0,,189,0
Karluk,2010,0,,190,0
Karluk,2010,10,,191,10
Karluk,2010,2,,192,12
Karluk,2010,3,,193,15
Karluk,2010,5,,194,20
Karluk,2010,0,,195,20
Karluk,2010,0,,196,20
Karluk,2010,3,,197,23
Karluk,2010,3,,198,26
Karluk,2010,1,,199,27
Karluk,2010,9,,200,36
Karluk,2010,1,,201,37
Karluk,2010,0,,202,37
Karluk,2010,2,,203,39
Karluk,2010,0,,204,39
Karluk,2010,8,,205,47
Karluk,2010,68,,206,115
Karluk,2010,381,,207,496
Karluk,2010,67,,208,563
Karluk,2010,85,,209,648
Karluk,2010,1771,,210,2419
Karluk,2010,1673,,211,4092
Karluk,2010,2005,,212,6097
Karluk,2010,2753,,213,8850
Karluk,2010,586,,214,9436
Karluk,2010,4665,,215,14101
Karluk,2010,4031,,216,18132
Karluk,2010,42132,,217,60264
Karluk,2010,9872,,218,70136
Karluk,2010,21103,,219,91239
Karluk,2010,28724,,220,119963
Karluk,2010,87829,,221,207792
Karluk,2010,8456,,222,216248
Karluk,2010,30263,,223,246511
Karluk,2010,7624,,224,254135
Karluk,2010,11689,,225,265824
Karluk,2010,58692,,226,324516
Karluk,2010,73588,,227,398104
Karluk,2010,78453,,228,476557
Karluk,2010,134710,,229,611267
Karluk,2010,63749,,230,675016
Karluk,2010,42922,,231,717938
Karluk,2010,33454,,232,751392
Karluk,2010,51911,,233,803303
Karluk,2010,28649,,234,831952
Karluk,2010,83430,,235,915382
Karluk,2010,66285,,236,981667
Karluk,2010,83143,,237,1064810
Karluk,2010,75672,,238,1140482
Karluk,2010,60953,,239,1201435
Karluk,2010,23736,,240,1225171
Karluk,2010,12904,,241,1238075
Karluk,2010,26584,,242,1264659
Karluk,2010,16358,,243,1281017
Karluk,2010,8382,,244,1289399
Karluk,2010,8466,,245,1297865
Karluk,2010,2580,,246,1300445
Karluk,2010,3919,,247,1304364
Karluk,2010,10166,,248,1314530
Karluk,2010,3697,,249,1318227
Karluk,2010,3557,,250,1321784
Karluk,2010,104,,251,1321888
Karluk,2010,563,,252,1322451
Karluk,2010,637,,253,1323088
Karluk,2010,562,,254,1323650
Karluk,2010,247,,255,1323897
Karluk,2010,130,,256,1324027
Karluk,2010,48,,257,1324075
Karluk,2010,84,,258,1324159
Karluk,2010,65,,259,1324224
Karluk,2010,54,,260,1324278
Karluk,2010,90,,261,1324368
Karluk,2010,0,,262,1324368
Karluk,2010,0,,263,1324368
Karluk,2010,0,,264,1324368
Karluk,2010,0,,265,1324368
Karluk,2010,0,,266,1324368
Karluk,2010,0,,267,1324368
Karluk,2010,0,,268,1324368
Karluk,2010,0,,269,1324368
Karluk,2010,0,,270,1324368
Karluk,2010,0,,271,1324368
Karluk,2010,0,,272,1324368
Karluk,2010,0,,273,1324368
Karluk,2010,0,,274,1324368
Karluk,2010,0,,275,1324368
Karluk,2010,0,,276,1324368
Karluk,2010,0,,277,1324368
Karluk,2010,0,,278,1324368
Karluk,2010,0,,279,1324368
Karluk,2010,0,,280,1324368
Karluk,2010,0,,281,1324368
Karluk,2010,0,,282,1324368
Karluk,2010,0,,283,1324368
Karluk,2010,0,,284,1324368
Karluk,2010,0,,285,1324368
Karluk,2009,0,,154,0
Karluk,2009,0,,155,0
Karluk,2009,0,,156,0
Karluk,2009,0,,157,0
Karluk,2009,0,,158,0
Karluk,2009,0,,159,0
Karluk,2009,0,,160,0
Karluk,2009,0,,161,0
Karluk,2009,0,,162,0
Karluk,2009,0,,163,0
Karluk,2009,0,,164,0
Karluk,2009,0,,165,0
Karluk,2009,0,,166,0
Karluk,2009,0,,167,0
Karluk,2009,0,,168,0
Karluk,2009,0,,169,0
Karluk,2009,0,,170,0
Karluk,2009,0,,171,0
Karluk,2009,0,,172,0
Karluk,2009,0,,173,0
Karluk,2009,0,,174,0
Karluk,2009,0,,175,0
Karluk,2009,1,,176,1
Karluk,2009,0,,177,1
Karluk,2009,0,,178,1
Karluk,2009,0,,179,1
Karluk,2009,0,,180,1
Karluk,2009,0,,181,1
Karluk,2009,0,,182,1
Karluk,2009,1,,183,2
Karluk,2009,0,,184,2
Karluk,2009,1,,185,3
Karluk,2009,0,,186,3
Karluk,2009,11,,187,14
Karluk,2009,3,,188,17
Karluk,2009,2,,189,19
Karluk,2009,0,,190,19
Karluk,2009,0,,191,19
Karluk,2009,0,,192,19
Karluk,2009,0,,193,19
Karluk,2009,0,,194,19
Karluk,2009,0,,195,19
Karluk,2009,0,,196,19
Karluk,2009,0,,197,19
Karluk,2009,0,,198,19
Karluk,2009,0,,199,19
Karluk,2009,0,,200,19
Karluk,2009,1,,201,20
Karluk,2009,0,,202,20
Karluk,2009,2,,203,22
Karluk,2009,2,,204,24
Karluk,2009,0,,205,24
Karluk,2009,3,,206,27
Karluk,2009,5,,207,32
Karluk,2009,13,,208,45
Karluk,2009,6,,209,51
Karluk,2009,12,,210,63
Karluk,2009,95,,211,158
Karluk,2009,171,,212,329
Karluk,2009,164,,213,493
Karluk,2009,185,,214,678
Karluk,2009,452,,215,1130
Karluk,2009,2301,,216,3431
Karluk,2009,1381,,217,4812
Karluk,2009,61,,218,4873
Karluk,2009,1567,,219,6440
Karluk,2009,99,,220,6539
Karluk,2009,1244,,221,7783
Karluk,2009,907,,222,8690
Karluk,2009,677,,223,9367
Karluk,2009,423,,224,9790
Karluk,2009,3347,,225,13137
Karluk,2009,1503,,226,14640
Karluk,2009,5566,,227,20206
Karluk,2009,272,,228,20478
Karluk,2009,1476,,229,21954
Karluk,2009,1564,,230,23518
Karluk,2009,530,,231,24048
Karluk,2009,3074,,232,27122
Karluk,2009,3702,,233,30824
Karluk,2009,2087,,234,32911
Karluk,2009,6512,,235,39423
Karluk,2009,3551,,236,42974
Karluk,2009,6778,,237,49752
Karluk,2009,5015,,238,54767
Karluk,2009,10924,,239,65691
Karluk,2009,6307,,240,71998
Karluk,2009,10926,,241,82924
Karluk,2009,7122,,242,90046
Karluk,2009,10221,,243,100267
Karluk,2009,4948,,244,105215
Karluk,2009,9275,,245,114490
Karluk,2009,10612,,246,125102
Karluk,2009,9801,,247,134903
Karluk,2009,9149,,248,144052
Karluk,2009,2957,,249,147009
Karluk,2009,1653,,250,148662
Karluk,2009,1338,,251,150000
Karluk,2009,3830,,252,153830
Karluk,2009,579,,253,154409
Karluk,2009,763,,254,155172
Karluk,2009,477,,255,155649
Karluk,2009,234,,256,155883
Karluk,2009,320,,257,156203
Karluk,2009,484,,258,156687
Karluk,2009,170,,259,156857
Karluk,2009,1055,,260,157912
Karluk,2009,516,,261,158428
Karluk,2009,159,,262,158587
Karluk,2009,26,,263,158613
Karluk,2009,36,,264,158649
Karluk,2009,24,,265,158673
Karluk,2009,13,,266,158686
Karluk,2009,10,,267,158696
Karluk,2009,18,,268,158714
Karluk,2009,36,,269,158750
Karluk,2009,143,,270,158893
Karluk,2009,204,,271,159097
Karluk,2009,0,,272,159097
Karluk,2009,0,,273,159097
Karluk,2009,0,,274,159097
Karluk,2009,0,,275,159097
Karluk,2009,0,,276,159097
Karluk,2009,0,,277,159097
Karluk,2009,0,,278,159097
Karluk,2009,0,,279,159097
Karluk,2009,0,,280,159097
Karluk,2009,0,,281,159097
Karluk,2009,0,,282,159097
Karluk,2009,0,,283,159097
Karluk,2009,0,,284,159097
Karluk,2009,0,,285,159097
Karluk,2008,0,,155,0
Karluk,2008,0,,156,0
Karluk,2008,0,,157,0
Karluk,2008,0,,158,0
Karluk,2008,0,,159,0
Karluk,2008,0,,160,0
Karluk,2008,0,,161,0
Karluk,2008,0,,162,0
Karluk,2008,0,,163,0
Karluk,2008,0,,164,0
Karluk,2008,0,,165,0
Karluk,2008,0,,166,0
Karluk,2008,0,,167,0
Karluk,2008,0,,168,0
Karluk,2008,0,,169,0
Karluk,2008,0,,170,0
Karluk,2008,0,,171,0
Karluk,2008,0,,172,0
Karluk,2008,0,,173,0
Karluk,2008,0,,174,0
Karluk,2008,0,,175,0
Karluk,2008,0,,176,0
Karluk,2008,0,,177,0
Karluk,2008,0,,178,0
Karluk,2008,0,,179,0
Karluk,2008,1,,180,1
Karluk,2008,0,,181,1
Karluk,2008,0,,182,1
Karluk,2008,1,,183,2
Karluk,2008,0,,184,2
Karluk,2008,0,,185,2
Karluk,2008,0,,186,2
Karluk,2008,0,,187,2
Karluk,2008,0,,188,2
Karluk,2008,1,,189,3
Karluk,2008,0,,190,3
Karluk,2008,0,,191,3
Karluk,2008,0,,192,3
Karluk,2008,0,,193,3
Karluk,2008,0,,194,3
Karluk,2008,0,,195,3
Karluk,2008,0,,196,3
Karluk,2008,0,,197,3
Karluk,2008,0,,198,3
Karluk,2008,0,,199,3
Karluk,2008,0,,200,3
Karluk,2008,1,,201,4
Karluk,2008,2,,202,6
Karluk,2008,3,,203,9
Karluk,2008,0,,204,9
Karluk,2008,6,,205,15
Karluk,2008,26,,206,41
Karluk,2008,84,,207,125
Karluk,2008,82,,208,207
Karluk,2008,8,,209,215
Karluk,2008,88,,210,303
Karluk,2008,42,,211,345
Karluk,2008,23,,212,368
Karluk,2008,138,,213,506
Karluk,2008,168,,214,674
Karluk,2008,2212,,215,2886
Karluk,2008,235,,216,3121
Karluk,2008,789,,217,3910
Karluk,2008,984,,218,4894
Karluk,2008,11882,,219,16776
Karluk,2008,15665,,220,32441
Karluk,2008,17950,,221,50391
Karluk,2008,11275,,222,61666
Karluk,2008,10110,,223,71776
Karluk,2008,198,,224,71974
Karluk,2008,8839,,225,80813
Karluk,2008,49841,,226,130654
Karluk,2008,26740,,227,157394
Karluk,2008,17566,,228,174960
Karluk,2008,10058,,229,185018
Karluk,2008,14075,,230,199093
Karluk,2008,10628,,231,209721
Karluk,2008,102150,,232,311871
Karluk,2008,93233,,233,405104
Karluk,2008,18960,,234,424064
Karluk,2008,6516,,235,430580
Karluk,2008,13785,,236,444365
Karluk,2008,30248,,237,474613
Karluk,2008,12015,,238,486628
Karluk,2008,4532,,239,491160
Karluk,2008,29140,,240,520300
Karluk,2008,22693,,241,542993
Karluk,2008,12467,,242,555460
Karluk,2008,9471,,243,564931
Karluk,2008,4579,,244,569510
Karluk,2008,29982,,245,599492
Karluk,2008,2888,,246,602380
Karluk,2008,4375,,247,606755
Karluk,2008,669,,248,607424
Karluk,2008,1309,,249,608733
Karluk,2008,301,,250,609034
Karluk,2008,30,,251,609064
Karluk,2008,300,,252,609364
Karluk,2008,8000,,253,617364
Karluk,2008,5112,,254,622476
Karluk,2008,56,,255,622532
Karluk,2008,121,,256,622653
Karluk,2008,27,,257,622680
Karluk,2008,93,,258,622773
Karluk,2008,133,,259,622906
Karluk,2008,153,,260,623059
Karluk,2008,7,,261,623066
Karluk,2008,148,,262,623214
Karluk,2008,1250,,263,624464
Karluk,2008,76,,264,624540
Karluk,2008,0,,265,624540
Karluk,2008,0,,266,624540
Karluk,2008,0,,267,624540
Karluk,2008,0,,268,624540
Karluk,2008,0,,269,624540
Karluk,2008,0,,270,624540
Karluk,2008,0,,271,624540
Karluk,2008,0,,272,624540
Karluk,2008,0,,273,624540
Karluk,2008,0,,274,624540
Karluk,2008,0,,275,624540
Karluk,2008,0,,276,624540
Karluk,2008,0,,277,624540
Karluk,2008,0,,278,624540
Karluk,2008,0,,279,624540
Karluk,2008,0,,280,624540
Karluk,2008,0,,281,624540
Karluk,2008,0,,282,624540
Karluk,2008,0,,283,624540
Karluk,2008,0,,284,624540
Karluk,2008,0,,285,624540
Karluk,2008,0,,286,624540
Karluk,2007,0,,154,0
Karluk,2007,0,,155,0
Karluk,2007,0,,156,0
Karluk,2007,0,,157,0
Karluk,2007,0,,158,0
Karluk,2007,0,,159,0
Karluk,2007,0,,160,0
Karluk,2007,0,,161,0
Karluk,2007,0,,162,0
Karluk,2007,0,,163,0
Karluk,2007,0,,164,0
Karluk,2007,0,,165,0
Karluk,2007,0,,166,0
Karluk,2007,0,,167,0
Karluk,2007,0,,168,0
Karluk,2007,0,,169,0
Karluk,2007,0,,170,0
Karluk,2007,0,,171,0
Karluk,2007,0,,172,0
Karluk,2007,0,,173,0
Karluk,2007,0,,174,0
Karluk,2007,0,,175,0
Karluk,2007,0,,176,0
Karluk,2007,0,,177,0
Karluk,2007,0,,178,0
Karluk,2007,0,,179,0
Karluk,2007,0,,180,0
Karluk,2007,0,,181,0
Karluk,2007,0,,182,0
Karluk,2007,0,,183,0
Karluk,2007,0,,184,0
Karluk,2007,0,,185,0
Karluk,2007,0,,186,0
Karluk,2007,0,,187,0
Karluk,2007,0,,188,0
Karluk,2007,0,,189,0
Karluk,2007,0,,190,0
Karluk,2007,0,,191,0
Karluk,2007,0,,192,0
Karluk,2007,0,,193,0
Karluk,2007,0,,194,0
Karluk,2007,0,,195,0
Karluk,2007,0,,196,0
Karluk,2007,0,,197,0
Karluk,2007,1,,198,1
Karluk,2007,0,,199,1
Karluk,2007,0,,200,1
Karluk,2007,3,,201,4
Karluk,2007,1,,202,5
Karluk,2007,2,,203,7
Karluk,2007,1,,204,8
Karluk,2007,0,,205,8
Karluk,2007,26,,206,34
Karluk,2007,54,,207,88
Karluk,2007,3,,208,91
Karluk,2007,1,,209,92
Karluk,2007,0,,210,92
Karluk,2007,1,,211,93
Karluk,2007,5,,212,98
Karluk,2007,0,,213,98
Karluk,2007,5,,214,103
Karluk,2007,77,,215,180
Karluk,2007,129,,216,309
Karluk,2007,1089,,217,1398
Karluk,2007,167,,218,1565
Karluk,2007,5,,219,1570
Karluk,2007,266,,220,1836
Karluk,2007,96,,221,1932
Karluk,2007,312,,222,2244
Karluk,2007,133,,223,2377
Karluk,2007,4,,224,2381
Karluk,2007,8,,225,2389
Karluk,2007,2620,,226,5009
Karluk,2007,540,,227,5549
Karluk,2007,382,,228,5931
Karluk,2007,1998,,229,7929
Karluk,2007,1294,,230,9223
Karluk,2007,943,,231,10166
Karluk,2007,1948,,232,12114
Karluk,2007,3353,,233,15467
Karluk,2007,2277,,234,17744
Karluk,2007,4105,,235,21849
Karluk,2007,14146,,236,35995
Karluk,2007,1613,,237,37608
Karluk,2007,271,,238,37879
Karluk,2007,3425,,239,41304
Karluk,2007,4039,,240,45343
Karluk,2007,21246,,241,66589
Karluk,2007,15801,,242,82390
Karluk,2007,7627,,243,90017
Karluk,2007,6595,,244,96612
Karluk,2007,16836,,245,113448
Karluk,2007,7360,,246,120808
Karluk,2007,10937,,247,131745
Karluk,2007,52748,,248,184493
Karluk,2007,5914,,249,190407
Karluk,2007,1934,,250,192341
Karluk,2007,30507,,251,222848
Karluk,2007,5578,,252,228426
Karluk,2007,1315,,253,229741
Karluk,2007,304,,254,230045
Karluk,2007,3222,,255,233267
Karluk,2007,1058,,256,234325
Karluk,2007,3617,,257,237942
Karluk,2007,1035,,258,238977
Karluk,2007,283,,259,239260
Karluk,2007,5264,,260,244524
Karluk,2007,127,,261,244651
Karluk,2007,1693,,262,246344
Karluk,2007,17,,263,246361
Karluk,2007,89,,264,246450
Karluk,2007,9,,265,246459
Karluk,2007,202,,266,246661
Karluk,2007,30,,267,246691
Karluk,2007,13,,268,246704
Karluk,2007,3000,,269,249704
Karluk,2007,0,,270,249704
Karluk,2007,0,,271,249704
Karluk,2007,0,,272,249704
Karluk,2007,0,,273,249704
Karluk,2007,0,,274,249704
Karluk,2007,0,,275,249704
Karluk,2007,0,,276,249704
Karluk,2007,0,,277,249704
Karluk,2007,0,,278,249704
Karluk,2007,0,,279,249704
Karluk,2007,0,,280,249704
Karluk,2007,0,,281,249704
Karluk,2007,0,,282,249704
Karluk,2007,0,,283,249704
Karluk,2007,0,,284,249704
Karluk,2007,0,,285,249704
Karluk,2006,0,,154,0
Karluk,2006,0,,155,0
Karluk,2006,0,,156,0
Karluk,2006,0,,157,0
Karluk,2006,0,,158,0
Karluk,2006,0,,159,0
Karluk,2006,0,,160,0
Karluk,2006,0,,161,0
Karluk,2006,0,,162,0
Karluk,2006,0,,163,0
Karluk,2006,0,,164,0
Karluk,2006,0,,165,0
Karluk,2006,0,,166,0
Karluk,2006,0,,167,0
Karluk,2006,0,,168,0
Karluk,2006,0,,169,0
Karluk,2006,0,,170,0
Karluk,2006,0,,171,0
Karluk,2006,0,,172,0
Karluk,2006,0,,173,0
Karluk,2006,0,,174,0
Karluk,2006,0,,175,0
Karluk,2006,0,,176,0
Karluk,2006,0,,177,0
Karluk,2006,0,,178,0
Karluk,2006,0,,179,0
Karluk,2006,0,,180,0
Karluk,2006,0,,181,0
Karluk,2006,0,,182,0
Karluk,2006,0,,183,0
Karluk,2006,1,,184,1
Karluk,2006,0,,185,1
Karluk,2006,0,,186,1
Karluk,2006,0,,187,1
Karluk,2006,1,,188,2
Karluk,2006,1,,189,3
Karluk,2006,0,,190,3
Karluk,2006,0,,191,3
Karluk,2006,1,,192,4
Karluk,2006,0,,193,4
Karluk,2006,0,,194,4
Karluk,2006,0,,195,4
Karluk,2006,0,,196,4
Karluk,2006,1,,197,5
Karluk,2006,0,,198,5
Karluk,2006,0,,199,5
Karluk,2006,0,,200,5
Karluk,2006,0,,201,5
Karluk,2006,3,,202,8
Karluk,2006,0,,203,8
Karluk,2006,2,,204,10
Karluk,2006,17,,205,27
Karluk,2006,16,,206,43
Karluk,2006,1,,207,44
Karluk,2006,1,,208,45
Karluk,2006,4,,209,49
Karluk,2006,0,,210,49
Karluk,2006,0,,211,49
Karluk,2006,1,,212,50
Karluk,2006,8,,213,58
Karluk,2006,35,,214,93
Karluk,2006,11,,215,104
Karluk,2006,9052,,216,9156
Karluk,2006,53,,217,9209
Karluk,2006,38,,218,9247
Karluk,2006,0,,219,9247
Karluk,2006,55,,220,9302
Karluk,2006,2927,,221,12229
Karluk,2006,125,,222,12354
Karluk,2006,18501,,223,30855
Karluk,2006,28450,,224,59305
Karluk,2006,11418,,225,70723
Karluk,2006,9513,,226,80236
Karluk,2006,30134,,227,110370
Karluk,2006,31812,,228,142182
Karluk,2006,48755,,229,190937
Karluk,2006,75476,,230,266413
Karluk,2006,54786,,231,321199
Karluk,2006,70658,,232,391857
Karluk,2006,7522,,233,399379
Karluk,2006,44726,,234,444105
Karluk,2006,32217,,235,476322
Karluk,2006,39656,,236,515978
Karluk,2006,107098,,237,623076
Karluk,2006,67672,,238,690748
Karluk,2006,52275,,239,743023
Karluk,2006,63039,,240,806062
Karluk,2006,24583,,241,830645
Karluk,2006,8810,,242,839455
Karluk,2006,67538,,243,906993
Karluk,2006,12644,,244,919637
Karluk,2006,1083,,245,920720
Karluk,2006,4414,,246,925134
Karluk,2006,4805,,247,929939
Karluk,2006,6898,,248,936837
Karluk,2006,12890,,249,949727
Karluk,2006,9341,,250,959068
Karluk,2006,15610,,251,974678
Karluk,2006,11124,,252,985802
Karluk,2006,6210,,253,992012
Karluk,2006,4485,,254,996497
Karluk,2006,2141,,255,998638
Karluk,2006,733,,256,999371
Karluk,2006,9350,,257,1008721
Karluk,2006,4590,,258,1013311
Karluk,2006,2448,,259,1015759
Karluk,2006,2800,,260,1018559
Karluk,2006,92,,261,1018651
Karluk,2006,632,,262,1019283
Karluk,2006,0,,263,1019283
Karluk,2006,0,,264,1019283
Karluk,2006,0,,265,1019283
Karluk,2006,0,,266,1019283
Karluk,2006,0,,267,1019283
Karluk,2006,0,,268,1019283
Karluk,2006,0,,269,1019283
Karluk,2006,0,,270,1019283
Karluk,2006,0,,271,1019283
Karluk,2006,0,,272,1019283
Karluk,2006,0,,273,1019283
Karluk,2006,0,,274,1019283
Karluk,2006,0,,275,1019283
Karluk,2006,0,,276,1019283
Karluk,2006,0,,277,1019283
Karluk,2006,0,,278,1019283
Karluk,2006,0,,279,1019283
Karluk,2006,0,,280,1019283
Karluk,2006,0,,281,1019283
Karluk,2006,0,,282,1019283
Karluk,2006,0,,283,1019283
Karluk,2006,0,,284,1019283
Karluk,2006,0,,285,1019283
Karluk,2005,0,,154,0
Karluk,2005,0,,155,0
Karluk,2005,0,,156,0
Karluk,2005,0,,157,0
Karluk,2005,0,,158,0
Karluk,2005,0,,159,0
Karluk,2005,0,,160,0
Karluk,2005,0,,161,0
Karluk,2005,0,,162,0
Karluk,2005,0,,163,0
Karluk,2005,0,,164,0
Karluk,2005,0,,165,0
Karluk,2005,0,,166,0
Karluk,2005,0,,167,0
Karluk,2005,0,,168,0
Karluk,2005,0,,169,0
Karluk,2005,0,,170,0
Karluk,2005,0,,171,0
Karluk,2005,0,,172,0
Karluk,2005,0,,173,0
Karluk,2005,0,,174,0
Karluk,2005,1,,175,1
Karluk,2005,1,,176,2
Karluk,2005,3,,177,5
Karluk,2005,1,,178,6
Karluk,2005,0,,179,6
Karluk,2005,3,,180,9
Karluk,2005,0,,181,9
Karluk,2005,0,,182,9
Karluk,2005,4,,183,13
Karluk,2005,5,,184,18
Karluk,2005,0,,185,18
Karluk,2005,0,,186,18
Karluk,2005,11,,187,29
Karluk,2005,0,,188,29
Karluk,2005,7,,189,36
Karluk,2005,1,,190,37
Karluk,2005,7,,191,44
Karluk,2005,1,,192,45
Karluk,2005,3,,193,48
Karluk,2005,0,,194,48
Karluk,2005,0,,195,48
Karluk,2005,1,,196,49
Karluk,2005,4,,197,53
Karluk,2005,2,,198,55
Karluk,2005,14,,199,69
Karluk,2005,25,,200,94
Karluk,2005,0,,201,94
Karluk,2005,25,,202,119
Karluk,2005,8,,203,127
Karluk,2005,40,,204,167
Karluk,2005,12,,205,179
Karluk,2005,8,,206,187
Karluk,2005,103,,207,290
Karluk,2005,83,,208,373
Karluk,2005,35,,209,408
Karluk,2005,66,,210,474
Karluk,2005,383,,211,857
Karluk,2005,235,,212,1092
Karluk,2005,2842,,213,3934
Karluk,2005,1774,,214,5708
Karluk,2005,7290,,215,12998
Karluk,2005,936,,216,13934
Karluk,2005,65,,217,13999
Karluk,2005,10,,218,14009
Karluk,2005,323,,219,14332
Karluk,2005,139,,220,14471
Karluk,2005,285,,221,14756
Karluk,2005,2633,,222,17389
Karluk,2005,35,,223,17424
Karluk,2005,457,,224,17881
Karluk,2005,1276,,225,19157
Karluk,2005,2565,,226,21722
Karluk,2005,1198,,227,22920
Karluk,2005,3939,,228,26859
Karluk,2005,15815,,229,42674
Karluk,2005,5037,,230,47711
Karluk,2005,3011,,231,50722
Karluk,2005,9021,,232,59743
Karluk,2005,5569,,233,65312
Karluk,2005,3893,,234,69205
Karluk,2005,23861,,235,93066
Karluk,2005,19409,,236,112475
Karluk,2005,3534,,237,116009
Karluk,2005,6251,,238,122260
Karluk,2005,15375,,239,137635
Karluk,2005,9807,,240,147442
Karluk,2005,4010,,241,151452
Karluk,2005,22952,,242,174404
Karluk,2005,7100,,243,181504
Karluk,2005,6187,,244,187691
Karluk,2005,11921,,245,199612
Karluk,2005,3545,,246,203157
Karluk,2005,10268,,247,213425
Karluk,2005,2670,,248,216095
Karluk,2005,8030,,249,224125
Karluk,2005,4547,,250,228672
Karluk,2005,269,,251,228941
Karluk,2005,2353,,252,231294
Karluk,2005,1366,,253,232660
Karluk,2005,262,,254,232922
Karluk,2005,167,,255,233089
Karluk,2005,133,,256,233222
Karluk,2005,184,,257,233406
Karluk,2005,351,,258,233757
Karluk,2005,212,,259,233969
Karluk,2005,15,,260,233984
Karluk,2005,156,,261,234140
Karluk,2005,21,,262,234161
Karluk,2005,77,,263,234238
Karluk,2005,0,,264,234238
Karluk,2005,4,,265,234242
Karluk,2005,39,,266,234281
Karluk,2005,0,,267,234281
Karluk,2005,0,,268,234281
Karluk,2005,0,,269,234281
Karluk,2005,0,,270,234281
Karluk,2005,0,,271,234281
Karluk,2005,0,,272,234281
Karluk,2005,0,,273,234281
Karluk,2005,0,,274,234281
Karluk,2005,0,,275,234281
Karluk,2005,0,,276,234281
Karluk,2005,0,,277,234281
Karluk,2005,0,,278,234281
Karluk,2005,0,,279,234281
Karluk,2005,0,,280,234281
Karluk,2005,0,,281,234281
Karluk,2005,0,,282,234281
Karluk,2005,0,,283,234281
Karluk,2005,0,,284,234281
Karluk,2005,0,,285,234281
Karluk,2004,0,,155,0
Karluk,2004,0,,156,0
Karluk,2004,0,,157,0
Karluk,2004,0,,158,0
Karluk,2004,0,,159,0
Karluk,2004,0,,160,0
Karluk,2004,0,,161,0
Karluk,2004,0,,162,0
Karluk,2004,0,,163,0
Karluk,2004,0,,164,0
Karluk,2004,0,,165,0
Karluk,2004,0,,166,0
Karluk,2004,0,,167,0
Karluk,2004,0,,168,0
Karluk,2004,0,,169,0
Karluk,2004,0,,170,0
Karluk,2004,0,,171,0
Karluk,2004,0,,172,0
Karluk,2004,0,,173,0
Karluk,2004,0,,174,0
Karluk,2004,0,,175,0
Karluk,2004,0,,176,0
Karluk,2004,0,,177,0
Karluk,2004,0,,178,0
Karluk,2004,0,,179,0
Karluk,2004,0,,180,0
Karluk,2004,0,,181,0
Karluk,2004,0,,182,0
Karluk,2004,0,,183,0
Karluk,2004,0,,184,0
Karluk,2004,0,,185,0
Karluk,2004,0,,186,0
Karluk,2004,0,,187,0
Karluk,2004,0,,188,0
Karluk,2004,0,,189,0
Karluk,2004,0,,190,0
Karluk,2004,0,,191,0
Karluk,2004,0,,192,0
Karluk,2004,2,,193,2
Karluk,2004,1,,194,3
Karluk,2004,1,,195,4
Karluk,2004,0,,196,4
Karluk,2004,0,,197,4
Karluk,2004,0,,198,4
Karluk,2004,0,,199,4
Karluk,2004,2,,200,6
Karluk,2004,1,,201,7
Karluk,2004,0,,202,7
Karluk,2004,0,,203,7
Karluk,2004,2,,204,9
Karluk,2004,11,,205,20
Karluk,2004,17,,206,37
Karluk,2004,13,,207,50
Karluk,2004,733,,208,783
Karluk,2004,2,,209,785
Karluk,2004,1,,210,786
Karluk,2004,0,,211,786
Karluk,2004,0,,212,786
Karluk,2004,158,,213,944
Karluk,2004,1,,214,945
Karluk,2004,1,,215,946
Karluk,2004,23002,,216,23948
Karluk,2004,1827,,217,25775
Karluk,2004,10937,,218,36712
Karluk,2004,2698,,219,39410
Karluk,2004,2517,,220,41927
Karluk,2004,61678,,221,103605
Karluk,2004,120736,,222,224341
Karluk,2004,45223,,223,269564
Karluk,2004,100966,,224,370530
Karluk,2004,179168,,225,549698
Karluk,2004,21712,,226,571410
Karluk,2004,2861,,227,574271
Karluk,2004,1614,,228,575885
Karluk,2004,1669,,229,577554
Karluk,2004,24354,,230,601908
Karluk,2004,26999,,231,628907
Karluk,2004,51656,,232,680563
Karluk,2004,8367,,233,688930
Karluk,2004,13277,,234,702207
Karluk,2004,29026,,235,731233
Karluk,2004,41657,,236,772890
Karluk,2004,110253,,237,883143
Karluk,2004,100505,,238,983648
Karluk,2004,101978,,239,1085626
Karluk,2004,91182,,240,1176808
Karluk,2004,36082,,241,1212890
Karluk,2004,30124,,242,1243014
Karluk,2004,50024,,243,1293038
Karluk,2004,46241,,244,1339279
Karluk,2004,66547,,245,1405826
Karluk,2004,65400,,246,1471226
Karluk,2004,14704,,247,1485930
Karluk,2004,4856,,248,1490786
Karluk,2004,3057,,249,1493843
Karluk,2004,7369,,250,1501212
Karluk,2004,5115,,251,1506327
Karluk,2004,1668,,252,1507995
Karluk,2004,7410,,253,1515405
Karluk,2004,1678,,254,1517083
Karluk,2004,1573,,255,1518656
Karluk,2004,661,,256,1519317
Karluk,2004,432,,257,1519749
Karluk,2004,297,,258,1520046
Karluk,2004,327,,259,1520373
Karluk,2004,606,,260,1520979
Karluk,2004,221,,261,1521200
Karluk,2004,192,,262,1521392
Karluk,2004,186,,263,1521578
Karluk,2004,473,,264,1522051
Karluk,2004,192,,265,1522243
Karluk,2004,57,,266,1522300
Karluk,2004,104,,267,1522404
Karluk,2004,60,,268,1522464
Karluk,2004,0,,269,1522464
Karluk,2004,13,,270,1522477
Karluk,2004,18,,271,1522495
Karluk,2004,180,,272,1522675
Karluk,2004,0,,273,1522675
Karluk,2004,0,,274,1522675
Karluk,2004,0,,275,1522675
Karluk,2004,0,,276,1522675
Karluk,2004,0,,277,1522675
Karluk,2004,0,,278,1522675
Karluk,2004,0,,279,1522675
Karluk,2004,0,,280,1522675
Karluk,2004,0,,281,1522675
Karluk,2004,0,,282,1522675
Karluk,2004,0,,283,1522675
Karluk,2004,0,,284,1522675
Karluk,2004,0,,285,1522675
Karluk,2004,0,,286,1522675
Karluk,2003,0,,154,0
Karluk,2003,0,,155,0
Karluk,2003,0,,156,0
Karluk,2003,0,,157,0
Karluk,2003,0,,158,0
Karluk,2003,0,,159,0
Karluk,2003,0,,160,0
Karluk,2003,0,,161,0
Karluk,2003,0,,162,0
Karluk,2003,0,,163,0
Karluk,2003,0,,164,0
Karluk,2003,0,,165,0
Karluk,2003,0,,166,0
Karluk,2003,0,,167,0
Karluk,2003,0,,168,0
Karluk,2003,0,,169,0
Karluk,2003,0,,170,0
Karluk,2003,0,,171,0
Karluk,2003,0,,172,0
Karluk,2003,0,,173,0
Karluk,2003,0,,174,0
Karluk,2003,0,,175,0
Karluk,2003,0,,176,0
Karluk,2003,0,,177,0
Karluk,2003,0,,178,0
Karluk,2003,0,,179,0
Karluk,2003,0,,180,0
Karluk,2003,0,,181,0
Karluk,2003,2,,182,2
Karluk,2003,0,,183,2
Karluk,2003,0,,184,2
Karluk,2003,12,,185,14
Karluk,2003,3,,186,17
Karluk,2003,0,,187,17
Karluk,2003,1,,188,18
Karluk,2003,7,,189,25
Karluk,2003,19,,190,44
Karluk,2003,18,,191,62
Karluk,2003,51,,192,113
Karluk,2003,77,,193,190
Karluk,2003,0,,194,190
Karluk,2003,2,,195,192
Karluk,2003,21,,196,213
Karluk,2003,94,,197,307
Karluk,2003,7,,198,314
Karluk,2003,0,,199,314
Karluk,2003,5,,200,319
Karluk,2003,14,,201,333
Karluk,2003,9,,202,342
Karluk,2003,190,,203,532
Karluk,2003,464,,204,996
Karluk,2003,37,,205,1033
Karluk,2003,38,,206,1071
Karluk,2003,15,,207,1086
Karluk,2003,325,,208,1411
Karluk,2003,3540,,209,4951
Karluk,2003,217,,210,5168
Karluk,2003,917,,211,6085
Karluk,2003,15844,,212,21929
Karluk,2003,4652,,213,26581
Karluk,2003,1225,,214,27806
Karluk,2003,304,,215,28110
Karluk,2003,122,,216,28232
Karluk,2003,1017,,217,29249
Karluk,2003,4299,,218,33548
Karluk,2003,828,,219,34376
Karluk,2003,240,,220,34616
Karluk,2003,1660,,221,36276
Karluk,2003,6574,,222,42850
Karluk,2003,20026,,223,62876
Karluk,2003,19142,,224,82018
Karluk,2003,839,,225,82857
Karluk,2003,2918,,226,85775
Karluk,2003,841,,227,86616
Karluk,2003,1036,,228,87652
Karluk,2003,627,,229,88279
Karluk,2003,1083,,230,89362
Karluk,2003,265,,231,89627
Karluk,2003,3470,,232,93097
Karluk,2003,1955,,233,95052
Karluk,2003,262,,234,95314
Karluk,2003,486,,235,95800
Karluk,2003,672,,236,96472
Karluk,2003,814,,237,97286
Karluk,2003,7612,,238,104898
Karluk,2003,5643,,239,110541
Karluk,2003,7990,,240,118531
Karluk,2003,4631,,241,123162
Karluk,2003,1232,,242,124394
Karluk,2003,2194,,243,126588
Karluk,2003,4049,,244,130637
Karluk,2003,639,,245,131276
Karluk,2003,2165,,246,133441
Karluk,2003,533,,247,133974
Karluk,2003,499,,248,134473
Karluk,2003,1812,,249,136285
Karluk,2003,1294,,250,137579
Karluk,2003,898,,251,138477
Karluk,2003,1057,,252,139534
Karluk,2003,453,,253,139987
Karluk,2003,128,,254,140115
Karluk,2003,157,,255,140272
Karluk,2003,17,,256,140289
Karluk,2003,120,,257,140409
Karluk,2003,136,,258,140545
Karluk,2003,64,,259,140609
Karluk,2003,30,,260,140639
Karluk,2003,4,,261,140643
Karluk,2003,25,,262,140668
Karluk,2003,1,,263,140669
Karluk,2003,6,,264,140675
Karluk,2003,20,,265,140695
Karluk,2003,0,,266,140695
Karluk,2003,36,,267,140731
Karluk,2003,35,,268,140766
Karluk,2003,16,,269,140782
Karluk,2003,2,,270,140784
Karluk,2003,10,,271,140794
Karluk,2003,0,,272,140794
Karluk,2003,0,,273,140794
Karluk,2003,0,,274,140794
Karluk,2003,0,,275,140794
Karluk,2003,0,,276,140794
Karluk,2003,0,,277,140794
Karluk,2003,0,,278,140794
Karluk,2003,0,,279,140794
Karluk,2003,0,,280,140794
Karluk,2003,0,,281,140794
Karluk,2003,0,,282,140794
Karluk,2003,0,,283,140794
Karluk,2003,0,,284,140794
Karluk,2003,0,,285,140794
Karluk,2002,0,,154,0
Karluk,2002,0,,155,0
Karluk,2002,0,,156,0
Karluk,2002,0,,157,0
Karluk,2002,0,,158,0
Karluk,2002,0,,159,0
Karluk,2002,0,,160,0
Karluk,2002,0,,161,0
Karluk,2002,0,,162,0
Karluk,2002,0,,163,0
Karluk,2002,0,,164,0
Karluk,2002,0,,165,0
Karluk,2002,0,,166,0
Karluk,2002,0,,167,0
Karluk,2002,0,,168,0
Karluk,2002,0,,169,0
Karluk,2002,0,,170,0
Karluk,2002,0,,171,0
Karluk,2002,0,,172,0
Karluk,2002,0,,173,0
Karluk,2002,0,,174,0
Karluk,2002,0,,175,0
Karluk,2002,0,,176,0
Karluk,2002,0,,177,0
Karluk,2002,0,,178,0
Karluk,2002,0,,179,0
Karluk,2002,0,,180,0
Karluk,2002,0,,181,0
Karluk,2002,3,,182,3
Karluk,2002,0,,183,3
Karluk,2002,0,,184,3
Karluk,2002,11,,185,14
Karluk,2002,13,,186,27
Karluk,2002,6,,187,33
Karluk,2002,19,,188,52
Karluk,2002,25,,189,77
Karluk,2002,13,,190,90
Karluk,2002,27,,191,117
Karluk,2002,15,,192,132
Karluk,2002,14,,193,146
Karluk,2002,0,,194,146
Karluk,2002,0,,195,146
Karluk,2002,5,,196,151
Karluk,2002,13,,197,164
Karluk,2002,21,,198,185
Karluk,2002,1900,,199,2085
Karluk,2002,10476,,200,12561
Karluk,2002,3435,,201,15996
Karluk,2002,1082,,202,17078
Karluk,2002,1444,,203,18522
Karluk,2002,1135,,204,19657
Karluk,2002,8649,,205,28306
Karluk,2002,3073,,206,31379
Karluk,2002,1891,,207,33270
Karluk,2002,1899,,208,35169
Karluk,2002,7343,,209,42512
Karluk,2002,14634,,210,57146
Karluk,2002,41362,,211,98508
Karluk,2002,91518,,212,190026
Karluk,2002,92319,,213,282345
Karluk,2002,89931,,214,372276
Karluk,2002,35985,,215,408261
Karluk,2002,4347,,216,412608
Karluk,2002,98902,,217,511510
Karluk,2002,19438,,218,530948
Karluk,2002,6405,,219,537353
Karluk,2002,49557,,220,586910
Karluk,2002,29868,,221,616778
Karluk,2002,71271,,222,688049
Karluk,2002,53637,,223,741686
Karluk,2002,107019,,224,848705
Karluk,2002,74775,,225,923480
Karluk,2002,40397,,226,963877
Karluk,2002,93768,,227,1057645
Karluk,2002,95272,,228,1152917
Karluk,2002,54969,,229,1207886
Karluk,2002,48651,,230,1256537
Karluk,2002,18758,,231,1275295
Karluk,2002,101671,,232,1376966
Karluk,2002,23118,,233,1400084
Karluk,2002,15859,,234,1415943
Karluk,2002,11105,,235,1427048
Karluk,2002,26792,,236,1453840
Karluk,2002,39415,,237,1493255
Karluk,2002,14212,,238,1507467
Karluk,2002,20168,,239,1527635
Karluk,2002,27580,,240,1555215
Karluk,2002,28990,,241,1584205
Karluk,2002,24468,,242,1608673
Karluk,2002,13470,,243,1622143
Karluk,2002,15941,,244,1638084
Karluk,2002,10013,,245,1648097
Karluk,2002,3706,,246,1651803
Karluk,2002,10488,,247,1662291
Karluk,2002,13037,,248,1675328
Karluk,2002,1112,,249,1676440
Karluk,2002,3141,,250,1679581
Karluk,2002,1797,,251,1681378
Karluk,2002,1441,,252,1682819
Karluk,2002,622,,253,1683441
Karluk,2002,247,,254,1683688
Karluk,2002,436,,255,1684124
Karluk,2002,364,,256,1684488
Karluk,2002,53,,257,1684541
Karluk,2002,60,,258,1684601
Karluk,2002,46,,259,1684647
Karluk,2002,4318,,260,1688965
Karluk,2002,1295,,261,1690260
Karluk,2002,1006,,262,1691266
Karluk,2002,223,,263,1691489
Karluk,2002,68,,264,1691557
Karluk,2002,87,,265,1691644
Karluk,2002,1683,,266,1693327
Karluk,2002,1100,,267,1694427
Karluk,2002,16,,268,1694443
Karluk,2002,27,,269,1694470
Karluk,2002,43,,270,1694513
Karluk,2002,0,,271,1694513
Karluk,2002,0,,272,1694513
Karluk,2002,0,,273,1694513
Karluk,2002,0,,274,1694513
Karluk,2002,0,,275,1694513
Karluk,2002,0,,276,1694513
Karluk,2002,0,,277,1694513
Karluk,2002,0,,278,1694513
Karluk,2002,0,,279,1694513
Karluk,2002,0,,280,1694513
Karluk,2002,0,,281,1694513
Karluk,2002,0,,282,1694513
Karluk,2002,0,,283,1694513
Karluk,2002,0,,284,1694513
Karluk,2002,0,,285,1694513
Karluk,2001,0,,154,0
Karluk,2001,0,,155,0
Karluk,2001,0,,156,0
Karluk,2001,0,,157,0
Karluk,2001,0,,158,0
Karluk,2001,0,,159,0
Karluk,2001,0,,160,0
Karluk,2001,0,,161,0
Karluk,2001,0,,162,0
Karluk,2001,0,,163,0
Karluk,2001,0,,164,0
Karluk,2001,0,,165,0
Karluk,2001,0,,166,0
Karluk,2001,0,,167,0
Karluk,2001,2,,168,2
Karluk,2001,0,,169,2
Karluk,2001,0,,170,2
Karluk,2001,0,,171,2
Karluk,2001,0,,172,2
Karluk,2001,0,,173,2
Karluk,2001,0,,174,2
Karluk,2001,1,,175,3
Karluk,2001,0,,176,3
Karluk,2001,0,,177,3
Karluk,2001,0,,178,3
Karluk,2001,0,,179,3
Karluk,2001,1,,180,4
Karluk,2001,0,,181,4
Karluk,2001,0,,182,4
Karluk,2001,0,,183,4
Karluk,2001,0,,184,4
Karluk,2001,0,,185,4
Karluk,2001,0,,186,4
Karluk,2001,0,,187,4
Karluk,2001,0,,188,4
Karluk,2001,0,,189,4
Karluk,2001,0,,190,4
Karluk,2001,1,,191,5
Karluk,2001,0,,192,5
Karluk,2001,32,,193,37
Karluk,2001,2,,194,39
Karluk,2001,4,,195,43
Karluk,2001,0,,196,43
Karluk,2001,0,,197,43
Karluk,2001,0,,198,43
Karluk,2001,0,,199,43
Karluk,2001,16,,200,59
Karluk,2001,13,,201,72
Karluk,2001,11,,202,83
Karluk,2001,63,,203,146
Karluk,2001,8,,204,154
Karluk,2001,19,,205,173
Karluk,2001,14,,206,187
Karluk,2001,4,,207,191
Karluk,2001,34,,208,225
Karluk,2001,12,,209,237
Karluk,2001,24,,210,261
Karluk,2001,151,,211,412
Karluk,2001,164,,212,576
Karluk,2001,655,,213,1231
Karluk,2001,1940,,214,3171
Karluk,2001,664,,215,3835
Karluk,2001,127,,216,3962
Karluk,2001,1282,,217,5244
Karluk,2001,2388,,218,7632
Karluk,2001,361,,219,7993
Karluk,2001,371,,220,8364
Karluk,2001,1780,,221,10144
Karluk,2001,659,,222,10803
Karluk,2001,3354,,223,14157
Karluk,2001,919,,224,15076
Karluk,2001,656,,225,15732
Karluk,2001,1134,,226,16866
Karluk,2001,1016,,227,17882
Karluk,2001,1144,,228,19026
Karluk,2001,6416,,229,25442
Karluk,2001,2250,,230,27692
Karluk,2001,239,,231,27931
Karluk,2001,1370,,232,29301
Karluk,2001,499,,233,29800
Karluk,2001,512,,234,30312
Karluk,2001,271,,235,30583
Karluk,2001,423,,236,31006
Karluk,2001,345,,237,31351
Karluk,2001,673,,238,32024
Karluk,2001,504,,239,32528
Karluk,2001,3069,,240,35597
Karluk,2001,2432,,241,38029
Karluk,2001,3019,,242,41048
Karluk,2001,3134,,243,44182
Karluk,2001,3847,,244,48029
Karluk,2001,3382,,245,51411
Karluk,2001,521,,246,51932
Karluk,2001,373,,247,52305
Karluk,2001,1172,,248,53477
Karluk,2001,527,,249,54004
Karluk,2001,1936,,250,55940
Karluk,2001,722,,251,56662
Karluk,2001,689,,252,57351
Karluk,2001,165,,253,57516
Karluk,2001,298,,254,57814
Karluk,2001,236,,255,58050
Karluk,2001,599,,256,58649
Karluk,2001,361,,257,59010
Karluk,2001,97,,258,59107
Karluk,2001,107,,259,59214
Karluk,2001,5620,,260,64834
Karluk,2001,720,,261,65554
Karluk,2001,1000,,262,66554
Karluk,2001,0,,263,66554
Karluk,2001,0,,264,66554
Karluk,2001,0,,265,66554
Karluk,2001,0,,266,66554
Karluk,2001,0,,267,66554
Karluk,2001,0,,268,66554
Karluk,2001,0,,269,66554
Karluk,2001,0,,270,66554
Karluk,2001,0,,271,66554
Karluk,2001,0,,272,66554
Karluk,2001,0,,273,66554
Karluk,2001,0,,274,66554
Karluk,2001,0,,275,66554
Karluk,2001,0,,276,66554
Karluk,2001,0,,277,66554
Karluk,2001,0,,278,66554
Karluk,2001,0,,279,66554
Karluk,2001,0,,280,66554
Karluk,2001,0,,281,66554
Karluk,2001,0,,282,66554
Karluk,2001,0,,283,66554
Karluk,2001,0,,284,66554
Karluk,2001,0,,285,66554
Karluk,2000,0,,155,0
Karluk,2000,0,,156,0
Karluk,2000,0,,157,0
Karluk,2000,0,,158,0
Karluk,2000,0,,159,0
Karluk,2000,0,,160,0
Karluk,2000,0,,161,0
Karluk,2000,0,,162,0
Karluk,2000,0,,163,0
Karluk,2000,0,,164,0
Karluk,2000,0,,165,0
Karluk,2000,0,,166,0
Karluk,2000,0,,167,0
Karluk,2000,0,,168,0
Karluk,2000,0,,169,0
Karluk,2000,0,,170,0
Karluk,2000,0,,171,0
Karluk,2000,0,,172,0
Karluk,2000,0,,173,0
Karluk,2000,0,,174,0
Karluk,2000,0,,175,0
Karluk,2000,0,,176,0
Karluk,2000,0,,177,0
Karluk,2000,0,,178,0
Karluk,2000,0,,179,0
Karluk,2000,0,,180,0
Karluk,2000,0,,181,0
Karluk,2000,0,,182,0
Karluk,2000,0,,183,0
Karluk,2000,0,,184,0
Karluk,2000,0,,185,0
Karluk,2000,0,,186,0
Karluk,2000,0,,187,0
Karluk,2000,0,,188,0
Karluk,2000,0,,189,0
Karluk,2000,0,,190,0
Karluk,2000,0,,191,0
Karluk,2000,0,,192,0
Karluk,2000,12,,193,12
Karluk,2000,19,,194,31
Karluk,2000,37,,195,68
Karluk,2000,2,,196,70
Karluk,2000,11,,197,81
Karluk,2000,32,,198,113
Karluk,2000,2,,199,115
Karluk,2000,2,,200,117
Karluk,2000,17,,201,134
Karluk,2000,12,,202,146
Karluk,2000,16,,203,162
Karluk,2000,17,,204,179
Karluk,2000,18,,205,197
Karluk,2000,59,,206,256
Karluk,2000,166,,207,422
Karluk,2000,18,,208,440
Karluk,2000,1,,209,441
Karluk,2000,153,,210,594
Karluk,2000,228,,211,822
Karluk,2000,105,,212,927
Karluk,2000,16365,,213,17292
Karluk,2000,6724,,214,24016
Karluk,2000,44197,,215,68213
Karluk,2000,15146,,216,83359
Karluk,2000,12681,,217,96040
Karluk,2000,6978,,218,103018
Karluk,2000,19575,,219,122593
Karluk,2000,88153,,220,210746
Karluk,2000,16262,,221,227008
Karluk,2000,12630,,222,239638
Karluk,2000,11711,,223,251349
Karluk,2000,24152,,224,275501
Karluk,2000,19740,,225,295241
Karluk,2000,130565,,226,425806
Karluk,2000,35316,,227,461122
Karluk,2000,4315,,228,465437
Karluk,2000,6631,,229,472068
Karluk,2000,32659,,230,504727
Karluk,2000,51955,,231,556682
Karluk,2000,39027,,232,595709
Karluk,2000,14425,,233,610134
Karluk,2000,21250,,234,631384
Karluk,2000,61202,,235,692586
Karluk,2000,24083,,236,716669
Karluk,2000,30690,,237,747359
Karluk,2000,92940,,238,840299
Karluk,2000,54660,,239,894959
Karluk,2000,91366,,240,986325
Karluk,2000,36217,,241,1022542
Karluk,2000,31296,,242,1053838
Karluk,2000,7575,,243,1061413
Karluk,2000,7063,,244,1068476
Karluk,2000,2191,,245,1070667
Karluk,2000,3793,,246,1074460
Karluk,2000,1140,,247,1075600
Karluk,2000,3174,,248,1078774
Karluk,2000,936,,249,1079710
Karluk,2000,6292,,250,1086002
Karluk,2000,2548,,251,1088550
Karluk,2000,3094,,252,1091644
Karluk,2000,55,,253,1091699
Karluk,2000,1188,,254,1092887
Karluk,2000,1846,,255,1094733
Karluk,2000,605,,256,1095338
Karluk,2000,579,,257,1095917
Karluk,2000,661,,258,1096578
Karluk,2000,47,,259,1096625
Karluk,2000,94,,260,1096719
Karluk,2000,7,,261,1096726
Karluk,2000,9,,262,1096735
Karluk,2000,19,,263,1096754
Karluk,2000,8,,264,1096762
Karluk,2000,59,,265,1096821
Karluk,2000,83,,266,1096904
Karluk,2000,12,,267,1096916
Karluk,2000,0,,268,1096916
Karluk,2000,0,,269,1096916
Karluk,2000,0,,270,1096916
Karluk,2000,0,,271,1096916
Karluk,2000,0,,272,1096916
Karluk,2000,0,,273,1096916
Karluk,2000,0,,274,1096916
Karluk,2000,0,,275,1096916
Karluk,2000,0,,276,1096916
Karluk,2000,0,,277,1096916
Karluk,2000,0,,278,1096916
Karluk,2000,0,,279,1096916
Karluk,2000,0,,280,1096916
Karluk,2000,0,,281,1096916
Karluk,2000,0,,282,1096916
Karluk,2000,0,,283,1096916
Karluk,2000,0,,284,1096916
Karluk,2000,0,,285,1096916
Karluk,2000,0,,286,1096916
Karluk,1999,0,,154,0
Karluk,1999,0,,155,0
Karluk,1999,0,,156,0
Karluk,1999,0,,157,0
Karluk,1999,0,,158,0
Karluk,1999,0,,159,0
Karluk,1999,0,,160,0
Karluk,1999,0,,161,0
Karluk,1999,0,,162,0
Karluk,1999,0,,163,0
Karluk,1999,0,,164,0
Karluk,1999,0,,165,0
Karluk,1999,0,,166,0
Karluk,1999,0,,167,0
Karluk,1999,0,,168,0
Karluk,1999,0,,169,0
Karluk,1999,0,,170,0
Karluk,1999,0,,171,0
Karluk,1999,0,,172,0
Karluk,1999,0,,173,0
Karluk,1999,0,,174,0
Karluk,1999,0,,175,0
Karluk,1999,0,,176,0
Karluk,1999,0,,177,0
Karluk,1999,0,,178,0
Karluk,1999,0,,179,0
Karluk,1999,0,,180,0
Karluk,1999,0,,181,0
Karluk,1999,0,,182,0
Karluk,1999,0,,183,0
Karluk,1999,0,,184,0
Karluk,1999,0,,185,0
Karluk,1999,0,,186,0
Karluk,1999,0,,187,0
Karluk,1999,0,,188,0
Karluk,1999,0,,189,0
Karluk,1999,0,,190,0
Karluk,1999,0,,191,0
Karluk,1999,0,,192,0
Karluk,1999,0,,193,0
Karluk,1999,0,,194,0
Karluk,1999,0,,195,0
Karluk,1999,0,,196,0
Karluk,1999,0,,197,0
Karluk,1999,0,,198,0
Karluk,1999,0,,199,0
Karluk,1999,0,,200,0
Karluk,1999,0,,201,0
Karluk,1999,0,,202,0
Karluk,1999,0,,203,0
Karluk,1999,0,,204,0
Karluk,1999,2,,205,2
Karluk,1999,0,,206,2
Karluk,1999,0,,207,2
Karluk,1999,7,,208,9
Karluk,1999,0,,209,9
Karluk,1999,11,,210,20
Karluk,1999,3,,211,23
Karluk,1999,2,,212,25
Karluk,1999,1,,213,26
Karluk,1999,8,,214,34
Karluk,1999,1,,215,35
Karluk,1999,28,,216,63
Karluk,1999,6,,217,69
Karluk,1999,74,,218,143
Karluk,1999,61,,219,204
Karluk,1999,347,,220,551
Karluk,1999,658,,221,1209
Karluk,1999,311,,222,1520
Karluk,1999,393,,223,1913
Karluk,1999,1389,,224,3302
Karluk,1999,128,,225,3430
Karluk,1999,97,,226,3527
Karluk,1999,510,,227,4037
Karluk,1999,79,,228,4116
Karluk,1999,263,,229,4379
Karluk,1999,1234,,230,5613
Karluk,1999,1467,,231,7080
Karluk,1999,1072,,232,8152
Karluk,1999,1393,,233,9545
Karluk,1999,3229,,234,12774
Karluk,1999,1181,,235,13955
Karluk,1999,589,,236,14544
Karluk,1999,810,,237,15354
Karluk,1999,603,,238,15957
Karluk,1999,1849,,239,17806
Karluk,1999,478,,240,18284
Karluk,1999,671,,241,18955
Karluk,1999,1956,,242,20911
Karluk,1999,2077,,243,22988
Karluk,1999,1867,,244,24855
Karluk,1999,1687,,245,26542
Karluk,1999,10641,,246,37183
Karluk,1999,7409,,247,44592
Karluk,1999,2145,,248,46737
Karluk,1999,1657,,249,48394
Karluk,1999,8452,,250,56846
Karluk,1999,2436,,251,59282
Karluk,1999,3256,,252,62538
Karluk,1999,505,,253,63043
Karluk,1999,4336,,254,67379
Karluk,1999,610,,255,67989
Karluk,1999,201,,256,68190
Karluk,1999,362,,257,68552
Karluk,1999,132,,258,68684
Karluk,1999,410,,259,69094
Karluk,1999,456,,260,69550
Karluk,1999,16823,,261,86373
Karluk,1999,1641,,262,88014
Karluk,1999,421,,263,88435
Karluk,1999,177,,264,88612
Karluk,1999,548,,265,89160
Karluk,1999,0,,266,89160
Karluk,1999,0,,267,89160
Karluk,1999,0,,268,89160
Karluk,1999,0,,269,89160
Karluk,1999,0,,270,89160
Karluk,1999,0,,271,89160
Karluk,1999,0,,272,89160
Karluk,1999,0,,273,89160
Karluk,1999,0,,274,89160
Karluk,1999,0,,275,89160
Karluk,1999,0,,276,89160
Karluk,1999,0,,277,89160
Karluk,1999,0,,278,89160
Karluk,1999,0,,279,89160
Karluk,1999,0,,280,89160
Karluk,1999,0,,281,89160
Karluk,1999,0,,282,89160
Karluk,1999,0,,283,89160
Karluk,1999,0,,284,89160
Karluk,1999,0,,285,89160
Karluk,1998,0,,154,0
Karluk,1998,0,,155,0
Karluk,1998,0,,156,0
Karluk,1998,0,,157,0
Karluk,1998,0,,158,0
Karluk,1998,0,,159,0
Karluk,1998,0,,160,0
Karluk,1998,0,,161,0
Karluk,1998,0,,162,0
Karluk,1998,0,,163,0
Karluk,1998,0,,164,0
Karluk,1998,0,,165,0
Karluk,1998,0,,166,0
Karluk,1998,0,,167,0
Karluk,1998,0,,168,0
Karluk,1998,0,,169,0
Karluk,1998,0,,170,0
Karluk,1998,0,,171,0
Karluk,1998,0,,172,0
Karluk,1998,0,,173,0
Karluk,1998,0,,174,0
Karluk,1998,0,,175,0
Karluk,1998,0,,176,0
Karluk,1998,0,,177,0
Karluk,1998,0,,178,0
Karluk,1998,0,,179,0
Karluk,1998,0,,180,0
Karluk,1998,0,,181,0
Karluk,1998,0,,182,0
Karluk,1998,0,,183,0
Karluk,1998,0,,184,0
Karluk,1998,0,,185,0
Karluk,1998,0,,186,0
Karluk,1998,0,,187,0
Karluk,1998,0,,188,0
Karluk,1998,0,,189,0
Karluk,1998,0,,190,0
Karluk,1998,0,,191,0
Karluk,1998,8,,192,8
Karluk,1998,5,,193,13
Karluk,1998,7,,194,20
Karluk,1998,1,,195,21
Karluk,1998,0,,196,21
Karluk,1998,0,,197,21
Karluk,1998,0,,198,21
Karluk,1998,0,,199,21
Karluk,1998,0,,200,21
Karluk,1998,0,,201,21
Karluk,1998,9,,202,30
Karluk,1998,25,,203,55
Karluk,1998,5,,204,60
Karluk,1998,43,,205,103
Karluk,1998,3,,206,106
Karluk,1998,17,,207,123
Karluk,1998,12,,208,135
Karluk,1998,50,,209,185
Karluk,1998,178,,210,363
Karluk,1998,102,,211,465
Karluk,1998,822,,212,1287
Karluk,1998,2107,,213,3394
Karluk,1998,31266,,214,34660
Karluk,1998,3828,,215,38488
Karluk,1998,9,,216,38497
Karluk,1998,77182,,217,115679
Karluk,1998,38240,,218,153919
Karluk,1998,2420,,219,156339
Karluk,1998,11609,,220,167948
Karluk,1998,33687,,221,201635
Karluk,1998,25624,,222,227259
Karluk,1998,36596,,223,263855
Karluk,1998,17933,,224,281788
Karluk,1998,31281,,225,313069
Karluk,1998,58799,,226,371868
Karluk,1998,26648,,227,398516
Karluk,1998,176868,,228,575384
Karluk,1998,154709,,229,730093
Karluk,1998,8162,,230,738255
Karluk,1998,6846,,231,745101
Karluk,1998,40599,,232,785700
Karluk,1998,23273,,233,808973
Karluk,1998,60319,,234,869292
Karluk,1998,24582,,235,893874
Karluk,1998,73188,,236,967062
Karluk,1998,33605,,237,1000667
Karluk,1998,26810,,238,1027477
Karluk,1998,39782,,239,1067259
Karluk,1998,11401,,240,1078660
Karluk,1998,19478,,241,1098138
Karluk,1998,10195,,242,1108333
Karluk,1998,4528,,243,1112861
Karluk,1998,2375,,244,1115236
Karluk,1998,2500,,245,1117736
Karluk,1998,4000,,246,1121736
Karluk,1998,3438,,247,1125174
Karluk,1998,1901,,248,1127075
Karluk,1998,2261,,249,1129336
Karluk,1998,504,,250,1129840
Karluk,1998,948,,251,1130788
Karluk,1998,363,,252,1131151
Karluk,1998,222,,253,1131373
Karluk,1998,1135,,254,1132508
Karluk,1998,541,,255,1133049
Karluk,1998,494,,256,1133543
Karluk,1998,645,,257,1134188
Karluk,1998,345,,258,1134533
Karluk,1998,99,,259,1134632
Karluk,1998,148,,260,1134780
Karluk,1998,334,,261,1135114
Karluk,1998,106,,262,1135220
Karluk,1998,200,,263,1135420
Karluk,1998,15,,264,1135435
Karluk,1998,4,,265,1135439
Karluk,1998,0,,266,1135439
Karluk,1998,0,,267,1135439
Karluk,1998,0,,268,1135439
Karluk,1998,0,,269,1135439
Karluk,1998,0,,270,1135439
Karluk,1998,0,,271,1135439
Karluk,1998,0,,272,1135439
Karluk,1998,0,,273,1135439
Karluk,1998,0,,274,1135439
Karluk,1998,0,,275,1135439
Karluk,1998,0,,276,1135439
Karluk,1998,0,,277,1135439
Karluk,1998,0,,278,1135439
Karluk,1998,0,,279,1135439
Karluk,1998,0,,280,1135439
Karluk,1998,0,,281,1135439
Karluk,1998,0,,282,1135439
Karluk,1998,0,,283,1135439
Karluk,1998,0,,284,1135439
Karluk,1998,0,,285,1135439
Karluk,1997,0,,154,0
Karluk,1997,0,,155,0
Karluk,1997,0,,156,0
Karluk,1997,0,,157,0
Karluk,1997,0,,158,0
Karluk,1997,0,,159,0
Karluk,1997,0,,160,0
Karluk,1997,0,,161,0
Karluk,1997,0,,162,0
Karluk,1997,0,,163,0
Karluk,1997,0,,164,0
Karluk,1997,0,,165,0
Karluk,1997,0,,166,0
Karluk,1997,0,,167,0
Karluk,1997,0,,168,0
Karluk,1997,0,,169,0
Karluk,1997,0,,170,0
Karluk,1997,0,,171,0
Karluk,1997,0,,172,0
Karluk,1997,0,,173,0
Karluk,1997,0,,174,0
Karluk,1997,0,,175,0
Karluk,1997,0,,176,0
Karluk,1997,0,,177,0
Karluk,1997,0,,178,0
Karluk,1997,0,,179,0
Karluk,1997,0,,180,0
Karluk,1997,0,,181,0
Karluk,1997,0,,182,0
Karluk,1997,0,,183,0
Karluk,1997,0,,184,0
Karluk,1997,0,,185,0
Karluk,1997,0,,186,0
Karluk,1997,0,,187,0
Karluk,1997,0,,188,0
Karluk,1997,0,,189,0
Karluk,1997,0,,190,0
Karluk,1997,0,,191,0
Karluk,1997,0,,192,0
Karluk,1997,0,,193,0
Karluk,1997,1,,194,1
Karluk,1997,0,,195,1
Karluk,1997,1,,196,2
Karluk,1997,3,,197,5
Karluk,1997,2,,198,7
Karluk,1997,0,,199,7
Karluk,1997,2,,200,9
Karluk,1997,0,,201,9
Karluk,1997,2,,202,11
Karluk,1997,1,,203,12
Karluk,1997,0,,204,12
Karluk,1997,8,,205,20
Karluk,1997,1,,206,21
Karluk,1997,0,,207,21
Karluk,1997,4,,208,25
Karluk,1997,4,,209,29
Karluk,1997,7,,210,36
Karluk,1997,2,,211,38
Karluk,1997,55,,212,93
Karluk,1997,48,,213,141
Karluk,1997,89,,214,230
Karluk,1997,146,,215,376
Karluk,1997,77,,216,453
Karluk,1997,108,,217,561
Karluk,1997,367,,218,928
Karluk,1997,137,,219,1065
Karluk,1997,1190,,220,2255
Karluk,1997,4264,,221,6519
Karluk,1997,203,,222,6722
Karluk,1997,414,,223,7136
Karluk,1997,1491,,224,8627
Karluk,1997,3902,,225,12529
Karluk,1997,244,,226,12773
Karluk,1997,772,,227,13545
Karluk,1997,139,,228,13684
Karluk,1997,405,,229,14089
Karluk,1997,440,,230,14529
Karluk,1997,1291,,231,15820
Karluk,1997,2634,,232,18454
Karluk,1997,3957,,233,22411
Karluk,1997,853,,234,23264
Karluk,1997,1018,,235,24282
Karluk,1997,754,,236,25036
Karluk,1997,794,,237,25830
Karluk,1997,1105,,238,26935
Karluk,1997,3659,,239,30594
Karluk,1997,3054,,240,33648
Karluk,1997,6688,,241,40336
Karluk,1997,6942,,242,47278
Karluk,1997,10227,,243,57505
Karluk,1997,9161,,244,66666
Karluk,1997,6572,,245,73238
Karluk,1997,5963,,246,79201
Karluk,1997,3361,,247,82562
Karluk,1997,5741,,248,88303
Karluk,1997,6169,,249,94472
Karluk,1997,3141,,250,97613
Karluk,1997,5494,,251,103107
Karluk,1997,5165,,252,108272
Karluk,1997,1296,,253,109568
Karluk,1997,812,,254,110380
Karluk,1997,701,,255,111081
Karluk,1997,620,,256,111701
Karluk,1997,486,,257,112187
Karluk,1997,1147,,258,113334
Karluk,1997,882,,259,114216
Karluk,1997,222,,260,114438
Karluk,1997,173,,261,114611
Karluk,1997,73,,262,114684
Karluk,1997,50,,263,114734
Karluk,1997,12,,264,114746
Karluk,1997,48,,265,114794
Karluk,1997,41,,266,114835
Karluk,1997,43,,267,114878
Karluk,1997,3,,268,114881
Karluk,1997,0,,269,114881
Karluk,1997,0,,270,114881
Karluk,1997,0,,271,114881
Karluk,1997,0,,272,114881
Karluk,1997,0,,273,114881
Karluk,1997,0,,274,114881
Karluk,1997,0,,275,114881
Karluk,1997,0,,276,114881
Karluk,1997,0,,277,114881
Karluk,1997,0,,278,114881
Karluk,1997,0,,279,114881
Karluk,1997,0,,280,114881
Karluk,1997,0,,281,114881
Karluk,1997,0,,282,114881
Karluk,1997,0,,283,114881
Karluk,1997,0,,284,114881
Karluk,1997,0,,285,114881
Karluk,1996,0,,155,0
Karluk,1996,0,,156,0
Karluk,1996,0,,157,0
Karluk,1996,0,,158,0
Karluk,1996,0,,159,0
Karluk,1996,0,,160,0
Karluk,1996,0,,161,0
Karluk,1996,0,,162,0
Karluk,1996,0,,163,0
Karluk,1996,0,,164,0
Karluk,1996,0,,165,0
Karluk,1996,0,,166,0
Karluk,1996,0,,167,0
Karluk,1996,0,,168,0
Karluk,1996,0,,169,0
Karluk,1996,0,,170,0
Karluk,1996,0,,171,0
Karluk,1996,0,,172,0
Karluk,1996,0,,173,0
Karluk,1996,0,,174,0
Karluk,1996,0,,175,0
Karluk,1996,0,,176,0
Karluk,1996,0,,177,0
Karluk,1996,0,,178,0
Karluk,1996,0,,179,0
Karluk,1996,0,,180,0
Karluk,1996,0,,181,0
Karluk,1996,0,,182,0
Karluk,1996,0,,183,0
Karluk,1996,0,,184,0
Karluk,1996,0,,185,0
Karluk,1996,0,,186,0
Karluk,1996,1,,187,1
Karluk,1996,0,,188,1
Karluk,1996,0,,189,1
Karluk,1996,1,,190,2
Karluk,1996,0,,191,2
Karluk,1996,0,,192,2
Karluk,1996,1,,193,3
Karluk,1996,0,,194,3
Karluk,1996,0,,195,3
Karluk,1996,0,,196,3
Karluk,1996,0,,197,3
Karluk,1996,0,,198,3
Karluk,1996,0,,199,3
Karluk,1996,0,,200,3
Karluk,1996,0,,201,3
Karluk,1996,1,,202,4
Karluk,1996,2,,203,6
Karluk,1996,4,,204,10
Karluk,1996,5,,205,15
Karluk,1996,0,,206,15
Karluk,1996,46,,207,61
Karluk,1996,0,,208,61
Karluk,1996,0,,209,61
Karluk,1996,1,,210,62
Karluk,1996,3,,211,65
Karluk,1996,1,,212,66
Karluk,1996,28,,213,94
Karluk,1996,210,,214,304
Karluk,1996,197,,215,501
Karluk,1996,352,,216,853
Karluk,1996,3141,,217,3994
Karluk,1996,79540,,218,83534
Karluk,1996,13474,,219,97008
Karluk,1996,3315,,220,100323
Karluk,1996,370,,221,100693
Karluk,1996,9619,,222,110312
Karluk,1996,36218,,223,146530
Karluk,1996,22579,,224,169109
Karluk,1996,25354,,225,194463
Karluk,1996,6387,,226,200850
Karluk,1996,14139,,227,214989
Karluk,1996,66203,,228,281192
Karluk,1996,58924,,229,340116
Karluk,1996,39140,,230,379256
Karluk,1996,44771,,231,424027
Karluk,1996,58523,,232,482550
Karluk,1996,38051,,233,520601
Karluk,1996,82630,,234,603231
Karluk,1996,29770,,235,633001
Karluk,1996,31756,,236,664757
Karluk,1996,40775,,237,705532
Karluk,1996,15769,,238,721301
Karluk,1996,40721,,239,762022
Karluk,1996,6768,,240,768790
Karluk,1996,26727,,241,795517
Karluk,1996,13755,,242,809272
Karluk,1996,7341,,243,816613
Karluk,1996,11769,,244,828382
Karluk,1996,3070,,245,831452
Karluk,1996,4519,,246,835971
Karluk,1996,4590,,247,840561
Karluk,1996,1643,,248,842204
Karluk,1996,1100,,249,843304
Karluk,1996,1860,,250,845164
Karluk,1996,4981,,251,850145
Karluk,1996,374,,252,850519
Karluk,1996,95,,253,850614
Karluk,1996,138,,254,850752
Karluk,1996,24,,255,850776
Karluk,1996,1100,,256,851876
Karluk,1996,3800,,257,855676
Karluk,1996,18,,258,855694
Karluk,1996,7,,259,855701
Karluk,1996,0,,260,855701
Karluk,1996,21,,261,855722
Karluk,1996,3,,262,855725
Karluk,1996,25,,263,855750
Karluk,1996,22,,264,855772
Karluk,1996,1,,265,855773
Karluk,1996,3,,266,855776
Karluk,1996,2,,267,855778
Karluk,1996,1,,268,855779
Karluk,1996,4,,269,855783
Karluk,1996,0,,270,855783
Karluk,1996,0,,271,855783
Karluk,1996,0,,272,855783
Karluk,1996,0,,273,855783
Karluk,1996,0,,274,855783
Karluk,1996,0,,275,855783
Karluk,1996,0,,276,855783
Karluk,1996,0,,277,855783
Karluk,1996,0,,278,855783
Karluk,1996,0,,279,855783
Karluk,1996,0,,280,855783
Karluk,1996,0,,281,855783
Karluk,1996,0,,282,855783
Karluk,1996,0,,283,855783
Karluk,1996,0,,284,855783
Karluk,1996,0,,285,855783
Karluk,1996,0,,286,855783
Karluk,1995,0,,154,0
Karluk,1995,0,,155,0
Karluk,1995,0,,156,0
Karluk,1995,0,,157,0
Karluk,1995,0,,158,0
Karluk,1995,0,,159,0
Karluk,1995,0,,160,0
Karluk,1995,0,,161,0
Karluk,1995,0,,162,0
Karluk,1995,0,,163,0
Karluk,1995,0,,164,0
Karluk,1995,0,,165,0
Karluk,1995,0,,166,0
Karluk,1995,0,,167,0
Karluk,1995,0,,168,0
Karluk,1995,0,,169,0
Karluk,1995,0,,170,0
Karluk,1995,0,,171,0
Karluk,1995,0,,172,0
Karluk,1995,0,,173,0
Karluk,1995,0,,174,0
Karluk,1995,0,,175,0
Karluk,1995,0,,176,0
Karluk,1995,0,,177,0
Karluk,1995,0,,178,0
Karluk,1995,0,,179,0
Karluk,1995,0,,180,0
Karluk,1995,0,,181,0
Karluk,1995,0,,182,0
Karluk,1995,2,,183,2
Karluk,1995,2,,184,4
Karluk,1995,0,,185,4
Karluk,1995,0,,186,4
Karluk,1995,0,,187,4
Karluk,1995,0,,188,4
Karluk,1995,1,,189,5
Karluk,1995,0,,190,5
Karluk,1995,1,,191,6
Karluk,1995,0,,192,6
Karluk,1995,1,,193,7
Karluk,1995,0,,194,7
Karluk,1995,0,,195,7
Karluk,1995,0,,196,7
Karluk,1995,2,,197,9
Karluk,1995,0,,198,9
Karluk,1995,10,,199,19
Karluk,1995,15,,200,34
Karluk,1995,24,,201,58
Karluk,1995,17,,202,75
Karluk,1995,10,,203,85
Karluk,1995,10,,204,95
Karluk,1995,41,,205,136
Karluk,1995,403,,206,539
Karluk,1995,257,,207,796
Karluk,1995,15,,208,811
Karluk,1995,75,,209,886
Karluk,1995,1585,,210,2471
Karluk,1995,607,,211,3078
Karluk,1995,362,,212,3440
Karluk,1995,1422,,213,4862
Karluk,1995,2320,,214,7182
Karluk,1995,7540,,215,14722
Karluk,1995,293,,216,15015
Karluk,1995,83,,217,15098
Karluk,1995,682,,218,15780
Karluk,1995,869,,219,16649
Karluk,1995,2342,,220,18991
Karluk,1995,2300,,221,21291
Karluk,1995,3354,,222,24645
Karluk,1995,1031,,223,25676
Karluk,1995,6470,,224,32146
Karluk,1995,340,,225,32486
Karluk,1995,621,,226,33107
Karluk,1995,453,,227,33560
Karluk,1995,1501,,228,35061
Karluk,1995,49,,229,35110
Karluk,1995,2488,,230,37598
Karluk,1995,712,,231,38310
Karluk,1995,283,,232,38593
Karluk,1995,1319,,233,39912
Karluk,1995,2498,,234,42410
Karluk,1995,3967,,235,46377
Karluk,1995,2232,,236,48609
Karluk,1995,2174,,237,50783
Karluk,1995,1253,,238,52036
Karluk,1995,3751,,239,55787
Karluk,1995,10578,,240,66365
Karluk,1995,4356,,241,70721
Karluk,1995,7911,,242,78632
Karluk,1995,2129,,243,80761
Karluk,1995,6692,,244,87453
Karluk,1995,1568,,245,89021
Karluk,1995,920,,246,89941
Karluk,1995,2647,,247,92588
Karluk,1995,4162,,248,96750
Karluk,1995,3973,,249,100723
Karluk,1995,2407,,250,103130
Karluk,1995,963,,251,104093
Karluk,1995,288,,252,104381
Karluk,1995,691,,253,105072
Karluk,1995,3704,,254,108776
Karluk,1995,1254,,255,110030
Karluk,1995,158,,256,110188
Karluk,1995,27,,257,110215
Karluk,1995,167,,258,110382
Karluk,1995,33,,259,110415
Karluk,1995,146,,260,110561
Karluk,1995,99,,261,110660
Karluk,1995,1,,262,110661
Karluk,1995,239,,263,110900
Karluk,1995,88,,264,110988
Karluk,1995,30,,265,111018
Karluk,1995,32,,266,111050
Karluk,1995,13,,267,111063
Karluk,1995,3,,268,111066
Karluk,1995,0,,269,111066
Karluk,1995,0,,270,111066
Karluk,1995,0,,271,111066
Karluk,1995,0,,272,111066
Karluk,1995,0,,273,111066
Karluk,1995,0,,274,111066
Karluk,1995,0,,275,111066
Karluk,1995,0,,276,111066
Karluk,1995,0,,277,111066
Karluk,1995,0,,278,111066
Karluk,1995,0,,279,111066
Karluk,1995,0,,280,111066
Karluk,1995,0,,281,111066
Karluk,1995,0,,282,111066
Karluk,1995,0,,283,111066
Karluk,1995,0,,284,111066
Karluk,1995,0,,285,111066
Karluk,1994,0,,154,0
Karluk,1994,0,,155,0
Karluk,1994,0,,156,0
Karluk,1994,0,,157,0
Karluk,1994,0,,158,0
Karluk,1994,0,,159,0
Karluk,1994,0,,160,0
Karluk,1994,0,,161,0
Karluk,1994,0,,162,0
Karluk,1994,0,,163,0
Karluk,1994,0,,164,0
Karluk,1994,0,,165,0
Karluk,1994,0,,166,0
Karluk,1994,0,,167,0
Karluk,1994,0,,168,0
Karluk,1994,0,,169,0
Karluk,1994,0,,170,0
Karluk,1994,0,,171,0
Karluk,1994,0,,172,0
Karluk,1994,0,,173,0
Karluk,1994,0,,174,0
Karluk,1994,0,,175,0
Karluk,1994,0,,176,0
Karluk,1994,0,,177,0
Karluk,1994,0,,178,0
Karluk,1994,0,,179,0
Karluk,1994,0,,180,0
Karluk,1994,0,,181,0
Karluk,1994,0,,182,0
Karluk,1994,0,,183,0
Karluk,1994,0,,184,0
Karluk,1994,1,,185,1
Karluk,1994,1,,186,2
Karluk,1994,0,,187,2
Karluk,1994,0,,188,2
Karluk,1994,6,,189,8
Karluk,1994,11,,190,19
Karluk,1994,4,,191,23
Karluk,1994,3,,192,26
Karluk,1994,0,,193,26
Karluk,1994,19,,194,45
Karluk,1994,97,,195,142
Karluk,1994,25,,196,167
Karluk,1994,12,,197,179
Karluk,1994,4,,198,183
Karluk,1994,6,,199,189
Karluk,1994,1,,200,190
Karluk,1994,4,,201,194
Karluk,1994,211,,202,405
Karluk,1994,143,,203,548
Karluk,1994,15,,204,563
Karluk,1994,232,,205,795
Karluk,1994,358,,206,1153
Karluk,1994,61,,207,1214
Karluk,1994,45,,208,1259
Karluk,1994,482,,209,1741
Karluk,1994,91,,210,1832
Karluk,1994,350,,211,2182
Karluk,1994,6580,,212,8762
Karluk,1994,2449,,213,11211
Karluk,1994,70,,214,11281
Karluk,1994,264,,215,11545
Karluk,1994,6932,,216,18477
Karluk,1994,4499,,217,22976
Karluk,1994,5876,,218,28852
Karluk,1994,7629,,219,36481
Karluk,1994,10608,,220,47089
Karluk,1994,18242,,221,65331
Karluk,1994,23889,,222,89220
Karluk,1994,32338,,223,121558
Karluk,1994,14701,,224,136259
Karluk,1994,1594,,225,137853
Karluk,1994,2147,,226,140000
Karluk,1994,3304,,227,143304
Karluk,1994,14138,,228,157442
Karluk,1994,32504,,229,189946
Karluk,1994,38236,,230,228182
Karluk,1994,25727,,231,253909
Karluk,1994,45655,,232,299564
Karluk,1994,70142,,233,369706
Karluk,1994,3905,,234,373611
Karluk,1994,13794,,235,387405
Karluk,1994,1560,,236,388965
Karluk,1994,2888,,237,391853
Karluk,1994,7077,,238,398930
Karluk,1994,806,,239,399736
Karluk,1994,9636,,240,409372
Karluk,1994,5148,,241,414520
Karluk,1994,3389,,242,417909
Karluk,1994,3211,,243,421120
Karluk,1994,1502,,244,422622
Karluk,1994,2687,,245,425309
Karluk,1994,1659,,246,426968
Karluk,1994,1886,,247,428854
Karluk,1994,895,,248,429749
Karluk,1994,3029,,249,432778
Karluk,1994,959,,250,433737
Karluk,1994,818,,251,434555
Karluk,1994,367,,252,434922
Karluk,1994,1049,,253,435971
Karluk,1994,446,,254,436417
Karluk,1994,203,,255,436620
Karluk,1994,50,,256,436670
Karluk,1994,47,,257,436717
Karluk,1994,1753,,258,438470
Karluk,1994,212,,259,438682
Karluk,1994,60,,260,438742
Karluk,1994,6,,261,438748
Karluk,1994,4,,262,438752
Karluk,1994,174,,263,438926
Karluk,1994,44,,264,438970
Karluk,1994,12,,265,438982
Karluk,1994,9,,266,438991
Karluk,1994,0,,267,438991
Karluk,1994,0,,268,438991
Karluk,1994,0,,269,438991
Karluk,1994,0,,270,438991
Karluk,1994,0,,271,438991
Karluk,1994,0,,272,438991
Karluk,1994,0,,273,438991
Karluk,1994,0,,274,438991
Karluk,1994,0,,275,438991
Karluk,1994,0,,276,438991
Karluk,1994,0,,277,438991
Karluk,1994,0,,278,438991
Karluk,1994,0,,279,438991
Karluk,1994,0,,280,438991
Karluk,1994,0,,281,438991
Karluk,1994,0,,282,438991
Karluk,1994,0,,283,438991
Karluk,1994,0,,284,438991
Karluk,1994,0,,285,438991
Karluk,1993,0,,154,0
Karluk,1993,0,,155,0
Karluk,1993,0,,156,0
Karluk,1993,0,,157,0
Karluk,1993,0,,158,0
Karluk,1993,0,,159,0
Karluk,1993,0,,160,0
Karluk,1993,0,,161,0
Karluk,1993,0,,162,0
Karluk,1993,0,,163,0
Karluk,1993,0,,164,0
Karluk,1993,0,,165,0
Karluk,1993,0,,166,0
Karluk,1993,0,,167,0
Karluk,1993,0,,168,0
Karluk,1993,0,,169,0
Karluk,1993,0,,170,0
Karluk,1993,0,,171,0
Karluk,1993,0,,172,0
Karluk,1993,0,,173,0
Karluk,1993,0,,174,0
Karluk,1993,0,,175,0
Karluk,1993,0,,176,0
Karluk,1993,0,,177,0
Karluk,1993,0,,178,0
Karluk,1993,0,,179,0
Karluk,1993,0,,180,0
Karluk,1993,0,,181,0
Karluk,1993,0,,182,0
Karluk,1993,0,,183,0
Karluk,1993,0,,184,0
Karluk,1993,0,,185,0
Karluk,1993,0,,186,0
Karluk,1993,0,,187,0
Karluk,1993,0,,188,0
Karluk,1993,0,,189,0
Karluk,1993,0,,190,0
Karluk,1993,0,,191,0
Karluk,1993,13,,192,13
Karluk,1993,25,,193,38
Karluk,1993,1,,194,39
Karluk,1993,5,,195,44
Karluk,1993,7,,196,51
Karluk,1993,14,,197,65
Karluk,1993,9,,198,74
Karluk,1993,11,,199,85
Karluk,1993,13,,200,98
Karluk,1993,5,,201,103
Karluk,1993,3,,202,106
Karluk,1993,7,,203,113
Karluk,1993,14,,204,127
Karluk,1993,1,,205,128
Karluk,1993,11,,206,139
Karluk,1993,14,,207,153
Karluk,1993,14,,208,167
Karluk,1993,17,,209,184
Karluk,1993,49,,210,233
Karluk,1993,6,,211,239
Karluk,1993,89,,212,328
Karluk,1993,933,,213,1261
Karluk,1993,113,,214,1374
Karluk,1993,25,,215,1399
Karluk,1993,93,,216,1492
Karluk,1993,408,,217,1900
Karluk,1993,1172,,218,3072
Karluk,1993,1396,,219,4468
Karluk,1993,241,,220,4709
Karluk,1993,84,,221,4793
Karluk,1993,213,,222,5006
Karluk,1993,771,,223,5777
Karluk,1993,931,,224,6708
Karluk,1993,702,,225,7410
Karluk,1993,1884,,226,9294
Karluk,1993,1831,,227,11125
Karluk,1993,1429,,228,12554
Karluk,1993,359,,229,12913
Karluk,1993,1075,,230,13988
Karluk,1993,4397,,231,18385
Karluk,1993,923,,232,19308
Karluk,1993,485,,233,19793
Karluk,1993,692,,234,20485
Karluk,1993,2778,,235,23263
Karluk,1993,1280,,236,24543
Karluk,1993,1794,,237,26337
Karluk,1993,1666,,238,28003
Karluk,1993,2198,,239,30201
Karluk,1993,4288,,240,34489
Karluk,1993,9609,,241,44098
Karluk,1993,9426,,242,53524
Karluk,1993,4011,,243,57535
Karluk,1993,1318,,244,58853
Karluk,1993,2098,,245,60951
Karluk,1993,993,,246,61944
Karluk,1993,1869,,247,63813
Karluk,1993,4871,,248,68684
Karluk,1993,2465,,249,71149
Karluk,1993,2989,,250,74138
Karluk,1993,4013,,251,78151
Karluk,1993,2554,,252,80705
Karluk,1993,907,,253,81612
Karluk,1993,2551,,254,84163
Karluk,1993,4749,,255,88912
Karluk,1993,2097,,256,91009
Karluk,1993,1817,,257,92826
Karluk,1993,1337,,258,94163
Karluk,1993,2737,,259,96900
Karluk,1993,632,,260,97532
Karluk,1993,358,,261,97890
Karluk,1993,394,,262,98284
Karluk,1993,2272,,263,100556
Karluk,1993,350,,264,100906
Karluk,1993,282,,265,101188
Karluk,1993,147,,266,101335
Karluk,1993,65,,267,101400
Karluk,1993,59,,268,101459
Karluk,1993,43,,269,101502
Karluk,1993,12,,270,101514
Karluk,1993,158,,271,101672
Karluk,1993,0,,272,101672
Karluk,1993,0,,273,101672
Karluk,1993,0,,274,101672
Karluk,1993,0,,275,101672
Karluk,1993,0,,276,101672
Karluk,1993,0,,277,101672
Karluk,1993,0,,278,101672
Karluk,1993,0,,279,101672
Karluk,1993,0,,280,101672
Karluk,1993,0,,281,101672
Karluk,1993,0,,282,101672
Karluk,1993,0,,283,101672
Karluk,1993,0,,284,101672
Karluk,1993,0,,285,101672
Karluk,1992,0,,155,0
Karluk,1992,0,,156,0
Karluk,1992,0,,157,0
Karluk,1992,0,,158,0
Karluk,1992,0,,159,0
Karluk,1992,0,,160,0
Karluk,1992,0,,161,0
Karluk,1992,0,,162,0
Karluk,1992,0,,163,0
Karluk,1992,0,,164,0
Karluk,1992,0,,165,0
Karluk,1992,0,,166,0
Karluk,1992,0,,167,0
Karluk,1992,0,,168,0
Karluk,1992,0,,169,0
Karluk,1992,0,,170,0
Karluk,1992,0,,171,0
Karluk,1992,0,,172,0
Karluk,1992,0,,173,0
Karluk,1992,0,,174,0
Karluk,1992,0,,175,0
Karluk,1992,0,,176,0
Karluk,1992,0,,177,0
Karluk,1992,0,,178,0
Karluk,1992,0,,179,0
Karluk,1992,0,,180,0
Karluk,1992,0,,181,0
Karluk,1992,0,,182,0
Karluk,1992,1,,183,1
Karluk,1992,0,,184,1
Karluk,1992,0,,185,1
Karluk,1992,2,,186,3
Karluk,1992,0,,187,3
Karluk,1992,0,,188,3
Karluk,1992,1,,189,4
Karluk,1992,2,,190,6
Karluk,1992,2,,191,8
Karluk,1992,7,,192,15
Karluk,1992,37,,193,52
Karluk,1992,55,,194,107
Karluk,1992,29,,195,136
Karluk,1992,90,,196,226
Karluk,1992,106,,197,332
Karluk,1992,43,,198,375
Karluk,1992,45,,199,420
Karluk,1992,69,,200,489
Karluk,1992,197,,201,686
Karluk,1992,206,,202,892
Karluk,1992,84,,203,976
Karluk,1992,407,,204,1383
Karluk,1992,92,,205,1475
Karluk,1992,137,,206,1612
Karluk,1992,528,,207,2140
Karluk,1992,149,,208,2289
Karluk,1992,418,,209,2707
Karluk,1992,92,,210,2799
Karluk,1992,10,,211,2809
Karluk,1992,10,,212,2819
Karluk,1992,179,,213,2998
Karluk,1992,695,,214,3693
Karluk,1992,191,,215,3884
Karluk,1992,1800,,216,5684
Karluk,1992,349,,217,6033
Karluk,1992,1498,,218,7531
Karluk,1992,6394,,219,13925
Karluk,1992,4129,,220,18054
Karluk,1992,2806,,221,20860
Karluk,1992,827,,222,21687
Karluk,1992,723,,223,22410
Karluk,1992,2970,,224,25380
Karluk,1992,53280,,225,78660
Karluk,1992,4316,,226,82976
Karluk,1992,10004,,227,92980
Karluk,1992,8029,,228,101009
Karluk,1992,51908,,229,152917
Karluk,1992,18449,,230,171366
Karluk,1992,9022,,231,180388
Karluk,1992,2929,,232,183317
Karluk,1992,24741,,233,208058
Karluk,1992,14101,,234,222159
Karluk,1992,10234,,235,232393
Karluk,1992,43312,,236,275705
Karluk,1992,14651,,237,290356
Karluk,1992,9400,,238,299756
Karluk,1992,40874,,239,340630
Karluk,1992,13825,,240,354455
Karluk,1992,9707,,241,364162
Karluk,1992,2995,,242,367157
Karluk,1992,4990,,243,372147
Karluk,1992,4327,,244,376474
Karluk,1992,2039,,245,378513
Karluk,1992,1912,,246,380425
Karluk,1992,9006,,247,389431
Karluk,1992,1676,,248,391107
Karluk,1992,4311,,249,395418
Karluk,1992,1078,,250,396496
Karluk,1992,1075,,251,397571
Karluk,1992,701,,252,398272
Karluk,1992,452,,253,398724
Karluk,1992,59,,254,398783
Karluk,1992,102,,255,398885
Karluk,1992,1769,,256,400654
Karluk,1992,173,,257,400827
Karluk,1992,58,,258,400885
Karluk,1992,9,,259,400894
Karluk,1992,51,,260,400945
Karluk,1992,9,,261,400954
Karluk,1992,7,,262,400961
Karluk,1992,8,,263,400969
Karluk,1992,27,,264,400996
Karluk,1992,39,,265,401035
Karluk,1992,4,,266,401039
Karluk,1992,17,,267,401056
Karluk,1992,23,,268,401079
Karluk,1992,4,,269,401083
Karluk,1992,0,,270,401083
Karluk,1992,0,,271,401083
Karluk,1992,0,,272,401083
Karluk,1992,0,,273,401083
Karluk,1992,0,,274,401083
Karluk,1992,0,,275,401083
Karluk,1992,0,,276,401083
Karluk,1992,0,,277,401083
Karluk,1992,0,,278,401083
Karluk,1992,0,,279,401083
Karluk,1992,0,,280,401083
Karluk,1992,0,,281,401083
Karluk,1992,0,,282,401083
Karluk,1992,0,,283,401083
Karluk,1992,0,,284,401083
Karluk,1992,0,,285,401083
Karluk,1992,0,,286,401083
Karluk,1991,0,,154,0
Karluk,1991,0,,155,0
Karluk,1991,0,,156,0
Karluk,1991,0,,157,0
Karluk,1991,0,,158,0
Karluk,1991,0,,159,0
Karluk,1991,0,,160,0
Karluk,1991,0,,161,0
Karluk,1991,0,,162,0
Karluk,1991,0,,163,0
Karluk,1991,0,,164,0
Karluk,1991,0,,165,0
Karluk,1991,0,,166,0
Karluk,1991,0,,167,0
Karluk,1991,0,,168,0
Karluk,1991,0,,169,0
Karluk,1991,0,,170,0
Karluk,1991,0,,171,0
Karluk,1991,0,,172,0
Karluk,1991,0,,173,0
Karluk,1991,0,,174,0
Karluk,1991,0,,175,0
Karluk,1991,0,,176,0
Karluk,1991,0,,177,0
Karluk,1991,0,,178,0
Karluk,1991,0,,179,0
Karluk,1991,0,,180,0
Karluk,1991,0,,181,0
Karluk,1991,0,,182,0
Karluk,1991,0,,183,0
Karluk,1991,0,,184,0
Karluk,1991,0,,185,0
Karluk,1991,35,,186,35
Karluk,1991,31,,187,66
Karluk,1991,13,,188,79
Karluk,1991,10,,189,89
Karluk,1991,33,,190,122
Karluk,1991,14,,191,136
Karluk,1991,3,,192,139
Karluk,1991,7,,193,146
Karluk,1991,17,,194,163
Karluk,1991,48,,195,211
Karluk,1991,51,,196,262
Karluk,1991,77,,197,339
Karluk,1991,57,,198,396
Karluk,1991,55,,199,451
Karluk,1991,22,,200,473
Karluk,1991,85,,201,558
Karluk,1991,185,,202,743
Karluk,1991,217,,203,960
Karluk,1991,201,,204,1161
Karluk,1991,219,,205,1380
Karluk,1991,163,,206,1543
Karluk,1991,42,,207,1585
Karluk,1991,2639,,208,4224
Karluk,1991,1394,,209,5618
Karluk,1991,1220,,210,6838
Karluk,1991,1762,,211,8600
Karluk,1991,2154,,212,10754
Karluk,1991,47,,213,10801
Karluk,1991,1225,,214,12026
Karluk,1991,660,,215,12686
Karluk,1991,1952,,216,14638
Karluk,1991,392,,217,15030
Karluk,1991,2431,,218,17461
Karluk,1991,2402,,219,19863
Karluk,1991,2959,,220,22822
Karluk,1991,7708,,221,30530
Karluk,1991,4012,,222,34542
Karluk,1991,3883,,223,38425
Karluk,1991,3548,,224,41973
Karluk,1991,5613,,225,47586
Karluk,1991,1353,,226,48939
Karluk,1991,1566,,227,50505
Karluk,1991,793,,228,51298
Karluk,1991,2314,,229,53612
Karluk,1991,765,,230,54377
Karluk,1991,2573,,231,56950
Karluk,1991,1341,,232,58291
Karluk,1991,1171,,233,59462
Karluk,1991,2639,,234,62101
Karluk,1991,2183,,235,64284
Karluk,1991,1780,,236,66064
Karluk,1991,4394,,237,70458
Karluk,1991,3788,,238,74246
Karluk,1991,1087,,239,75333
Karluk,1991,1389,,240,76722
Karluk,1991,518,,241,77240
Karluk,1991,4805,,242,82045
Karluk,1991,8211,,243,90256
Karluk,1991,4655,,244,94911
Karluk,1991,632,,245,95543
Karluk,1991,3387,,246,98930
Karluk,1991,5171,,247,104101
Karluk,1991,5373,,248,109474
Karluk,1991,2381,,249,111855
Karluk,1991,1005,,250,112860
Karluk,1991,835,,251,113695
Karluk,1991,420,,252,114115
Karluk,1991,859,,253,114974
Karluk,1991,204,,254,115178
Karluk,1991,27,,255,115205
Karluk,1991,15,,256,115220
Karluk,1991,48,,257,115268
Karluk,1991,43,,258,115311
Karluk,1991,619,,259,115930
Karluk,1991,254,,260,116184
Karluk,1991,42,,261,116226
Karluk,1991,47,,262,116273
Karluk,1991,20,,263,116293
Karluk,1991,20,,264,116313
Karluk,1991,16,,265,116329
Karluk,1991,0,,266,116329
Karluk,1991,0,,267,116329
Karluk,1991,0,,268,116329
Karluk,1991,0,,269,116329
Karluk,1991,0,,270,116329
Karluk,1991,0,,271,116329
Karluk,1991,0,,272,116329
Karluk,1991,0,,273,116329
Karluk,1991,0,,274,116329
Karluk,1991,0,,275,116329
Karluk,1991,0,,276,116329
Karluk,1991,0,,277,116329
Karluk,1991,0,,278,116329
Karluk,1991,0,,279,116329
Karluk,1991,0,,280,116329
Karluk,1991,0,,281,116329
Karluk,1991,0,,282,116329
Karluk,1991,0,,283,116329
Karluk,1991,0,,284,116329
Karluk,1991,0,,285,116329
Karluk,1990,0,,154,0
Karluk,1990,0,,155,0
Karluk,1990,0,,156,0
Karluk,1990,0,,157,0
Karluk,1990,0,,158,0
Karluk,1990,0,,159,0
Karluk,1990,0,,160,0
Karluk,1990,0,,161,0
Karluk,1990,0,,162,0
Karluk,1990,0,,163,0
Karluk,1990,0,,164,0
Karluk,1990,0,,165,0
Karluk,1990,0,,166,0
Karluk,1990,0,,167,0
Karluk,1990,0,,168,0
Karluk,1990,0,,169,0
Karluk,1990,0,,170,0
Karluk,1990,0,,171,0
Karluk,1990,0,,172,0
Karluk,1990,0,,173,0
Karluk,1990,0,,174,0
Karluk,1990,0,,175,0
Karluk,1990,0,,176,0
Karluk,1990,0,,177,0
Karluk,1990,0,,178,0
Karluk,1990,0,,179,0
Karluk,1990,0,,180,0
Karluk,1990,2,,181,2
Karluk,1990,1,,182,3
Karluk,1990,0,,183,3
Karluk,1990,0,,184,3
Karluk,1990,0,,185,3
Karluk,1990,0,,186,3
Karluk,1990,3,,187,6
Karluk,1990,10,,188,16
Karluk,1990,3,,189,19
Karluk,1990,5,,190,24
Karluk,1990,21,,191,45
Karluk,1990,65,,192,110
Karluk,1990,8,,193,118
Karluk,1990,5,,194,123
Karluk,1990,4,,195,127
Karluk,1990,9,,196,136
Karluk,1990,62,,197,198
Karluk,1990,75,,198,273
Karluk,1990,37,,199,310
Karluk,1990,142,,200,452
Karluk,1990,66,,201,518
Karluk,1990,83,,202,601
Karluk,1990,102,,203,703
Karluk,1990,39,,204,742
Karluk,1990,46,,205,788
Karluk,1990,48,,206,836
Karluk,1990,239,,207,1075
Karluk,1990,339,,208,1414
Karluk,1990,562,,209,1976
Karluk,1990,1205,,210,3181
Karluk,1990,1546,,211,4727
Karluk,1990,810,,212,5537
Karluk,1990,7658,,213,13195
Karluk,1990,3687,,214,16882
Karluk,1990,10834,,215,27716
Karluk,1990,14025,,216,41741
Karluk,1990,13841,,217,55582
Karluk,1990,51070,,218,106652
Karluk,1990,102679,,219,209331
Karluk,1990,113570,,220,322901
Karluk,1990,439970,,221,762871
Karluk,1990,124077,,222,886948
Karluk,1990,196786,,223,1083734
Karluk,1990,251820,,224,1335554
Karluk,1990,179870,,225,1515424
Karluk,1990,307417,,226,1822841
Karluk,1990,328030,,227,2150871
Karluk,1990,180850,,228,2331721
Karluk,1990,35992,,229,2367713
Karluk,1990,72627,,230,2440340
Karluk,1990,102443,,231,2542783
Karluk,1990,94018,,232,2636801
Karluk,1990,106568,,233,2743369
Karluk,1990,121275,,234,2864644
Karluk,1990,189829,,235,3054473
Karluk,1990,82258,,236,3136731
Karluk,1990,98908,,237,3235639
Karluk,1990,45912,,238,3281551
Karluk,1990,67062,,239,3348613
Karluk,1990,11473,,240,3360086
Karluk,1990,8728,,241,3368814
Karluk,1990,6276,,242,3375090
Karluk,1990,15065,,243,3390155
Karluk,1990,11931,,244,3402086
Karluk,1990,7654,,245,3409740
Karluk,1990,7717,,246,3417457
Karluk,1990,2759,,247,3420216
Karluk,1990,2595,,248,3422811
Karluk,1990,391,,249,3423202
Karluk,1990,515,,250,3423717
Karluk,1990,252,,251,3423969
Karluk,1990,0,,252,3423969
Karluk,1990,0,,253,3423969
Karluk,1990,0,,254,3423969
Karluk,1990,0,,255,3423969
Karluk,1990,0,,256,3423969
Karluk,1990,0,,257,3423969
Karluk,1990,0,,258,3423969
Karluk,1990,0,,259,3423969
Karluk,1990,0,,260,3423969
Karluk,1990,0,,261,3423969
Karluk,1990,0,,262,3423969
Karluk,1990,0,,263,3423969
Karluk,1990,0,,264,3423969
Karluk,1990,0,,265,3423969
Karluk,1990,0,,266,3423969
Karluk,1990,0,,267,3423969
Karluk,1990,0,,268,3423969
Karluk,1990,0,,269,3423969
Karluk,1990,0,,270,3423969
Karluk,1990,0,,271,3423969
Karluk,1990,0,,272,3423969
Karluk,1990,0,,273,3423969
Karluk,1990,0,,274,3423969
Karluk,1990,0,,275,3423969
Karluk,1990,0,,276,3423969
Karluk,1990,0,,277,3423969
Karluk,1990,0,,278,3423969
Karluk,1990,0,,279,3423969
Karluk,1990,0,,280,3423969
Karluk,1990,0,,281,3423969
Karluk,1990,0,,282,3423969
Karluk,1990,0,,283,3423969
Karluk,1990,0,,284,3423969
Karluk,1990,0,,285,3423969
Karluk,1989,0,,154,0
Karluk,1989,0,,155,0
Karluk,1989,0,,156,0
Karluk,1989,0,,157,0
Karluk,1989,0,,158,0
Karluk,1989,0,,159,0
Karluk,1989,0,,160,0
Karluk,1989,0,,161,0
Karluk,1989,0,,162,0
Karluk,1989,0,,163,0
Karluk,1989,0,,164,0
Karluk,1989,0,,165,0
Karluk,1989,0,,166,0
Karluk,1989,0,,167,0
Karluk,1989,0,,168,0
Karluk,1989,0,,169,0
Karluk,1989,0,,170,0
Karluk,1989,0,,171,0
Karluk,1989,0,,172,0
Karluk,1989,0,,173,0
Karluk,1989,0,,174,0
Karluk,1989,4,,175,4
Karluk,1989,4,,176,8
Karluk,1989,4,,177,12
Karluk,1989,5,,178,17
Karluk,1989,12,,179,29
Karluk,1989,15,,180,44
Karluk,1989,5,,181,49
Karluk,1989,8,,182,57
Karluk,1989,7,,183,64
Karluk,1989,5,,184,69
Karluk,1989,20,,185,89
Karluk,1989,4,,186,93
Karluk,1989,61,,187,154
Karluk,1989,34,,188,188
Karluk,1989,12,,189,200
Karluk,1989,71,,190,271
Karluk,1989,147,,191,418
Karluk,1989,134,,192,552
Karluk,1989,76,,193,628
Karluk,1989,45,,194,673
Karluk,1989,30,,195,703
Karluk,1989,195,,196,898
Karluk,1989,258,,197,1156
Karluk,1989,247,,198,1403
Karluk,1989,589,,199,1992
Karluk,1989,228,,200,2220
Karluk,1989,85,,201,2305
Karluk,1989,442,,202,2747
Karluk,1989,136,,203,2883
Karluk,1989,274,,204,3157
Karluk,1989,138,,205,3295
Karluk,1989,323,,206,3618
Karluk,1989,311,,207,3929
Karluk,1989,2143,,208,6072
Karluk,1989,1362,,209,7434
Karluk,1989,3078,,210,10512
Karluk,1989,1229,,211,11741
Karluk,1989,1488,,212,13229
Karluk,1989,2468,,213,15697
Karluk,1989,2495,,214,18192
Karluk,1989,1067,,215,19259
Karluk,1989,2013,,216,21272
Karluk,1989,2786,,217,24058
Karluk,1989,2006,,218,26064
Karluk,1989,733,,219,26797
Karluk,1989,668,,220,27465
Karluk,1989,2607,,221,30072
Karluk,1989,6402,,222,36474
Karluk,1989,7614,,223,44088
Karluk,1989,1958,,224,46046
Karluk,1989,866,,225,46912
Karluk,1989,590,,226,47502
Karluk,1989,215,,227,47717
Karluk,1989,291,,228,48008
Karluk,1989,462,,229,48470
Karluk,1989,5129,,230,53599
Karluk,1989,2174,,231,55773
Karluk,1989,2048,,232,57821
Karluk,1989,1371,,233,59192
Karluk,1989,1484,,234,60676
Karluk,1989,5829,,235,66505
Karluk,1989,4507,,236,71012
Karluk,1989,4877,,237,75889
Karluk,1989,3632,,238,79521
Karluk,1989,1559,,239,81080
Karluk,1989,2753,,240,83833
Karluk,1989,3744,,241,87577
Karluk,1989,9411,,242,96988
Karluk,1989,736,,243,97724
Karluk,1989,2295,,244,100019
Karluk,1989,4290,,245,104309
Karluk,1989,2008,,246,106317
Karluk,1989,1254,,247,107571
Karluk,1989,1081,,248,108652
Karluk,1989,471,,249,109123
Karluk,1989,409,,250,109532
Karluk,1989,44,,251,109576
Karluk,1989,101,,252,109677
Karluk,1989,47,,253,109724
Karluk,1989,31,,254,109755
Karluk,1989,38,,255,109793
Karluk,1989,44,,256,109837
Karluk,1989,24,,257,109861
Karluk,1989,6,,258,109867
Karluk,1989,13,,259,109880
Karluk,1989,0,,260,109880
Karluk,1989,0,,261,109880
Karluk,1989,0,,262,109880
Karluk,1989,0,,263,109880
Karluk,1989,0,,264,109880
Karluk,1989,0,,265,109880
Karluk,1989,0,,266,109880
Karluk,1989,0,,267,109880
Karluk,1989,0,,268,109880
Karluk,1989,0,,269,109880
Karluk,1989,0,,270,109880
Karluk,1989,0,,271,109880
Karluk,1989,0,,272,109880
Karluk,1989,0,,273,109880
Karluk,1989,0,,274,109880
Karluk,1989,0,,275,109880
Karluk,1989,0,,276,109880
Karluk,1989,0,,277,109880
Karluk,1989,0,,278,109880
Karluk,1989,0,,279,109880
Karluk,1989,0,,280,109880
Karluk,1989,0,,281,109880
Karluk,1989,0,,282,109880
Karluk,1989,0,,283,109880
Karluk,1989,0,,284,109880
Karluk,1989,0,,285,109880
Karluk,1988,0,,155,0
Karluk,1988,0,,156,0
Karluk,1988,0,,157,0
Karluk,1988,0,,158,0
Karluk,1988,0,,159,0
Karluk,1988,0,,160,0
Karluk,1988,0,,161,0
Karluk,1988,0,,162,0
Karluk,1988,0,,163,0
Karluk,1988,0,,164,0
Karluk,1988,0,,165,0
Karluk,1988,0,,166,0
Karluk,1988,0,,167,0
Karluk,1988,0,,168,0
Karluk,1988,0,,169,0
Karluk,1988,0,,170,0
Karluk,1988,0,,171,0
Karluk,1988,0,,172,0
Karluk,1988,0,,173,0
Karluk,1988,0,,174,0
Karluk,1988,0,,175,0
Karluk,1988,0,,176,0
Karluk,1988,0,,177,0
Karluk,1988,0,,178,0
Karluk,1988,0,,179,0
Karluk,1988,0,,180,0
Karluk,1988,0,,181,0
Karluk,1988,0,,182,0
Karluk,1988,0,,183,0
Karluk,1988,3,,184,3
Karluk,1988,0,,185,3
Karluk,1988,0,,186,3
Karluk,1988,1,,187,4
Karluk,1988,3,,188,7
Karluk,1988,7,,189,14
Karluk,1988,10,,190,24
Karluk,1988,32,,191,56
Karluk,1988,7,,192,63
Karluk,1988,10,,193,73
Karluk,1988,7,,194,80
Karluk,1988,61,,195,141
Karluk,1988,153,,196,294
Karluk,1988,174,,197,468
Karluk,1988,209,,198,677
Karluk,1988,130,,199,807
Karluk,1988,222,,200,1029
Karluk,1988,362,,201,1391
Karluk,1988,116,,202,1507
Karluk,1988,28,,203,1535
Karluk,1988,40,,204,1575
Karluk,1988,50,,205,1625
Karluk,1988,215,,206,1840
Karluk,1988,491,,207,2331
Karluk,1988,348,,208,2679
Karluk,1988,23,,209,2702
Karluk,1988,20,,210,2722
Karluk,1988,177,,211,2899
Karluk,1988,41,,212,2940
Karluk,1988,245,,213,3185
Karluk,1988,640,,214,3825
Karluk,1988,191,,215,4016
Karluk,1988,5074,,216,9090
Karluk,1988,2416,,217,11506
Karluk,1988,4794,,218,16300
Karluk,1988,2248,,219,18548
Karluk,1988,12529,,220,31077
Karluk,1988,18093,,221,49170
Karluk,1988,5685,,222,54855
Karluk,1988,17385,,223,72240
Karluk,1988,33667,,224,105907
Karluk,1988,80228,,225,186135
Karluk,1988,27123,,226,213258
Karluk,1988,12561,,227,225819
Karluk,1988,29902,,228,255721
Karluk,1988,40437,,229,296158
Karluk,1988,54071,,230,350229
Karluk,1988,36802,,231,387031
Karluk,1988,26254,,232,413285
Karluk,1988,26293,,233,439578
Karluk,1988,28858,,234,468436
Karluk,1988,13505,,235,481941
Karluk,1988,27533,,236,509474
Karluk,1988,4355,,237,513829
Karluk,1988,24626,,238,538455
Karluk,1988,36975,,239,575430
Karluk,1988,7581,,240,583011
Karluk,1988,37770,,241,620781
Karluk,1988,32222,,242,653003
Karluk,1988,8387,,243,661390
Karluk,1988,6292,,244,667682
Karluk,1988,5640,,245,673322
Karluk,1988,3568,,246,676890
Karluk,1988,4952,,247,681842
Karluk,1988,4522,,248,686364
Karluk,1988,6796,,249,693160
Karluk,1988,5670,,250,698830
Karluk,1988,5196,,251,704026
Karluk,1988,3498,,252,707524
Karluk,1988,113,,253,707637
Karluk,1988,667,,254,708304
Karluk,1988,666,,255,708970
Karluk,1988,667,,256,709637
Karluk,1988,666,,257,710303
Karluk,1988,667,,258,710970
Karluk,1988,667,,259,711637
Karluk,1988,39,,260,711676
Karluk,1988,0,,261,711676
Karluk,1988,0,,262,711676
Karluk,1988,0,,263,711676
Karluk,1988,0,,264,711676
Karluk,1988,0,,265,711676
Karluk,1988,0,,266,711676
Karluk,1988,0,,267,711676
Karluk,1988,0,,268,711676
Karluk,1988,0,,269,711676
Karluk,1988,0,,270,711676
Karluk,1988,0,,271,711676
Karluk,1988,0,,272,711676
Karluk,1988,0,,273,711676
Karluk,1988,0,,274,711676
Karluk,1988,0,,275,711676
Karluk,1988,0,,276,711676
Karluk,1988,0,,277,711676
Karluk,1988,0,,278,711676
Karluk,1988,0,,279,711676
Karluk,1988,0,,280,711676
Karluk,1988,0,,281,711676
Karluk,1988,0,,282,711676
Karluk,1988,0,,283,711676
Karluk,1988,0,,284,711676
Karluk,1988,0,,285,711676
Karluk,1988,0,,286,711676
Karluk,1987,0,,154,0
Karluk,1987,0,,155,0
Karluk,1987,0,,156,0
Karluk,1987,0,,157,0
Karluk,1987,0,,158,0
Karluk,1987,0,,159,0
Karluk,1987,0,,160,0
Karluk,1987,0,,161,0
Karluk,1987,0,,162,0
Karluk,1987,0,,163,0
Karluk,1987,0,,164,0
Karluk,1987,0,,165,0
Karluk,1987,0,,166,0
Karluk,1987,0,,167,0
Karluk,1987,0,,168,0
Karluk,1987,0,,169,0
Karluk,1987,0,,170,0
Karluk,1987,0,,171,0
Karluk,1987,3,,172,3
Karluk,1987,12,,173,15
Karluk,1987,0,,174,15
Karluk,1987,0,,175,15
Karluk,1987,0,,176,15
Karluk,1987,0,,177,15
Karluk,1987,0,,178,15
Karluk,1987,1,,179,16
Karluk,1987,1,,180,17
Karluk,1987,0,,181,17
Karluk,1987,0,,182,17
Karluk,1987,0,,183,17
Karluk,1987,0,,184,17
Karluk,1987,0,,185,17
Karluk,1987,0,,186,17
Karluk,1987,1,,187,18
Karluk,1987,0,,188,18
Karluk,1987,0,,189,18
Karluk,1987,0,,190,18
Karluk,1987,0,,191,18
Karluk,1987,0,,192,18
Karluk,1987,1,,193,19
Karluk,1987,8,,194,27
Karluk,1987,3,,195,30
Karluk,1987,0,,196,30
Karluk,1987,8,,197,38
Karluk,1987,12,,198,50
Karluk,1987,75,,199,125
Karluk,1987,71,,200,196
Karluk,1987,73,,201,269
Karluk,1987,65,,202,334
Karluk,1987,47,,203,381
Karluk,1987,40,,204,421
Karluk,1987,7,,205,428
Karluk,1987,23,,206,451
Karluk,1987,19,,207,470
Karluk,1987,66,,208,536
Karluk,1987,56,,209,592
Karluk,1987,102,,210,694
Karluk,1987,52,,211,746
Karluk,1987,52,,212,798
Karluk,1987,61,,213,859
Karluk,1987,54,,214,913
Karluk,1987,66,,215,979
Karluk,1987,138,,216,1117
Karluk,1987,65,,217,1182
Karluk,1987,166,,218,1348
Karluk,1987,173,,219,1521
Karluk,1987,529,,220,2050
Karluk,1987,393,,221,2443
Karluk,1987,290,,222,2733
Karluk,1987,307,,223,3040
Karluk,1987,47,,224,3087
Karluk,1987,107,,225,3194
Karluk,1987,399,,226,3593
Karluk,1987,521,,227,4114
Karluk,1987,573,,228,4687
Karluk,1987,406,,229,5093
Karluk,1987,295,,230,5388
Karluk,1987,293,,231,5681
Karluk,1987,53,,232,5734
Karluk,1987,401,,233,6135
Karluk,1987,104,,234,6239
Karluk,1987,2391,,235,8630
Karluk,1987,1006,,236,9636
Karluk,1987,233,,237,9869
Karluk,1987,680,,238,10549
Karluk,1987,455,,239,11004
Karluk,1987,869,,240,11873
Karluk,1987,1143,,241,13016
Karluk,1987,537,,242,13553
Karluk,1987,602,,243,14155
Karluk,1987,1651,,244,15806
Karluk,1987,605,,245,16411
Karluk,1987,1032,,246,17443
Karluk,1987,1795,,247,19238
Karluk,1987,859,,248,20097
Karluk,1987,1616,,249,21713
Karluk,1987,1200,,250,22913
Karluk,1987,76,,251,22989
Karluk,1987,337,,252,23326
Karluk,1987,212,,253,23538
Karluk,1987,173,,254,23711
Karluk,1987,102,,255,23813
Karluk,1987,6,,256,23819
Karluk,1987,85,,257,23904
Karluk,1987,27,,258,23931
Karluk,1987,169,,259,24100
Karluk,1987,22,,260,24122
Karluk,1987,16,,261,24138
Karluk,1987,27,,262,24165
Karluk,1987,13,,263,24178
Karluk,1987,0,,264,24178
Karluk,1987,20,,265,24198
Karluk,1987,10,,266,24208
Karluk,1987,10,,267,24218
Karluk,1987,4,,268,24222
Karluk,1987,0,,269,24222
Karluk,1987,0,,270,24222
Karluk,1987,0,,271,24222
Karluk,1987,0,,272,24222
Karluk,1987,0,,273,24222
Karluk,1987,0,,274,24222
Karluk,1987,0,,275,24222
Karluk,1987,0,,276,24222
Karluk,1987,0,,277,24222
Karluk,1987,0,,278,24222
Karluk,1987,0,,279,24222
Karluk,1987,0,,280,24222
Karluk,1987,0,,281,24222
Karluk,1987,0,,282,24222
Karluk,1987,0,,283,24222
Karluk,1987,0,,284,24222
Karluk,1987,0,,285,24222
Karluk,1986,0,,154,0
Karluk,1986,0,,155,0
Karluk,1986,0,,156,0
Karluk,1986,0,,157,0
Karluk,1986,0,,158,0
Karluk,1986,0,,159,0
Karluk,1986,0,,160,0
Karluk,1986,0,,161,0
Karluk,1986,0,,162,0
Karluk,1986,0,,163,0
Karluk,1986,0,,164,0
Karluk,1986,0,,165,0
Karluk,1986,0,,166,0
Karluk,1986,0,,167,0
Karluk,1986,0,,168,0
Karluk,1986,0,,169,0
Karluk,1986,0,,170,0
Karluk,1986,0,,171,0
Karluk,1986,0,,172,0
Karluk,1986,2,,173,2
Karluk,1986,3,,174,5
Karluk,1986,3,,175,8
Karluk,1986,7,,176,15
Karluk,1986,4,,177,19
Karluk,1986,2,,178,21
Karluk,1986,3,,179,24
Karluk,1986,1,,180,25
Karluk,1986,3,,181,28
Karluk,1986,0,,182,28
Karluk,1986,0,,183,28
Karluk,1986,0,,184,28
Karluk,1986,2,,185,30
Karluk,1986,1,,186,31
Karluk,1986,3,,187,34
Karluk,1986,6,,188,40
Karluk,1986,3,,189,43
Karluk,1986,0,,190,43
Karluk,1986,0,,191,43
Karluk,1986,3,,192,46
Karluk,1986,4,,193,50
Karluk,1986,0,,194,50
Karluk,1986,12,,195,62
Karluk,1986,4,,196,66
Karluk,1986,11,,197,77
Karluk,1986,197,,198,274
Karluk,1986,50,,199,324
Karluk,1986,108,,200,432
Karluk,1986,76,,201,508
Karluk,1986,20,,202,528
Karluk,1986,4,,203,532
Karluk,1986,39,,204,571
Karluk,1986,17,,205,588
Karluk,1986,17,,206,605
Karluk,1986,1941,,207,2546
Karluk,1986,374,,208,2920
Karluk,1986,1426,,209,4346
Karluk,1986,796,,210,5142
Karluk,1986,51,,211,5193
Karluk,1986,82,,212,5275
Karluk,1986,376,,213,5651
Karluk,1986,1991,,214,7642
Karluk,1986,3905,,215,11547
Karluk,1986,3315,,216,14862
Karluk,1986,11808,,217,26670
Karluk,1986,3203,,218,29873
Karluk,1986,3482,,219,33355
Karluk,1986,75975,,220,109330
Karluk,1986,8508,,221,117838
Karluk,1986,5773,,222,123611
Karluk,1986,47,,223,123658
Karluk,1986,10659,,224,134317
Karluk,1986,10390,,225,144707
Karluk,1986,2638,,226,147345
Karluk,1986,12996,,227,160341
Karluk,1986,4611,,228,164952
Karluk,1986,25264,,229,190216
Karluk,1986,26953,,230,217169
Karluk,1986,70847,,231,288016
Karluk,1986,33805,,232,321821
Karluk,1986,97420,,233,419241
Karluk,1986,89534,,234,508775
Karluk,1986,7200,,235,515975
Karluk,1986,7467,,236,523442
Karluk,1986,1798,,237,525240
Karluk,1986,46088,,238,571328
Karluk,1986,51265,,239,622593
Karluk,1986,8574,,240,631167
Karluk,1986,1665,,241,632832
Karluk,1986,10848,,242,643680
Karluk,1986,5688,,243,649368
Karluk,1986,5213,,244,654581
Karluk,1986,2662,,245,657243
Karluk,1986,1735,,246,658978
Karluk,1986,3347,,247,662325
Karluk,1986,2397,,248,664722
Karluk,1986,425,,249,665147
Karluk,1986,600,,250,665747
Karluk,1986,1200,,251,666947
Karluk,1986,400,,252,667347
Karluk,1986,248,,253,667595
Karluk,1986,98,,254,667693
Karluk,1986,23,,255,667716
Karluk,1986,26,,256,667742
Karluk,1986,18,,257,667760
Karluk,1986,1,,258,667761
Karluk,1986,11,,259,667772
Karluk,1986,8,,260,667780
Karluk,1986,6,,261,667786
Karluk,1986,7,,262,667793
Karluk,1986,416,,263,668209
Karluk,1986,44,,264,668253
Karluk,1986,2,,265,668255
Karluk,1986,0,,266,668255
Karluk,1986,1,,267,668256
Karluk,1986,0,,268,668256
Karluk,1986,2,,269,668258
Karluk,1986,5,,270,668263
Karluk,1986,18,,271,668281
Karluk,1986,16,,272,668297
Karluk,1986,0,,273,668297
Karluk,1986,0,,274,668297
Karluk,1986,0,,275,668297
Karluk,1986,0,,276,668297
Karluk,1986,0,,277,668297
Karluk,1986,0,,278,668297
Karluk,1986,0,,279,668297
Karluk,1986,0,,280,668297
Karluk,1986,0,,281,668297
Karluk,1986,0,,282,668297
Karluk,1986,0,,283,668297
Karluk,1986,0,,284,668297
Karluk,1986,0,,285,668297
Karluk,1985,0,,154,0
Karluk,1985,0,,155,0
Karluk,1985,0,,156,0
Karluk,1985,0,,157,0
Karluk,1985,0,,158,0
Karluk,1985,0,,159,0
Karluk,1985,0,,160,0
Karluk,1985,0,,161,0
Karluk,1985,0,,162,0
Karluk,1985,0,,163,0
Karluk,1985,0,,164,0
Karluk,1985,0,,165,0
Karluk,1985,0,,166,0
Karluk,1985,0,,167,0
Karluk,1985,0,,168,0
Karluk,1985,0,,169,0
Karluk,1985,0,,170,0
Karluk,1985,0,,171,0
Karluk,1985,0,,172,0
Karluk,1985,0,,173,0
Karluk,1985,0,,174,0
Karluk,1985,0,,175,0
Karluk,1985,0,,176,0
Karluk,1985,0,,177,0
Karluk,1985,0,,178,0
Karluk,1985,0,,179,0
Karluk,1985,2,,180,2
Karluk,1985,2,,181,4
Karluk,1985,1,,182,5
Karluk,1985,4,,183,9
Karluk,1985,6,,184,15
Karluk,1985,5,,185,20
Karluk,1985,6,,186,26
Karluk,1985,84,,187,110
Karluk,1985,30,,188,140
Karluk,1985,18,,189,158
Karluk,1985,41,,190,199
Karluk,1985,16,,191,215
Karluk,1985,46,,192,261
Karluk,1985,85,,193,346
Karluk,1985,31,,194,377
Karluk,1985,27,,195,404
Karluk,1985,189,,196,593
Karluk,1985,105,,197,698
Karluk,1985,24,,198,722
Karluk,1985,6,,199,728
Karluk,1985,20,,200,748
Karluk,1985,42,,201,790
Karluk,1985,55,,202,845
Karluk,1985,330,,203,1175
Karluk,1985,328,,204,1503
Karluk,1985,147,,205,1650
Karluk,1985,2617,,206,4267
Karluk,1985,41,,207,4308
Karluk,1985,36,,208,4344
Karluk,1985,249,,209,4593
Karluk,1985,375,,210,4968
Karluk,1985,274,,211,5242
Karluk,1985,140,,212,5382
Karluk,1985,537,,213,5919
Karluk,1985,91,,214,6010
Karluk,1985,46,,215,6056
Karluk,1985,55,,216,6111
Karluk,1985,36,,217,6147
Karluk,1985,942,,218,7089
Karluk,1985,285,,219,7374
Karluk,1985,175,,220,7549
Karluk,1985,244,,221,7793
Karluk,1985,51,,222,7844
Karluk,1985,447,,223,8291
Karluk,1985,4461,,224,12752
Karluk,1985,2212,,225,14964
Karluk,1985,760,,226,15724
Karluk,1985,727,,227,16451
Karluk,1985,349,,228,16800
Karluk,1985,229,,229,17029
Karluk,1985,587,,230,17616
Karluk,1985,481,,231,18097
Karluk,1985,613,,232,18710
Karluk,1985,424,,233,19134
Karluk,1985,590,,234,19724
Karluk,1985,554,,235,20278
Karluk,1985,309,,236,20587
Karluk,1985,1100,,237,21687
Karluk,1985,1630,,238,23317
Karluk,1985,2400,,239,25717
Karluk,1985,1191,,240,26908
Karluk,1985,2727,,241,29635
Karluk,1985,2284,,242,31919
Karluk,1985,1296,,243,33215
Karluk,1985,2165,,244,35380
Karluk,1985,1233,,245,36613
Karluk,1985,1014,,246,37627
Karluk,1985,467,,247,38094
Karluk,1985,1006,,248,39100
Karluk,1985,349,,249,39449
Karluk,1985,228,,250,39677
Karluk,1985,540,,251,40217
Karluk,1985,13,,252,40230
Karluk,1985,163,,253,40393
Karluk,1985,87,,254,40480
Karluk,1985,115,,255,40595
Karluk,1985,196,,256,40791
Karluk,1985,295,,257,41086
Karluk,1985,75,,258,41161
Karluk,1985,7,,259,41168
Karluk,1985,1,,260,41169
Karluk,1985,13,,261,41182
Karluk,1985,21,,262,41203
Karluk,1985,16,,263,41219
Karluk,1985,3,,264,41222
Karluk,1985,5,,265,41227
Karluk,1985,3,,266,41230
Karluk,1985,2,,267,41232
Karluk,1985,0,,268,41232
Karluk,1985,0,,269,41232
Karluk,1985,0,,270,41232
Karluk,1985,0,,271,41232
Karluk,1985,0,,272,41232
Karluk,1985,0,,273,41232
Karluk,1985,0,,274,41232
Karluk,1985,0,,275,41232
Karluk,1985,0,,276,41232
Karluk,1985,0,,277,41232
Karluk,1985,0,,278,41232
Karluk,1985,0,,279,41232
Karluk,1985,0,,280,41232
Karluk,1985,0,,281,41232
Karluk,1985,0,,282,41232
Karluk,1985,0,,283,41232
Karluk,1985,0,,284,41232
Karluk,1985,0,,285,41232
Karluk,1984,0,,155,0
Karluk,1984,0,,156,0
Karluk,1984,0,,157,0
Karluk,1984,0,,158,0
Karluk,1984,0,,159,0
Karluk,1984,0,,160,0
Karluk,1984,0,,161,0
Karluk,1984,0,,162,0
Karluk,1984,0,,163,0
Karluk,1984,0,,164,0
Karluk,1984,0,,165,0
Karluk,1984,0,,166,0
Karluk,1984,0,,167,0
Karluk,1984,0,,168,0
Karluk,1984,0,,169,0
Karluk,1984,0,,170,0
Karluk,1984,0,,171,0
Karluk,1984,0,,172,0
Karluk,1984,0,,173,0
Karluk,1984,0,,174,0
Karluk,1984,2,,175,2
Karluk,1984,0,,176,2
Karluk,1984,0,,177,2
Karluk,1984,0,,178,2
Karluk,1984,0,,179,2
Karluk,1984,2,,180,4
Karluk,1984,0,,181,4
Karluk,1984,0,,182,4
Karluk,1984,0,,183,4
Karluk,1984,3,,184,7
Karluk,1984,0,,185,7
Karluk,1984,0,,186,7
Karluk,1984,13,,187,20
Karluk,1984,8,,188,28
Karluk,1984,29,,189,57
Karluk,1984,12,,190,69
Karluk,1984,9,,191,78
Karluk,1984,9,,192,87
Karluk,1984,47,,193,134
Karluk,1984,27,,194,161
Karluk,1984,51,,195,212
Karluk,1984,118,,196,330
Karluk,1984,4170,,197,4500
Karluk,1984,14083,,198,18583
Karluk,1984,9277,,199,27860
Karluk,1984,72810,,200,100670
Karluk,1984,20720,,201,121390
Karluk,1984,33550,,202,154940
Karluk,1984,93630,,203,248570
Karluk,1984,36990,,204,285560
Karluk,1984,30380,,205,315940
Karluk,1984,32590,,206,348530
Karluk,1984,27470,,207,376000
Karluk,1984,49250,,208,425250
Karluk,1984,17640,,209,442890
Karluk,1984,18990,,210,461880
Karluk,1984,23860,,211,485740
Karluk,1984,27350,,212,513090
Karluk,1984,78710,,213,591800
Karluk,1984,128930,,214,720730
Karluk,1984,184650,,215,905380
Karluk,1984,60500,,216,965880
Karluk,1984,16120,,217,982000
Karluk,1984,63340,,218,1045340
Karluk,1984,66680,,219,1112020
Karluk,1984,29830,,220,1141850
Karluk,1984,6230,,221,1148080
Karluk,1984,22700,,222,1170780
Karluk,1984,10310,,223,1181090
Karluk,1984,6630,,224,1187720
Karluk,1984,6880,,225,1194600
Karluk,1984,3410,,226,1198010
Karluk,1984,6170,,227,1204180
Karluk,1984,5760,,228,1209940
Karluk,1984,24980,,229,1234920
Karluk,1984,50910,,230,1285830
Karluk,1984,130730,,231,1416560
Karluk,1984,82560,,232,1499120
Karluk,1984,9350,,233,1508470
Karluk,1984,14530,,234,1523000
Karluk,1984,18310,,235,1541310
Karluk,1984,15050,,236,1556360
Karluk,1984,15000,,237,1571360
Karluk,1984,20000,,238,1591360
Karluk,1984,20000,,239,1611360
Karluk,1984,5000,,240,1616360
Karluk,1984,3000,,241,1619360
Karluk,1984,5000,,242,1624360
Karluk,1984,11010,,243,1635370
Karluk,1984,18000,,244,1653370
Karluk,1984,3000,,245,1656370
Karluk,1984,3000,,246,1659370
Karluk,1984,8343,,247,1667713
Karluk,1984,1531,,248,1669244
Karluk,1984,500,,249,1669744
Karluk,1984,1067,,250,1670811
Karluk,1984,460,,251,1671271
Karluk,1984,387,,252,1671658
Karluk,1984,200,,253,1671858
Karluk,1984,100,,254,1671958
Karluk,1984,76,,255,1672034
Karluk,1984,68,,256,1672102
Karluk,1984,31,,257,1672133
Karluk,1984,45,,258,1672178
Karluk,1984,14,,259,1672192
Karluk,1984,64,,260,1672256
Karluk,1984,43,,261,1672299
Karluk,1984,29,,262,1672328
Karluk,1984,28,,263,1672356
Karluk,1984,9,,264,1672365
Karluk,1984,6,,265,1672371
Karluk,1984,15,,266,1672386
Karluk,1984,15,,267,1672401
Karluk,1984,5,,268,1672406
Karluk,1984,2,,269,1672408
Karluk,1984,0,,270,1672408
Karluk,1984,0,,271,1672408
Karluk,1984,0,,272,1672408
Karluk,1984,0,,273,1672408
Karluk,1984,0,,274,1672408
Karluk,1984,0,,275,1672408
Karluk,1984,0,,276,1672408
Karluk,1984,0,,277,1672408
Karluk,1984,0,,278,1672408
Karluk,1984,0,,279,1672408
Karluk,1984,0,,280,1672408
Karluk,1984,0,,281,1672408
Karluk,1984,0,,282,1672408
Karluk,1984,0,,283,1672408
Karluk,1984,0,,284,1672408
Karluk,1984,0,,285,1672408
Karluk,1984,0,,286,1672408
Karluk,1983,0,,154,0
Karluk,1983,0,,155,0
Karluk,1983,0,,156,0
Karluk,1983,0,,157,0
Karluk,1983,0,,158,0
Karluk,1983,0,,159,0
Karluk,1983,0,,160,0
Karluk,1983,0,,161,0
Karluk,1983,0,,162,0
Karluk,1983,0,,163,0
Karluk,1983,0,,164,0
Karluk,1983,0,,165,0
Karluk,1983,0,,166,0
Karluk,1983,0,,167,0
Karluk,1983,0,,168,0
Karluk,1983,0,,169,0
Karluk,1983,0,,170,0
Karluk,1983,0,,171,0
Karluk,1983,0,,172,0
Karluk,1983,0,,173,0
Karluk,1983,0,,174,0
Karluk,1983,0,,175,0
Karluk,1983,0,,176,0
Karluk,1983,0,,177,0
Karluk,1983,0,,178,0
Karluk,1983,0,,179,0
Karluk,1983,0,,180,0
Karluk,1983,0,,181,0
Karluk,1983,0,,182,0
Karluk,1983,0,,183,0
Karluk,1983,0,,184,0
Karluk,1983,0,,185,0
Karluk,1983,0,,186,0
Karluk,1983,0,,187,0
Karluk,1983,0,,188,0
Karluk,1983,0,,189,0
Karluk,1983,0,,190,0
Karluk,1983,0,,191,0
Karluk,1983,10,,192,10
Karluk,1983,4,,193,14
Karluk,1983,15,,194,29
Karluk,1983,5,,195,34
Karluk,1983,5,,196,39
Karluk,1983,7,,197,46
Karluk,1983,19,,198,65
Karluk,1983,13,,199,78
Karluk,1983,35,,200,113
Karluk,1983,27,,201,140
Karluk,1983,3,,202,143
Karluk,1983,16,,203,159
Karluk,1983,27,,204,186
Karluk,1983,26,,205,212
Karluk,1983,53,,206,265
Karluk,1983,142,,207,407
Karluk,1983,216,,208,623
Karluk,1983,218,,209,841
Karluk,1983,222,,210,1063
Karluk,1983,280,,211,1343
Karluk,1983,159,,212,1502
Karluk,1983,553,,213,2055
Karluk,1983,764,,214,2819
Karluk,1983,337,,215,3156
Karluk,1983,146,,216,3302
Karluk,1983,642,,217,3944
Karluk,1983,480,,218,4424
Karluk,1983,695,,219,5119
Karluk,1983,595,,220,5714
Karluk,1983,170,,221,5884
Karluk,1983,532,,222,6416
Karluk,1983,285,,223,6701
Karluk,1983,563,,224,7264
Karluk,1983,365,,225,7629
Karluk,1983,134,,226,7763
Karluk,1983,325,,227,8088
Karluk,1983,1058,,228,9146
Karluk,1983,2795,,229,11941
Karluk,1983,1141,,230,13082
Karluk,1983,173,,231,13255
Karluk,1983,760,,232,14015
Karluk,1983,1002,,233,15017
Karluk,1983,1656,,234,16673
Karluk,1983,1000,,235,17673
Karluk,1983,87,,236,17760
Karluk,1983,64,,237,17824
Karluk,1983,68,,238,17892
Karluk,1983,1384,,239,19276
Karluk,1983,1839,,240,21115
Karluk,1983,854,,241,21969
Karluk,1983,2196,,242,24165
Karluk,1983,447,,243,24612
Karluk,1983,293,,244,24905
Karluk,1983,1446,,245,26351
Karluk,1983,709,,246,27060
Karluk,1983,51,,247,27111
Karluk,1983,5087,,248,32198
Karluk,1983,4085,,249,36283
Karluk,1983,935,,250,37218
Karluk,1983,108,,251,37326
Karluk,1983,53,,252,37379
Karluk,1983,124,,253,37503
Karluk,1983,80,,254,37583
Karluk,1983,212,,255,37795
Karluk,1983,508,,256,38303
Karluk,1983,185,,257,38488
Karluk,1983,15,,258,38503
Karluk,1983,14,,259,38517
Karluk,1983,105,,260,38622
Karluk,1983,231,,261,38853
Karluk,1983,4,,262,38857
Karluk,1983,15,,263,38872
Karluk,1983,21,,264,38893
Karluk,1983,8,,265,38901
Karluk,1983,1,,266,38902
Karluk,1983,0,,267,38902
Karluk,1983,0,,268,38902
Karluk,1983,0,,269,38902
Karluk,1983,0,,270,38902
Karluk,1983,0,,271,38902
Karluk,1983,0,,272,38902
Karluk,1983,0,,273,38902
Karluk,1983,0,,274,38902
Karluk,1983,0,,275,38902
Karluk,1983,0,,276,38902
Karluk,1983,0,,277,38902
Karluk,1983,0,,278,38902
Karluk,1983,0,,279,38902
Karluk,1983,0,,280,38902
Karluk,1983,0,,281,38902
Karluk,1983,0,,282,38902
Karluk,1983,0,,283,38902
Karluk,1983,0,,284,38902
Karluk,1983,0,,285,38902
Karluk,1982,0,,154,0
Karluk,1982,0,,155,0
Karluk,1982,0,,156,0
Karluk,1982,0,,157,0
Karluk,1982,0,,158,0
Karluk,1982,0,,159,0
Karluk,1982,0,,160,0
Karluk,1982,0,,161,0
Karluk,1982,0,,162,0
Karluk,1982,0,,163,0
Karluk,1982,0,,164,0
Karluk,1982,0,,165,0
Karluk,1982,0,,166,0
Karluk,1982,0,,167,0
Karluk,1982,0,,168,0
Karluk,1982,0,,169,0
Karluk,1982,0,,170,0
Karluk,1982,0,,171,0
Karluk,1982,0,,172,0
Karluk,1982,0,,173,0
Karluk,1982,0,,174,0
Karluk,1982,0,,175,0
Karluk,1982,0,,176,0
Karluk,1982,0,,177,0
Karluk,1982,2,,178,2
Karluk,1982,2,,179,4
Karluk,1982,1,,180,5
Karluk,1982,2,,181,7
Karluk,1982,0,,182,7
Karluk,1982,0,,183,7
Karluk,1982,1,,184,8
Karluk,1982,3,,185,11
Karluk,1982,13,,186,24
Karluk,1982,16,,187,40
Karluk,1982,25,,188,65
Karluk,1982,25,,189,90
Karluk,1982,20,,190,110
Karluk,1982,16,,191,126
Karluk,1982,20,,192,146
Karluk,1982,9,,193,155
Karluk,1982,15,,194,170
Karluk,1982,18,,195,188
Karluk,1982,13,,196,201
Karluk,1982,31,,197,232
Karluk,1982,46,,198,278
Karluk,1982,9,,199,287
Karluk,1982,74,,200,361
Karluk,1982,62,,201,423
Karluk,1982,28,,202,451
Karluk,1982,105,,203,556
Karluk,1982,440,,204,996
Karluk,1982,502,,205,1498
Karluk,1982,1232,,206,2730
Karluk,1982,18344,,207,21074
Karluk,1982,134900,,208,155974
Karluk,1982,45680,,209,201654
Karluk,1982,75300,,210,276954
Karluk,1982,51700,,211,328654
Karluk,1982,19830,,212,348484
Karluk,1982,11695,,213,360179
Karluk,1982,26400,,214,386579
Karluk,1982,83700,,215,470279
Karluk,1982,99600,,216,569879
Karluk,1982,204900,,217,774779
Karluk,1982,142300,,218,917079
Karluk,1982,88150,,219,1005229
Karluk,1982,172800,,220,1178029
Karluk,1982,116171,,221,1294200
Karluk,1982,173200,,222,1467400
Karluk,1982,150800,,223,1618200
Karluk,1982,95200,,224,1713400
Karluk,1982,169200,,225,1882600
Karluk,1982,111500,,226,1994100
Karluk,1982,46035,,227,2040135
Karluk,1982,46700,,228,2086835
Karluk,1982,35250,,229,2122085
Karluk,1982,30300,,230,2152385
Karluk,1982,34300,,231,2186685
Karluk,1982,19070,,232,2205755
Karluk,1982,9837,,233,2215592
Karluk,1982,22780,,234,2238372
Karluk,1982,15084,,235,2253456
Karluk,1982,3942,,236,2257398
Karluk,1982,8220,,237,2265618
Karluk,1982,14970,,238,2280588
Karluk,1982,6620,,239,2287208
Karluk,1982,8430,,240,2295638
Karluk,1982,7780,,241,2303418
Karluk,1982,3200,,242,2306618
Karluk,1982,5000,,243,2311618
Karluk,1982,6000,,244,2317618
Karluk,1982,1142,,245,2318760
Karluk,1982,1143,,246,2319903
Karluk,1982,1143,,247,2321046
Karluk,1982,1143,,248,2322189
Karluk,1982,1143,,249,2323332
Karluk,1982,1143,,250,2324475
Karluk,1982,1143,,251,2325618
Karluk,1982,105,,252,2325723
Karluk,1982,163,,253,2325886
Karluk,1982,64,,254,2325950
Karluk,1982,75,,255,2326025
Karluk,1982,424,,256,2326449
Karluk,1982,150,,257,2326599
Karluk,1982,75,,258,2326674
Karluk,1982,0,,259,2326674
Karluk,1982,0,,260,2326674
Karluk,1982,0,,261,2326674
Karluk,1982,0,,262,2326674
Karluk,1982,0,,263,2326674
Karluk,1982,0,,264,2326674
Karluk,1982,0,,265,2326674
Karluk,1982,0,,266,2326674
Karluk,1982,0,,267,2326674
Karluk,1982,0,,268,2326674
Karluk,1982,0,,269,2326674
Karluk,1982,0,,270,2326674
Karluk,1982,0,,271,2326674
Karluk,1982,0,,272,2326674
Karluk,1982,0,,273,2326674
Karluk,1982,0,,274,2326674
Karluk,1982,0,,275,2326674
Karluk,1982,0,,276,2326674
Karluk,1982,0,,277,2326674
Karluk,1982,0,,278,2326674
Karluk,1982,0,,279,2326674
Karluk,1982,0,,280,2326674
Karluk,1982,0,,281,2326674
Karluk,1982,0,,282,2326674
Karluk,1982,0,,283,2326674
Karluk,1982,0,,284,2326674
Karluk,1982,0,,285,2326674
Karluk,1981,0,,154,0
Karluk,1981,0,,155,0
Karluk,1981,0,,156,0
Karluk,1981,0,,157,0
Karluk,1981,0,,158,0
Karluk,1981,0,,159,0
Karluk,1981,0,,160,0
Karluk,1981,0,,161,0
Karluk,1981,0,,162,0
Karluk,1981,0,,163,0
Karluk,1981,0,,164,0
Karluk,1981,0,,165,0
Karluk,1981,0,,166,0
Karluk,1981,0,,167,0
Karluk,1981,0,,168,0
Karluk,1981,0,,169,0
Karluk,1981,0,,170,0
Karluk,1981,0,,171,0
Karluk,1981,0,,172,0
Karluk,1981,0,,173,0
Karluk,1981,0,,174,0
Karluk,1981,0,,175,0
Karluk,1981,0,,176,0
Karluk,1981,0,,177,0
Karluk,1981,0,,178,0
Karluk,1981,0,,179,0
Karluk,1981,0,,180,0
Karluk,1981,0,,181,0
Karluk,1981,0,,182,0
Karluk,1981,0,,183,0
Karluk,1981,0,,184,0
Karluk,1981,0,,185,0
Karluk,1981,0,,186,0
Karluk,1981,0,,187,0
Karluk,1981,0,,188,0
Karluk,1981,0,,189,0
Karluk,1981,0,,190,0
Karluk,1981,0,,191,0
Karluk,1981,0,,192,0
Karluk,1981,1,,193,1
Karluk,1981,0,,194,1
Karluk,1981,1,,195,2
Karluk,1981,36,,196,38
Karluk,1981,6,,197,44
Karluk,1981,5,,198,49
Karluk,1981,11,,199,60
Karluk,1981,11,,200,71
Karluk,1981,67,,201,138
Karluk,1981,75,,202,213
Karluk,1981,539,,203,752
Karluk,1981,318,,204,1070
Karluk,1981,243,,205,1313
Karluk,1981,127,,206,1440
Karluk,1981,202,,207,1642
Karluk,1981,69,,208,1711
Karluk,1981,314,,209,2025
Karluk,1981,52,,210,2077
Karluk,1981,236,,211,2313
Karluk,1981,409,,212,2722
Karluk,1981,391,,213,3113
Karluk,1981,4400,,214,7513
Karluk,1981,790,,215,8303
Karluk,1981,96,,216,8399
Karluk,1981,1039,,217,9438
Karluk,1981,1185,,218,10623
Karluk,1981,1797,,219,12420
Karluk,1981,103,,220,12523
Karluk,1981,990,,221,13513
Karluk,1981,1366,,222,14879
Karluk,1981,3738,,223,18617
Karluk,1981,4091,,224,22708
Karluk,1981,458,,225,23166
Karluk,1981,369,,226,23535
Karluk,1981,340,,227,23875
Karluk,1981,252,,228,24127
Karluk,1981,447,,229,24574
Karluk,1981,2326,,230,26900
Karluk,1981,768,,231,27668
Karluk,1981,1753,,232,29421
Karluk,1981,2966,,233,32387
Karluk,1981,1281,,234,33668
Karluk,1981,624,,235,34292
Karluk,1981,1466,,236,35758
Karluk,1981,4905,,237,40663
Karluk,1981,923,,238,41586
Karluk,1981,1397,,239,42983
Karluk,1981,499,,240,43482
Karluk,1981,556,,241,44038
Karluk,1981,163,,242,44201
Karluk,1981,381,,243,44582
Karluk,1981,528,,244,45110
Karluk,1981,416,,245,45526
Karluk,1981,308,,246,45834
Karluk,1981,1592,,247,47426
Karluk,1981,200,,248,47626
Karluk,1981,775,,249,48401
Karluk,1981,859,,250,49260
Karluk,1981,403,,251,49663
Karluk,1981,592,,252,50255
Karluk,1981,204,,253,50459
Karluk,1981,226,,254,50685
Karluk,1981,22,,255,50707
Karluk,1981,226,,256,50933
Karluk,1981,66,,257,50999
Karluk,1981,210,,258,51209
Karluk,1981,17,,259,51226
Karluk,1981,9,,260,51235
Karluk,1981,5,,261,51240
Karluk,1981,1,,262,51241
Karluk,1981,7,,263,51248
Karluk,1981,0,,264,51248
Karluk,1981,0,,265,51248
Karluk,1981,0,,266,51248
Karluk,1981,0,,267,51248
Karluk,1981,0,,268,51248
Karluk,1981,0,,269,51248
Karluk,1981,0,,270,51248
Karluk,1981,0,,271,51248
Karluk,1981,0,,272,51248
Karluk,1981,0,,273,51248
Karluk,1981,0,,274,51248
Karluk,1981,0,,275,51248
Karluk,1981,0,,276,51248
Karluk,1981,0,,277,51248
Karluk,1981,0,,278,51248
Karluk,1981,0,,279,51248
Karluk,1981,0,,280,51248
Karluk,1981,0,,281,51248
Karluk,1981,0,,282,51248
Karluk,1981,0,,283,51248
Karluk,1981,0,,284,51248
Karluk,1981,0,,285,51248
Karluk,1980,0,,155,0
Karluk,1980,0,,156,0
Karluk,1980,0,,157,0
Karluk,1980,0,,158,0
Karluk,1980,0,,159,0
Karluk,1980,0,,160,0
Karluk,1980,0,,161,0
Karluk,1980,0,,162,0
Karluk,1980,0,,163,0
Karluk,1980,0,,164,0
Karluk,1980,0,,165,0
Karluk,1980,0,,166,0
Karluk,1980,0,,167,0
Karluk,1980,0,,168,0
Karluk,1980,0,,169,0
Karluk,1980,0,,170,0
Karluk,1980,0,,171,0
Karluk,1980,0,,172,0
Karluk,1980,0,,173,0
Karluk,1980,0,,174,0
Karluk,1980,0,,175,0
Karluk,1980,0,,176,0
Karluk,1980,0,,177,0
Karluk,1980,0,,178,0
Karluk,1980,0,,179,0
Karluk,1980,0,,180,0
Karluk,1980,0,,181,0
Karluk,1980,0,,182,0
Karluk,1980,0,,183,0
Karluk,1980,0,,184,0
Karluk,1980,0,,185,0
Karluk,1980,0,,186,0
Karluk,1980,0,,187,0
Karluk,1980,33,,188,33
Karluk,1980,4,,189,37
Karluk,1980,9,,190,46
Karluk,1980,12,,191,58
Karluk,1980,89,,192,147
Karluk,1980,15,,193,162
Karluk,1980,100,,194,262
Karluk,1980,106,,195,368
Karluk,1980,57,,196,425
Karluk,1980,62,,197,487
Karluk,1980,93,,198,580
Karluk,1980,227,,199,807
Karluk,1980,3743,,200,4550
Karluk,1980,42039,,201,46589
Karluk,1980,57415,,202,104004
Karluk,1980,129705,,203,233709
Karluk,1980,216210,,204,449919
Karluk,1980,169635,,205,619554
Karluk,1980,250710,,206,870264
Karluk,1980,201810,,207,1072074
Karluk,1980,62880,,208,1134954
Karluk,1980,32560,,209,1167514
Karluk,1980,31622,,210,1199136
Karluk,1980,60120,,211,1259256
Karluk,1980,14085,,212,1273341
Karluk,1980,8315,,213,1281656
Karluk,1980,3292,,214,1284948
Karluk,1980,1080,,215,1286028
Karluk,1980,14517,,216,1300545
Karluk,1980,60039,,217,1360584
Karluk,1980,154330,,218,1514914
Karluk,1980,113231,,219,1628145
Karluk,1980,18702,,220,1646847
Karluk,1980,20380,,221,1667227
Karluk,1980,41152,,222,1708379
Karluk,1980,9974,,223,1718353
Karluk,1980,19740,,224,1738093
Karluk,1980,66890,,225,1804983
Karluk,1980,10526,,226,1815509
Karluk,1980,85768,,227,1901277
Karluk,1980,132881,,228,2034158
Karluk,1980,52777,,229,2086935
Karluk,1980,31831,,230,2118766
Karluk,1980,6580,,231,2125346
Karluk,1980,16190,,232,2141536
Karluk,1980,11526,,233,2153062
Karluk,1980,9041,,234,2162103
Karluk,1980,15218,,235,2177321
Karluk,1980,21114,,236,2198435
Karluk,1980,18520,,237,2216955
Karluk,1980,19490,,238,2236445
Karluk,1980,30144,,239,2266589
Karluk,1980,22366,,240,2288955
Karluk,1980,13819,,241,2302774
Karluk,1980,3893,,242,2306667
Karluk,1980,6110,,243,2312777
Karluk,1980,22600,,244,2335377
Karluk,1980,5772,,245,2341149
Karluk,1980,462,,246,2341611
Karluk,1980,1348,,247,2342959
Karluk,1980,3755,,248,2346714
Karluk,1980,4125,,249,2350839
Karluk,1980,3589,,250,2354428
Karluk,1980,217,,251,2354645
Karluk,1980,3959,,252,2358604
Karluk,1980,447,,253,2359051
Karluk,1980,109,,254,2359160
Karluk,1980,0,,255,2359160
Karluk,1980,0,,256,2359160
Karluk,1980,0,,257,2359160
Karluk,1980,0,,258,2359160
Karluk,1980,0,,259,2359160
Karluk,1980,0,,260,2359160
Karluk,1980,0,,261,2359160
Karluk,1980,0,,262,2359160
Karluk,1980,0,,263,2359160
Karluk,1980,0,,264,2359160
Karluk,1980,0,,265,2359160
Karluk,1980,0,,266,2359160
Karluk,1980,0,,267,2359160
Karluk,1980,0,,268,2359160
Karluk,1980,0,,269,2359160
Karluk,1980,0,,270,2359160
Karluk,1980,0,,271,2359160
Karluk,1980,0,,272,2359160
Karluk,1980,0,,273,2359160
Karluk,1980,0,,274,2359160
Karluk,1980,0,,275,2359160
Karluk,1980,0,,276,2359160
Karluk,1980,0,,277,2359160
Karluk,1980,0,,278,2359160
Karluk,1980,0,,279,2359160
Karluk,1980,0,,280,2359160
Karluk,1980,0,,281,2359160
Karluk,1980,0,,282,2359160
Karluk,1980,0,,283,2359160
Karluk,1980,0,,284,2359160
Karluk,1980,0,,285,2359160
Karluk,1980,0,,286,2359160
Karluk,1979,0,,154,0
Karluk,1979,0,,155,0
Karluk,1979,0,,156,0
Karluk,1979,0,,157,0
Karluk,1979,0,,158,0
Karluk,1979,0,,159,0
Karluk,1979,0,,160,0
Karluk,1979,0,,161,0
Karluk,1979,0,,162,0
Karluk,1979,0,,163,0
Karluk,1979,0,,164,0
Karluk,1979,0,,165,0
Karluk,1979,0,,166,0
Karluk,1979,0,,167,0
Karluk,1979,0,,168,0
Karluk,1979,0,,169,0
Karluk,1979,0,,170,0
Karluk,1979,0,,171,0
Karluk,1979,0,,172,0
Karluk,1979,0,,173,0
Karluk,1979,0,,174,0
Karluk,1979,9,,175,9
Karluk,1979,4,,176,13
Karluk,1979,4,,177,17
Karluk,1979,1,,178,18
Karluk,1979,6,,179,24
Karluk,1979,10,,180,34
Karluk,1979,10,,181,44
Karluk,1979,63,,182,107
Karluk,1979,28,,183,135
Karluk,1979,32,,184,167
Karluk,1979,7,,185,174
Karluk,1979,22,,186,196
Karluk,1979,10,,187,206
Karluk,1979,22,,188,228
Karluk,1979,5,,189,233
Karluk,1979,20,,190,253
Karluk,1979,9,,191,262
Karluk,1979,33,,192,295
Karluk,1979,28,,193,323
Karluk,1979,140,,194,463
Karluk,1979,217,,195,680
Karluk,1979,175,,196,855
Karluk,1979,567,,197,1422
Karluk,1979,1160,,198,2582
Karluk,1979,2975,,199,5557
Karluk,1979,2126,,200,7683
Karluk,1979,1373,,201,9056
Karluk,1979,758,,202,9814
Karluk,1979,216,,203,10030
Karluk,1979,1355,,204,11385
Karluk,1979,2501,,205,13886
Karluk,1979,1442,,206,15328
Karluk,1979,1593,,207,16921
Karluk,1979,939,,208,17860
Karluk,1979,1223,,209,19083
Karluk,1979,729,,210,19812
Karluk,1979,1001,,211,20813
Karluk,1979,1428,,212,22241
Karluk,1979,4599,,213,26840
Karluk,1979,4124,,214,30964
Karluk,1979,1031,,215,31995
Karluk,1979,811,,216,32806
Karluk,1979,2279,,217,35085
Karluk,1979,2585,,218,37670
Karluk,1979,4306,,219,41976
Karluk,1979,1586,,220,43562
Karluk,1979,1328,,221,44890
Karluk,1979,1509,,222,46399
Karluk,1979,1005,,223,47404
Karluk,1979,778,,224,48182
Karluk,1979,1380,,225,49562
Karluk,1979,1778,,226,51340
Karluk,1979,1293,,227,52633
Karluk,1979,2809,,228,55442
Karluk,1979,2732,,229,58174
Karluk,1979,1511,,230,59685
Karluk,1979,2890,,231,62575
Karluk,1979,1348,,232,63923
Karluk,1979,603,,233,64526
Karluk,1979,487,,234,65013
Karluk,1979,1094,,235,66107
Karluk,1979,878,,236,66985
Karluk,1979,323,,237,67308
Karluk,1979,300,,238,67608
Karluk,1979,665,,239,68273
Karluk,1979,704,,240,68977
Karluk,1979,722,,241,69699
Karluk,1979,1375,,242,71074
Karluk,1979,1465,,243,72539
Karluk,1979,1706,,244,74245
Karluk,1979,1180,,245,75425
Karluk,1979,1439,,246,76864
Karluk,1979,819,,247,77683
Karluk,1979,973,,248,78656
Karluk,1979,1007,,249,79663
Karluk,1979,611,,250,80274
Karluk,1979,522,,251,80796
Karluk,1979,132,,252,80928
Karluk,1979,82,,253,81010
Karluk,1979,72,,254,81082
Karluk,1979,104,,255,81186
Karluk,1979,73,,256,81259
Karluk,1979,84,,257,81343
Karluk,1979,27,,258,81370
Karluk,1979,5,,259,81375
Karluk,1979,35,,260,81410
Karluk,1979,12,,261,81422
Karluk,1979,10,,262,81432
Karluk,1979,12,,263,81444
Karluk,1979,6,,264,81450
Karluk,1979,17,,265,81467
Karluk,1979,3,,266,81470
Karluk,1979,1,,267,81471
Karluk,1979,0,,268,81471
Karluk,1979,2,,269,81473
Karluk,1979,0,,270,81473
Karluk,1979,0,,271,81473
Karluk,1979,0,,272,81473
Karluk,1979,0,,273,81473
Karluk,1979,0,,274,81473
Karluk,1979,0,,275,81473
Karluk,1979,0,,276,81473
Karluk,1979,0,,277,81473
Karluk,1979,0,,278,81473
Karluk,1979,0,,279,81473
Karluk,1979,0,,280,81473
Karluk,1979,0,,281,81473
Karluk,1979,0,,282,81473
Karluk,1979,0,,283,81473
Karluk,1979,0,,284,81473
Karluk,1979,0,,285,81473
Karluk,1978,0,,154,0
Karluk,1978,0,,155,0
Karluk,1978,0,,156,0
Karluk,1978,0,,157,0
Karluk,1978,0,,158,0
Karluk,1978,0,,159,0
Karluk,1978,0,,160,0
Karluk,1978,0,,161,0
Karluk,1978,0,,162,0
Karluk,1978,0,,163,0
Karluk,1978,0,,164,0
Karluk,1978,0,,165,0
Karluk,1978,0,,166,0
Karluk,1978,0,,167,0
Karluk,1978,0,,168,0
Karluk,1978,0,,169,0
Karluk,1978,0,,170,0
Karluk,1978,0,,171,0
Karluk,1978,0,,172,0
Karluk,1978,0,,173,0
Karluk,1978,0,,174,0
Karluk,1978,0,,175,0
Karluk,1978,0,,176,0
Karluk,1978,0,,177,0
Karluk,1978,0,,178,0
Karluk,1978,0,,179,0
Karluk,1978,0,,180,0
Karluk,1978,0,,181,0
Karluk,1978,0,,182,0
Karluk,1978,13,,183,13
Karluk,1978,12,,184,25
Karluk,1978,2,,185,27
Karluk,1978,5,,186,32
Karluk,1978,14,,187,46
Karluk,1978,14,,188,60
Karluk,1978,22,,189,82
Karluk,1978,23,,190,105
Karluk,1978,20,,191,125
Karluk,1978,25,,192,150
Karluk,1978,12,,193,162
Karluk,1978,3,,194,165
Karluk,1978,10,,195,175
Karluk,1978,13,,196,188
Karluk,1978,7,,197,195
Karluk,1978,4,,198,199
Karluk,1978,13,,199,212
Karluk,1978,26,,200,238
Karluk,1978,19,,201,257
Karluk,1978,13,,202,270
Karluk,1978,13,,203,283
Karluk,1978,11,,204,294
Karluk,1978,37,,205,331
Karluk,1978,29,,206,360
Karluk,1978,23,,207,383
Karluk,1978,48,,208,431
Karluk,1978,352,,209,783
Karluk,1978,2474,,210,3257
Karluk,1978,7685,,211,10942
Karluk,1978,52787,,212,63729
Karluk,1978,10643,,213,74372
Karluk,1978,6701,,214,81073
Karluk,1978,4889,,215,85962
Karluk,1978,5971,,216,91933
Karluk,1978,141,,217,92074
Karluk,1978,69,,218,92143
Karluk,1978,16837,,219,108980
Karluk,1978,929,,220,109909
Karluk,1978,6690,,221,116599
Karluk,1978,7657,,222,124256
Karluk,1978,21480,,223,145736
Karluk,1978,71039,,224,216775
Karluk,1978,100143,,225,316918
Karluk,1978,77108,,226,394026
Karluk,1978,77250,,227,471276
Karluk,1978,130326,,228,601602
Karluk,1978,72022,,229,673624
Karluk,1978,48618,,230,722242
Karluk,1978,45800,,231,768042
Karluk,1978,94761,,232,862803
Karluk,1978,30646,,233,893449
Karluk,1978,42687,,234,936136
Karluk,1978,31926,,235,968062
Karluk,1978,26159,,236,994221
Karluk,1978,12029,,237,1006250
Karluk,1978,4728,,238,1010978
Karluk,1978,46452,,239,1057430
Karluk,1978,35849,,240,1093279
Karluk,1978,58606,,241,1151885
Karluk,1978,52178,,242,1204063
Karluk,1978,27444,,243,1231507
Karluk,1978,22190,,244,1253697
Karluk,1978,29074,,245,1282771
Karluk,1978,15399,,246,1298170
Karluk,1978,11667,,247,1309837
Karluk,1978,54450,,248,1364287
Karluk,1978,4038,,249,1368325
Karluk,1978,3456,,250,1371781
Karluk,1978,1968,,251,1373749
Karluk,1978,2364,,252,1376113
Karluk,1978,1386,,253,1377499
Karluk,1978,546,,254,1378045
Karluk,1978,726,,255,1378771
Karluk,1978,696,,256,1379467
Karluk,1978,432,,257,1379899
Karluk,1978,408,,258,1380307
Karluk,1978,108,,259,1380415
Karluk,1978,40,,260,1380455
Karluk,1978,78,,261,1380533
Karluk,1978,54,,262,1380587
Karluk,1978,108,,263,1380695
Karluk,1978,60,,264,1380755
Karluk,1978,24,,265,1380779
Karluk,1978,0,,266,1380779
Karluk,1978,0,,267,1380779
Karluk,1978,0,,268,1380779
Karluk,1978,0,,269,1380779
Karluk,1978,0,,270,1380779
Karluk,1978,0,,271,1380779
Karluk,1978,4,,272,1380783
Karluk,1978,2,,273,1380785
Karluk,1978,4,,274,1380789
Karluk,1978,3,,275,1380792
Karluk,1978,0,,276,1380792
Karluk,1978,0,,277,1380792
Karluk,1978,0,,278,1380792
Karluk,1978,0,,279,1380792
Karluk,1978,0,,280,1380792
Karluk,1978,0,,281,1380792
Karluk,1978,0,,282,1380792
Karluk,1978,0,,283,1380792
Karluk,1978,0,,284,1380792
Karluk,1978,0,,285,1380792
Karluk,1977,0,,154,0
Karluk,1977,0,,155,0
Karluk,1977,0,,156,0
Karluk,1977,0,,157,0
Karluk,1977,0,,158,0
Karluk,1977,0,,159,0
Karluk,1977,0,,160,0
Karluk,1977,0,,161,0
Karluk,1977,0,,162,0
Karluk,1977,0,,163,0
Karluk,1977,0,,164,0
Karluk,1977,0,,165,0
Karluk,1977,0,,166,0
Karluk,1977,0,,167,0
Karluk,1977,0,,168,0
Karluk,1977,0,,169,0
Karluk,1977,0,,170,0
Karluk,1977,0,,171,0
Karluk,1977,0,,172,0
Karluk,1977,0,,173,0
Karluk,1977,0,,174,0
Karluk,1977,0,,175,0
Karluk,1977,0,,176,0
Karluk,1977,0,,177,0
Karluk,1977,0,,178,0
Karluk,1977,0,,179,0
Karluk,1977,3,,180,3
Karluk,1977,4,,181,7
Karluk,1977,7,,182,14
Karluk,1977,10,,183,24
Karluk,1977,8,,184,32
Karluk,1977,0,,185,32
Karluk,1977,6,,186,38
Karluk,1977,11,,187,49
Karluk,1977,23,,188,72
Karluk,1977,30,,189,102
Karluk,1977,18,,190,120
Karluk,1977,51,,191,171
Karluk,1977,119,,192,290
Karluk,1977,84,,193,374
Karluk,1977,97,,194,471
Karluk,1977,17,,195,488
Karluk,1977,38,,196,526
Karluk,1977,72,,197,598
Karluk,1977,177,,198,775
Karluk,1977,289,,199,1064
Karluk,1977,1085,,200,2149
Karluk,1977,615,,201,2764
Karluk,1977,1000,,202,3764
Karluk,1977,523,,203,4287
Karluk,1977,599,,204,4886
Karluk,1977,1333,,205,6219
Karluk,1977,869,,206,7088
Karluk,1977,2286,,207,9374
Karluk,1977,4961,,208,14335
Karluk,1977,3718,,209,18053
Karluk,1977,1410,,210,19463
Karluk,1977,4315,,211,23778
Karluk,1977,1051,,212,24829
Karluk,1977,657,,213,25486
Karluk,1977,589,,214,26075
Karluk,1977,1482,,215,27557
Karluk,1977,773,,216,28330
Karluk,1977,2304,,217,30634
Karluk,1977,580,,218,31214
Karluk,1977,2006,,219,33220
Karluk,1977,2311,,220,35531
Karluk,1977,2247,,221,37778
Karluk,1977,1656,,222,39434
Karluk,1977,962,,223,40396
Karluk,1977,2244,,224,42640
Karluk,1977,724,,225,43364
Karluk,1977,156,,226,43520
Karluk,1977,138,,227,43658
Karluk,1977,360,,228,44018
Karluk,1977,3614,,229,47632
Karluk,1977,544,,230,48176
Karluk,1977,220,,231,48396
Karluk,1977,177,,232,48573
Karluk,1977,74,,233,48647
Karluk,1977,60,,234,48707
Karluk,1977,105,,235,48812
Karluk,1977,66,,236,48878
Karluk,1977,56,,237,48934
Karluk,1977,819,,238,49753
Karluk,1977,860,,239,50613
Karluk,1977,321,,240,50934
Karluk,1977,170,,241,51104
Karluk,1977,189,,242,51293
Karluk,1977,210,,243,51503
Karluk,1977,40,,244,51543
Karluk,1977,24,,245,51567
Karluk,1977,162,,246,51729
Karluk,1977,63,,247,51792
Karluk,1977,40,,248,51832
Karluk,1977,19,,249,51851
Karluk,1977,43,,250,51894
Karluk,1977,115,,251,52009
Karluk,1977,24,,252,52033
Karluk,1977,143,,253,52176
Karluk,1977,66,,254,52242
Karluk,1977,3,,255,52245
Karluk,1977,15,,256,52260
Karluk,1977,18,,257,52278
Karluk,1977,14,,258,52292
Karluk,1977,9,,259,52301
Karluk,1977,7,,260,52308
Karluk,1977,3,,261,52311
Karluk,1977,1,,262,52312
Karluk,1977,0,,263,52312
Karluk,1977,0,,264,52312
Karluk,1977,0,,265,52312
Karluk,1977,4,,266,52316
Karluk,1977,0,,267,52316
Karluk,1977,0,,268,52316
Karluk,1977,0,,269,52316
Karluk,1977,2,,270,52318
Karluk,1977,0,,271,52318
Karluk,1977,0,,272,52318
Karluk,1977,0,,273,52318
Karluk,1977,0,,274,52318
Karluk,1977,0,,275,52318
Karluk,1977,0,,276,52318
Karluk,1977,0,,277,52318
Karluk,1977,0,,278,52318
Karluk,1977,1,,279,52319
Karluk,1977,0,,280,52319
Karluk,1977,0,,281,52319
Karluk,1977,0,,282,52319
Karluk,1977,0,,283,52319
Karluk,1977,0,,284,52319
Karluk,1977,0,,285,52319
Karluk,1976,0,,155,0
Karluk,1976,0,,156,0
Karluk,1976,0,,157,0
Karluk,1976,0,,158,0
Karluk,1976,0,,159,0
Karluk,1976,0,,160,0
Karluk,1976,0,,161,0
Karluk,1976,0,,162,0
Karluk,1976,0,,163,0
Karluk,1976,0,,164,0
Karluk,1976,0,,165,0
Karluk,1976,0,,166,0
Karluk,1976,0,,167,0
Karluk,1976,0,,168,0
Karluk,1976,0,,169,0
Karluk,1976,0,,170,0
Karluk,1976,0,,171,0
Karluk,1976,0,,172,0
Karluk,1976,0,,173,0
Karluk,1976,0,,174,0
Karluk,1976,0,,175,0
Karluk,1976,0,,176,0
Karluk,1976,0,,177,0
Karluk,1976,0,,178,0
Karluk,1976,0,,179,0
Karluk,1976,0,,180,0
Karluk,1976,0,,181,0
Karluk,1976,0,,182,0
Karluk,1976,3,,183,3
Karluk,1976,3,,184,6
Karluk,1976,10,,185,16
Karluk,1976,15,,186,31
Karluk,1976,9,,187,40
Karluk,1976,58,,188,98
Karluk,1976,38,,189,136
Karluk,1976,33,,190,169
Karluk,1976,24,,191,193
Karluk,1976,21,,192,214
Karluk,1976,5,,193,219
Karluk,1976,26,,194,245
Karluk,1976,32,,195,277
Karluk,1976,61,,196,338
Karluk,1976,76,,197,414
Karluk,1976,49,,198,463
Karluk,1976,30,,199,493
Karluk,1976,88,,200,581
Karluk,1976,92,,201,673
Karluk,1976,150,,202,823
Karluk,1976,119,,203,942
Karluk,1976,77,,204,1019
Karluk,1976,83,,205,1102
Karluk,1976,18,,206,1120
Karluk,1976,18,,207,1138
Karluk,1976,30,,208,1168
Karluk,1976,61,,209,1229
Karluk,1976,163,,210,1392
Karluk,1976,186,,211,1578
Karluk,1976,115,,212,1693
Karluk,1976,474,,213,2167
Karluk,1976,3227,,214,5394
Karluk,1976,13213,,215,18607
Karluk,1976,17708,,216,36315
Karluk,1976,30036,,217,66351
Karluk,1976,20101,,218,86452
Karluk,1976,43205,,219,129657
Karluk,1976,14958,,220,144615
Karluk,1976,9801,,221,154416
Karluk,1976,20083,,222,174499
Karluk,1976,15220,,223,189719
Karluk,1976,34589,,224,224308
Karluk,1976,15841,,225,240149
Karluk,1976,8945,,226,249094
Karluk,1976,12042,,227,261136
Karluk,1976,10591,,228,271727
Karluk,1976,7089,,229,278816
Karluk,1976,5836,,230,284652
Karluk,1976,14531,,231,299183
Karluk,1976,17791,,232,316974
Karluk,1976,3355,,233,320329
Karluk,1976,2647,,234,322976
Karluk,1976,4279,,235,327255
Karluk,1976,3720,,236,330975
Karluk,1976,6166,,237,337141
Karluk,1976,5321,,238,342462
Karluk,1976,6190,,239,348652
Karluk,1976,12724,,240,361376
Karluk,1976,2132,,241,363508
Karluk,1976,1844,,242,365352
Karluk,1976,1262,,243,366614
Karluk,1976,813,,244,367427
Karluk,1976,367,,245,367794
Karluk,1976,1173,,246,368967
Karluk,1976,1486,,247,370453
Karluk,1976,857,,248,371310
Karluk,1976,297,,249,371607
Karluk,1976,67,,250,371674
Karluk,1976,815,,251,372489
Karluk,1976,319,,252,372808
Karluk,1976,84,,253,372892
Karluk,1976,161,,254,373053
Karluk,1976,0,,255,373053
Karluk,1976,1,,256,373054
Karluk,1976,223,,257,373277
Karluk,1976,9,,258,373286
Karluk,1976,76,,259,373362
Karluk,1976,62,,260,373424
Karluk,1976,15,,261,373439
Karluk,1976,0,,262,373439
Karluk,1976,0,,263,373439
Karluk,1976,0,,264,373439
Karluk,1976,0,,265,373439
Karluk,1976,0,,266,373439
Karluk,1976,0,,267,373439
Karluk,1976,0,,268,373439
Karluk,1976,0,,269,373439
Karluk,1976,0,,270,373439
Karluk,1976,0,,271,373439
Karluk,1976,0,,272,373439
Karluk,1976,0,,273,373439
Karluk,1976,0,,274,373439
Karluk,1976,0,,275,373439
Karluk,1976,0,,276,373439
Karluk,1976,0,,277,373439
Karluk,1976,0,,278,373439
Karluk,1976,0,,279,373439
Karluk,1976,0,,280,373439
Karluk,1976,0,,281,373439
Karluk,1976,0,,282,373439
Karluk,1976,0,,283,373439
Karluk,1976,0,,284,373439
Karluk,1976,0,,285,373439
Karluk,1976,0,,286,373439
Karluk,1975,0,,154,0
Karluk,1975,0,,155,0
Karluk,1975,0,,156,0
Karluk,1975,0,,157,0
Karluk,1975,0,,158,0
Karluk,1975,0,,159,0
Karluk,1975,0,,160,0
Karluk,1975,0,,161,0
Karluk,1975,0,,162,0
Karluk,1975,0,,163,0
Karluk,1975,0,,164,0
Karluk,1975,0,,165,0
Karluk,1975,0,,166,0
Karluk,1975,0,,167,0
Karluk,1975,0,,168,0
Karluk,1975,0,,169,0
Karluk,1975,0,,170,0
Karluk,1975,0,,171,0
Karluk,1975,0,,172,0
Karluk,1975,0,,173,0
Karluk,1975,0,,174,0
Karluk,1975,0,,175,0
Karluk,1975,0,,176,0
Karluk,1975,0,,177,0
Karluk,1975,0,,178,0
Karluk,1975,0,,179,0
Karluk,1975,0,,180,0
Karluk,1975,0,,181,0
Karluk,1975,0,,182,0
Karluk,1975,0,,183,0
Karluk,1975,0,,184,0
Karluk,1975,0,,185,0
Karluk,1975,0,,186,0
Karluk,1975,0,,187,0
Karluk,1975,0,,188,0
Karluk,1975,0,,189,0
Karluk,1975,0,,190,0
Karluk,1975,0,,191,0
Karluk,1975,0,,192,0
Karluk,1975,0,,193,0
Karluk,1975,0,,194,0
Karluk,1975,2,,195,2
Karluk,1975,1,,196,3
Karluk,1975,0,,197,3
Karluk,1975,0,,198,3
Karluk,1975,0,,199,3
Karluk,1975,0,,200,3
Karluk,1975,0,,201,3
Karluk,1975,0,,202,3
Karluk,1975,0,,203,3
Karluk,1975,0,,204,3
Karluk,1975,0,,205,3
Karluk,1975,0,,206,3
Karluk,1975,1,,207,4
Karluk,1975,0,,208,4
Karluk,1975,0,,209,4
Karluk,1975,3,,210,7
Karluk,1975,0,,211,7
Karluk,1975,2,,212,9
Karluk,1975,5,,213,14
Karluk,1975,1,,214,15
Karluk,1975,6,,215,21
Karluk,1975,25,,216,46
Karluk,1975,10,,217,56
Karluk,1975,10,,218,66
Karluk,1975,0,,219,66
Karluk,1975,0,,220,66
Karluk,1975,0,,221,66
Karluk,1975,2,,222,68
Karluk,1975,0,,223,68
Karluk,1975,0,,224,68
Karluk,1975,0,,225,68
Karluk,1975,0,,226,68
Karluk,1975,0,,227,68
Karluk,1975,0,,228,68
Karluk,1975,0,,229,68
Karluk,1975,0,,230,68
Karluk,1975,0,,231,68
Karluk,1975,0,,232,68
Karluk,1975,0,,233,68
Karluk,1975,2,,234,70
Karluk,1975,0,,235,70
Karluk,1975,0,,236,70
Karluk,1975,0,,237,70
Karluk,1975,0,,238,70
Karluk,1975,0,,239,70
Karluk,1975,1,,240,71
Karluk,1975,0,,241,71
Karluk,1975,5,,242,76
Karluk,1975,10,,243,86
Karluk,1975,0,,244,86
Karluk,1975,0,,245,86
Karluk,1975,0,,246,86
Karluk,1975,0,,247,86
Karluk,1975,0,,248,86
Karluk,1975,12,,249,98
Karluk,1975,13,,250,111
Karluk,1975,24,,251,135
Karluk,1975,10,,252,145
Karluk,1975,21,,253,166
Karluk,1975,12,,254,178
Karluk,1975,18,,255,196
Karluk,1975,5,,256,201
Karluk,1975,0,,257,201
Karluk,1975,2,,258,203
Karluk,1975,2,,259,205
Karluk,1975,0,,260,205
Karluk,1975,0,,261,205
Karluk,1975,5,,262,210
Karluk,1975,0,,263,210
Karluk,1975,0,,264,210
Karluk,1975,1,,265,211
Karluk,1975,0,,266,211
Karluk,1975,0,,267,211
Karluk,1975,0,,268,211
Karluk,1975,0,,269,211
Karluk,1975,0,,270,211
Karluk,1975,0,,271,211
Karluk,1975,0,,272,211
Karluk,1975,0,,273,211
Karluk,1975,0,,274,211
Karluk,1975,0,,275,211
Karluk,1975,0,,276,211
Karluk,1975,0,,277,211
Karluk,1975,0,,278,211
Karluk,1975,0,,279,211
Karluk,1975,0,,280,211
Karluk,1975,0,,281,211
Karluk,1975,0,,282,211
Karluk,1975,0,,283,211
Karluk,1975,0,,284,211
Karluk,1975,0,,285,211
Karluk,1974,0,,154,0
Karluk,1974,0,,155,0
Karluk,1974,0,,156,0
Karluk,1974,0,,157,0
Karluk,1974,0,,158,0
Karluk,1974,0,,159,0
Karluk,1974,0,,160,0
Karluk,1974,0,,161,0
Karluk,1974,0,,162,0
Karluk,1974,0,,163,0
Karluk,1974,0,,164,0
Karluk,1974,0,,165,0
Karluk,1974,0,,166,0
Karluk,1974,0,,167,0
Karluk,1974,0,,168,0
Karluk,1974,0,,169,0
Karluk,1974,0,,170,0
Karluk,1974,0,,171,0
Karluk,1974,0,,172,0
Karluk,1974,0,,173,0
Karluk,1974,0,,174,0
Karluk,1974,0,,175,0
Karluk,1974,0,,176,0
Karluk,1974,0,,177,0
Karluk,1974,0,,178,0
Karluk,1974,0,,179,0
Karluk,1974,0,,180,0
Karluk,1974,0,,181,0
Karluk,1974,0,,182,0
Karluk,1974,0,,183,0
Karluk,1974,0,,184,0
Karluk,1974,0,,185,0
Karluk,1974,0,,186,0
Karluk,1974,0,,187,0
Karluk,1974,0,,188,0
Karluk,1974,0,,189,0
Karluk,1974,0,,190,0
Karluk,1974,0,,191,0
Karluk,1974,0,,192,0
Karluk,1974,0,,193,0
Karluk,1974,0,,194,0
Karluk,1974,0,,195,0
Karluk,1974,0,,196,0
Karluk,1974,0,,197,0
Karluk,1974,2,,198,2
Karluk,1974,7,,199,9
Karluk,1974,0,,200,9
Karluk,1974,1,,201,10
Karluk,1974,0,,202,10
Karluk,1974,0,,203,10
Karluk,1974,0,,204,10
Karluk,1974,0,,205,10
Karluk,1974,0,,206,10
Karluk,1974,0,,207,10
Karluk,1974,0,,208,10
Karluk,1974,1,,209,11
Karluk,1974,0,,210,11
Karluk,1974,0,,211,11
Karluk,1974,0,,212,11
Karluk,1974,0,,213,11
Karluk,1974,0,,214,11
Karluk,1974,0,,215,11
Karluk,1974,1,,216,12
Karluk,1974,4,,217,16
Karluk,1974,0,,218,16
Karluk,1974,0,,219,16
Karluk,1974,0,,220,16
Karluk,1974,0,,221,16
Karluk,1974,1,,222,17
Karluk,1974,1,,223,18
Karluk,1974,0,,224,18
Karluk,1974,1,,225,19
Karluk,1974,0,,226,19
Karluk,1974,4,,227,23
Karluk,1974,0,,228,23
Karluk,1974,0,,229,23
Karluk,1974,0,,230,23
Karluk,1974,0,,231,23
Karluk,1974,1,,232,24
Karluk,1974,1,,233,25
Karluk,1974,3,,234,28
Karluk,1974,2,,235,30
Karluk,1974,6,,236,36
Karluk,1974,0,,237,36
Karluk,1974,1,,238,37
Karluk,1974,8,,239,45
Karluk,1974,4,,240,49
Karluk,1974,3,,241,52
Karluk,1974,6,,242,58
Karluk,1974,3,,243,61
Karluk,1974,19,,244,80
Karluk,1974,26,,245,106
Karluk,1974,23,,246,129
Karluk,1974,18,,247,147
Karluk,1974,23,,248,170
Karluk,1974,17,,249,187
Karluk,1974,25,,250,212
Karluk,1974,5,,251,217
Karluk,1974,9,,252,226
Karluk,1974,7,,253,233
Karluk,1974,3,,254,236
Karluk,1974,4,,255,240
Karluk,1974,42,,256,282
Karluk,1974,4,,257,286
Karluk,1974,6,,258,292
Karluk,1974,15,,259,307
Karluk,1974,0,,260,307
Karluk,1974,4,,261,311
Karluk,1974,0,,262,311
Karluk,1974,0,,263,311
Karluk,1974,0,,264,311
Karluk,1974,0,,265,311
Karluk,1974,0,,266,311
Karluk,1974,0,,267,311
Karluk,1974,0,,268,311
Karluk,1974,0,,269,311
Karluk,1974,0,,270,311
Karluk,1974,0,,271,311
Karluk,1974,0,,272,311
Karluk,1974,0,,273,311
Karluk,1974,0,,274,311
Karluk,1974,0,,275,311
Karluk,1974,0,,276,311
Karluk,1974,0,,277,311
Karluk,1974,0,,278,311
Karluk,1974,0,,279,311
Karluk,1974,0,,280,311
Karluk,1974,0,,281,311
Karluk,1974,0,,282,311
Karluk,1974,0,,283,311
Karluk,1974,0,,284,311
Karluk,1974,0,,285,311
Karluk,1972,0,,155,0
Karluk,1972,0,,156,0
Karluk,1972,0,,157,0
Karluk,1972,0,,158,0
Karluk,1972,0,,159,0
Karluk,1972,0,,160,0
Karluk,1972,0,,161,0
Karluk,1972,0,,162,0
Karluk,1972,0,,163,0
Karluk,1972,0,,164,0
Karluk,1972,0,,165,0
Karluk,1972,0,,166,0
Karluk,1972,0,,167,0
Karluk,1972,0,,168,0
Karluk,1972,0,,169,0
Karluk,1972,0,,170,0
Karluk,1972,0,,171,0
Karluk,1972,0,,172,0
Karluk,1972,0,,173,0
Karluk,1972,0,,174,0
Karluk,1972,0,,175,0
Karluk,1972,0,,176,0
Karluk,1972,0,,177,0
Karluk,1972,0,,178,0
Karluk,1972,0,,179,0
Karluk,1972,0,,180,0
Karluk,1972,0,,181,0
Karluk,1972,0,,182,0
Karluk,1972,0,,183,0
Karluk,1972,0,,184,0
Karluk,1972,0,,185,0
Karluk,1972,0,,186,0
Karluk,1972,0,,187,0
Karluk,1972,0,,188,0
Karluk,1972,0,,189,0
Karluk,1972,0,,190,0
Karluk,1972,0,,191,0
Karluk,1972,0,,192,0
Karluk,1972,0,,193,0
Karluk,1972,0,,194,0
Karluk,1972,0,,195,0
Karluk,1972,0,,196,0
Karluk,1972,0,,197,0
Karluk,1972,0,,198,0
Karluk,1972,0,,199,0
Karluk,1972,0,,200,0
Karluk,1972,0,,201,0
Karluk,1972,1,,202,1
Karluk,1972,0,,203,1
Karluk,1972,0,,204,1
Karluk,1972,0,,205,1
Karluk,1972,0,,206,1
Karluk,1972,0,,207,1
Karluk,1972,0,,208,1
Karluk,1972,0,,209,1
Karluk,1972,0,,210,1
Karluk,1972,6,,211,7
Karluk,1972,0,,212,7
Karluk,1972,0,,213,7
Karluk,1972,0,,214,7
Karluk,1972,2,,215,9
Karluk,1972,4,,216,13
Karluk,1972,3,,217,16
Karluk,1972,10,,218,26
Karluk,1972,4,,219,30
Karluk,1972,11,,220,41
Karluk,1972,0,,221,41
Karluk,1972,5,,222,46
Karluk,1972,3,,223,49
Karluk,1972,5,,224,54
Karluk,1972,6,,225,60
Karluk,1972,7,,226,67
Karluk,1972,3,,227,70
Karluk,1972,0,,228,70
Karluk,1972,17,,229,87
Karluk,1972,7,,230,94
Karluk,1972,2,,231,96
Karluk,1972,7,,232,103
Karluk,1972,2,,233,105
Karluk,1972,4,,234,109
Karluk,1972,18,,235,127
Karluk,1972,34,,236,161
Karluk,1972,38,,237,199
Karluk,1972,21,,238,220
Karluk,1972,5,,239,225
Karluk,1972,20,,240,245
Karluk,1972,10,,241,255
Karluk,1972,12,,242,267
Karluk,1972,0,,243,267
Karluk,1972,4,,244,271
Karluk,1972,4,,245,275
Karluk,1972,0,,246,275
Karluk,1972,0,,247,275
Karluk,1972,0,,248,275
Karluk,1972,0,,249,275
Karluk,1972,0,,250,275
Karluk,1972,0,,251,275
Karluk,1972,14,,252,289
Karluk,1972,9,,253,298
Karluk,1972,4,,254,302
Karluk,1972,0,,255,302
Karluk,1972,3,,256,305
Karluk,1972,17,,257,322
Karluk,1972,0,,258,322
Karluk,1972,0,,259,322
Karluk,1972,0,,260,322
Karluk,1972,0,,261,322
Karluk,1972,0,,262,322
Karluk,1972,0,,263,322
Karluk,1972,0,,264,322
Karluk,1972,0,,265,322
Karluk,1972,2,,266,324
Karluk,1972,0,,267,324
Karluk,1972,0,,268,324
Karluk,1972,0,,269,324
Karluk,1972,0,,270,324
Karluk,1972,0,,271,324
Karluk,1972,0,,272,324
Karluk,1972,0,,273,324
Karluk,1972,0,,274,324
Karluk,1972,0,,275,324
Karluk,1972,0,,276,324
Karluk,1972,0,,277,324
Karluk,1972,0,,278,324
Karluk,1972,0,,279,324
Karluk,1972,0,,280,324
Karluk,1972,0,,281,324
Karluk,1972,0,,282,324
Karluk,1972,0,,283,324
Karluk,1972,0,,284,324
Karluk,1972,0,,285,324
Karluk,1972,0,,286,324
Karluk,1971,0,,154,0
Karluk,1971,0,,155,0
Karluk,1971,0,,156,0
Karluk,1971,0,,157,0
Karluk,1971,0,,158,0
Karluk,1971,0,,159,0
Karluk,1971,0,,160,0
Karluk,1971,0,,161,0
Karluk,1971,0,,162,0
Karluk,1971,0,,163,0
Karluk,1971,0,,164,0
Karluk,1971,0,,165,0
Karluk,1971,0,,166,0
Karluk,1971,0,,167,0
Karluk,1971,0,,168,0
Karluk,1971,0,,169,0
Karluk,1971,0,,170,0
Karluk,1971,0,,171,0
Karluk,1971,0,,172,0
Karluk,1971,0,,173,0
Karluk,1971,0,,174,0
Karluk,1971,0,,175,0
Karluk,1971,0,,176,0
Karluk,1971,0,,177,0
Karluk,1971,0,,178,0
Karluk,1971,0,,179,0
Karluk,1971,0,,180,0
Karluk,1971,0,,181,0
Karluk,1971,0,,182,0
Karluk,1971,0,,183,0
Karluk,1971,0,,184,0
Karluk,1971,0,,185,0
Karluk,1971,0,,186,0
Karluk,1971,0,,187,0
Karluk,1971,0,,188,0
Karluk,1971,0,,189,0
Karluk,1971,0,,190,0
Karluk,1971,0,,191,0
Karluk,1971,0,,192,0
Karluk,1971,0,,193,0
Karluk,1971,0,,194,0
Karluk,1971,0,,195,0
Karluk,1971,0,,196,0
Karluk,1971,0,,197,0
Karluk,1971,4,,198,4
Karluk,1971,9,,199,13
Karluk,1971,7,,200,20
Karluk,1971,8,,201,28
Karluk,1971,1,,202,29
Karluk,1971,2,,203,31
Karluk,1971,3,,204,34
Karluk,1971,1,,205,35
Karluk,1971,0,,206,35
Karluk,1971,0,,207,35
Karluk,1971,0,,208,35
Karluk,1971,0,,209,35
Karluk,1971,0,,210,35
Karluk,1971,0,,211,35
Karluk,1971,0,,212,35
Karluk,1971,0,,213,35
Karluk,1971,0,,214,35
Karluk,1971,0,,215,35
Karluk,1971,0,,216,35
Karluk,1971,0,,217,35
Karluk,1971,1,,218,36
Karluk,1971,0,,219,36
Karluk,1971,0,,220,36
Karluk,1971,0,,221,36
Karluk,1971,0,,222,36
Karluk,1971,0,,223,36
Karluk,1971,0,,224,36
Karluk,1971,1,,225,37
Karluk,1971,0,,226,37
Karluk,1971,6,,227,43
Karluk,1971,4,,228,47
Karluk,1971,4,,229,51
Karluk,1971,2,,230,53
Karluk,1971,4,,231,57
Karluk,1971,4,,232,61
Karluk,1971,0,,233,61
Karluk,1971,0,,234,61
Karluk,1971,0,,235,61
Karluk,1971,4,,236,65
Karluk,1971,1,,237,66
Karluk,1971,4,,238,70
Karluk,1971,1,,239,71
Karluk,1971,0,,240,71
Karluk,1971,2,,241,73
Karluk,1971,0,,242,73
Karluk,1971,2,,243,75
Karluk,1971,1,,244,76
Karluk,1971,3,,245,79
Karluk,1971,3,,246,82
Karluk,1971,1,,247,83
Karluk,1971,1,,248,84
Karluk,1971,1,,249,85
Karluk,1971,1,,250,86
Karluk,1971,0,,251,86
Karluk,1971,2,,252,88
Karluk,1971,0,,253,88
Karluk,1971,1,,254,89
Karluk,1971,0,,255,89
Karluk,1971,0,,256,89
Karluk,1971,1,,257,90
Karluk,1971,0,,258,90
Karluk,1971,0,,259,90
Karluk,1971,1,,260,91
Karluk,1971,0,,261,91
Karluk,1971,0,,262,91
Karluk,1971,0,,263,91
Karluk,1971,0,,264,91
Karluk,1971,0,,265,91
Karluk,1971,0,,266,91
Karluk,1971,0,,267,91
Karluk,1971,0,,268,91
Karluk,1971,0,,269,91
Karluk,1971,0,,270,91
Karluk,1971,0,,271,91
Karluk,1971,0,,272,91
Karluk,1971,0,,273,91
Karluk,1971,0,,274,91
Karluk,1971,0,,275,91
Karluk,1971,0,,276,91
Karluk,1971,0,,277,91
Karluk,1971,0,,278,91
Karluk,1971,0,,279,91
Karluk,1971,0,,280,91
Karluk,1971,0,,281,91
Karluk,1971,0,,282,91
Karluk,1971,0,,283,91
Karluk,1971,0,,284,91
Karluk,1971,0,,285,91
Karluk,1970,0,,154,0
Karluk,1970,0,,155,0
Karluk,1970,0,,156,0
Karluk,1970,0,,157,0
Karluk,1970,0,,158,0
Karluk,1970,0,,159,0
Karluk,1970,0,,160,0
Karluk,1970,0,,161,0
Karluk,1970,0,,162,0
Karluk,1970,0,,163,0
Karluk,1970,0,,164,0
Karluk,1970,0,,165,0
Karluk,1970,0,,166,0
Karluk,1970,0,,167,0
Karluk,1970,0,,168,0
Karluk,1970,0,,169,0
Karluk,1970,0,,170,0
Karluk,1970,0,,171,0
Karluk,1970,0,,172,0
Karluk,1970,0,,173,0
Karluk,1970,0,,174,0
Karluk,1970,0,,175,0
Karluk,1970,0,,176,0
Karluk,1970,0,,177,0
Karluk,1970,0,,178,0
Karluk,1970,0,,179,0
Karluk,1970,0,,180,0
Karluk,1970,0,,181,0
Karluk,1970,0,,182,0
Karluk,1970,0,,183,0
Karluk,1970,0,,184,0
Karluk,1970,0,,185,0
Karluk,1970,0,,186,0
Karluk,1970,0,,187,0
Karluk,1970,0,,188,0
Karluk,1970,0,,189,0
Karluk,1970,0,,190,0
Karluk,1970,0,,191,0
Karluk,1970,0,,192,0
Karluk,1970,0,,193,0
Karluk,1970,0,,194,0
Karluk,1970,0,,195,0
Karluk,1970,0,,196,0
Karluk,1970,0,,197,0
Karluk,1970,0,,198,0
Karluk,1970,0,,199,0
Karluk,1970,1,,200,1
Karluk,1970,0,,201,1
Karluk,1970,0,,202,1
Karluk,1970,0,,203,1
Karluk,1970,0,,204,1
Karluk,1970,1,,205,2
Karluk,1970,0,,206,2
Karluk,1970,0,,207,2
Karluk,1970,0,,208,2
Karluk,1970,1,,209,3
Karluk,1970,1,,210,4
Karluk,1970,1,,211,5
Karluk,1970,0,,212,5
Karluk,1970,0,,213,5
Karluk,1970,0,,214,5
Karluk,1970,0,,215,5
Karluk,1970,2,,216,7
Karluk,1970,0,,217,7
Karluk,1970,6,,218,13
Karluk,1970,3,,219,16
Karluk,1970,25,,220,41
Karluk,1970,24,,221,65
Karluk,1970,32,,222,97
Karluk,1970,36,,223,133
Karluk,1970,66,,224,199
Karluk,1970,154,,225,353
Karluk,1970,44,,226,397
Karluk,1970,101,,227,498
Karluk,1970,291,,228,789
Karluk,1970,501,,229,1290
Karluk,1970,510,,230,1800
Karluk,1970,669,,231,2469
Karluk,1970,572,,232,3041
Karluk,1970,238,,233,3279
Karluk,1970,127,,234,3406
Karluk,1970,290,,235,3696
Karluk,1970,67,,236,3763
Karluk,1970,151,,237,3914
Karluk,1970,26,,238,3940
Karluk,1970,17,,239,3957
Karluk,1970,212,,240,4169
Karluk,1970,271,,241,4440
Karluk,1970,212,,242,4652
Karluk,1970,271,,243,4923
Karluk,1970,221,,244,5144
Karluk,1970,102,,245,5246
Karluk,1970,37,,246,5283
Karluk,1970,57,,247,5340
Karluk,1970,35,,248,5375
Karluk,1970,15,,249,5390
Karluk,1970,11,,250,5401
Karluk,1970,9,,251,5410
Karluk,1970,0,,252,5410
Karluk,1970,0,,253,5410
Karluk,1970,2,,254,5412
Karluk,1970,9,,255,5421
Karluk,1970,0,,256,5421
Karluk,1970,3,,257,5424
Karluk,1970,2,,258,5426
Karluk,1970,2,,259,5428
Karluk,1970,0,,260,5428
Karluk,1970,0,,261,5428
Karluk,1970,0,,262,5428
Karluk,1970,0,,263,5428
Karluk,1970,0,,264,5428
Karluk,1970,0,,265,5428
Karluk,1970,0,,266,5428
Karluk,1970,0,,267,5428
Karluk,1970,0,,268,5428
Karluk,1970,0,,269,5428
Karluk,1970,0,,270,5428
Karluk,1970,0,,271,5428
Karluk,1970,0,,272,5428
Karluk,1970,0,,273,5428
Karluk,1970,0,,274,5428
Karluk,1970,0,,275,5428
Karluk,1970,0,,276,5428
Karluk,1970,0,,277,5428
Karluk,1970,0,,278,5428
Karluk,1970,0,,279,5428
Karluk,1970,0,,280,5428
Karluk,1970,0,,281,5428
Karluk,1970,0,,282,5428
Karluk,1970,0,,283,5428
Karluk,1970,0,,284,5428
Karluk,1970,0,,285,5428
Karluk,1969,0,,154,0
Karluk,1969,0,,155,0
Karluk,1969,0,,156,0
Karluk,1969,0,,157,0
Karluk,1969,0,,158,0
Karluk,1969,0,,159,0
Karluk,1969,0,,160,0
Karluk,1969,0,,161,0
Karluk,1969,0,,162,0
Karluk,1969,0,,163,0
Karluk,1969,0,,164,0
Karluk,1969,0,,165,0
Karluk,1969,0,,166,0
Karluk,1969,0,,167,0
Karluk,1969,0,,168,0
Karluk,1969,0,,169,0
Karluk,1969,0,,170,0
Karluk,1969,0,,171,0
Karluk,1969,0,,172,0
Karluk,1969,0,,173,0
Karluk,1969,0,,174,0
Karluk,1969,0,,175,0
Karluk,1969,0,,176,0
Karluk,1969,0,,177,0
Karluk,1969,0,,178,0
Karluk,1969,0,,179,0
Karluk,1969,0,,180,0
Karluk,1969,0,,181,0
Karluk,1969,0,,182,0
Karluk,1969,0,,183,0
Karluk,1969,0,,184,0
Karluk,1969,0,,185,0
Karluk,1969,0,,186,0
Karluk,1969,0,,187,0
Karluk,1969,0,,188,0
Karluk,1969,0,,189,0
Karluk,1969,0,,190,0
Karluk,1969,0,,191,0
Karluk,1969,0,,192,0
Karluk,1969,0,,193,0
Karluk,1969,0,,194,0
Karluk,1969,0,,195,0
Karluk,1969,0,,196,0
Karluk,1969,0,,197,0
Karluk,1969,0,,198,0
Karluk,1969,0,,199,0
Karluk,1969,0,,200,0
Karluk,1969,0,,201,0
Karluk,1969,0,,202,0
Karluk,1969,0,,203,0
Karluk,1969,0,,204,0
Karluk,1969,0,,205,0
Karluk,1969,0,,206,0
Karluk,1969,0,,207,0
Karluk,1969,0,,208,0
Karluk,1969,0,,209,0
Karluk,1969,0,,210,0
Karluk,1969,0,,211,0
Karluk,1969,0,,212,0
Karluk,1969,0,,213,0
Karluk,1969,0,,214,0
Karluk,1969,0,,215,0
Karluk,1969,0,,216,0
Karluk,1969,0,,217,0
Karluk,1969,0,,218,0
Karluk,1969,0,,219,0
Karluk,1969,0,,220,0
Karluk,1969,0,,221,0
Karluk,1969,0,,222,0
Karluk,1969,0,,223,0
Karluk,1969,0,,224,0
Karluk,1969,0,,225,0
Karluk,1969,0,,226,0
Karluk,1969,0,,227,0
Karluk,1969,1,,228,1
Karluk,1969,1,,229,2
Karluk,1969,4,,230,6
Karluk,1969,4,,231,10
Karluk,1969,3,,232,13
Karluk,1969,6,,233,19
Karluk,1969,0,,234,19
Karluk,1969,0,,235,19
Karluk,1969,0,,236,19
Karluk,1969,1,,237,20
Karluk,1969,17,,238,37
Karluk,1969,8,,239,45
Karluk,1969,3,,240,48
Karluk,1969,0,,241,48
Karluk,1969,-2,,242,46
Karluk,1969,0,,243,46
Karluk,1969,1,,244,47
Karluk,1969,-3,,245,44
Karluk,1969,0,,246,44
Karluk,1969,0,,247,44
Karluk,1969,3,,248,47
Karluk,1969,1,,249,48
Karluk,1969,3,,250,51
Karluk,1969,1,,251,52
Karluk,1969,1,,252,53
Karluk,1969,1,,253,54
Karluk,1969,2,,254,56
Karluk,1969,7,,255,63
Karluk,1969,3,,256,66
Karluk,1969,2,,257,68
Karluk,1969,0,,258,68
Karluk,1969,1,,259,69
Karluk,1969,1,,260,70
Karluk,1969,0,,261,70
Karluk,1969,0,,262,70
Karluk,1969,0,,263,70
Karluk,1969,0,,264,70
Karluk,1969,0,,265,70
Karluk,1969,0,,266,70
Karluk,1969,0,,267,70
Karluk,1969,0,,268,70
Karluk,1969,0,,269,70
Karluk,1969,0,,270,70
Karluk,1969,0,,271,70
Karluk,1969,0,,272,70
Karluk,1969,0,,273,70
Karluk,1969,0,,274,70
Karluk,1969,0,,275,70
Karluk,1969,0,,276,70
Karluk,1969,0,,277,70
Karluk,1969,0,,278,70
Karluk,1969,0,,279,70
Karluk,1969,0,,280,70
Karluk,1969,0,,281,70
Karluk,1969,0,,282,70
Karluk,1969,0,,283,70
Karluk,1969,0,,284,70
Karluk,1969,0,,285,70
Karluk,1968,0,,155,0
Karluk,1968,0,,156,0
Karluk,1968,0,,157,0
Karluk,1968,0,,158,0
Karluk,1968,0,,159,0
Karluk,1968,0,,160,0
Karluk,1968,0,,161,0
Karluk,1968,0,,162,0
Karluk,1968,0,,163,0
Karluk,1968,0,,164,0
Karluk,1968,0,,165,0
Karluk,1968,0,,166,0
Karluk,1968,0,,167,0
Karluk,1968,0,,168,0
Karluk,1968,0,,169,0
Karluk,1968,0,,170,0
Karluk,1968,0,,171,0
Karluk,1968,0,,172,0
Karluk,1968,0,,173,0
Karluk,1968,0,,174,0
Karluk,1968,0,,175,0
Karluk,1968,0,,176,0
Karluk,1968,0,,177,0
Karluk,1968,0,,178,0
Karluk,1968,0,,179,0
Karluk,1968,0,,180,0
Karluk,1968,0,,181,0
Karluk,1968,0,,182,0
Karluk,1968,0,,183,0
Karluk,1968,0,,184,0
Karluk,1968,0,,185,0
Karluk,1968,0,,186,0
Karluk,1968,0,,187,0
Karluk,1968,0,,188,0
Karluk,1968,0,,189,0
Karluk,1968,0,,190,0
Karluk,1968,0,,191,0
Karluk,1968,0,,192,0
Karluk,1968,0,,193,0
Karluk,1968,0,,194,0
Karluk,1968,0,,195,0
Karluk,1968,0,,196,0
Karluk,1968,0,,197,0
Karluk,1968,0,,198,0
Karluk,1968,0,,199,0
Karluk,1968,0,,200,0
Karluk,1968,0,,201,0
Karluk,1968,0,,202,0
Karluk,1968,0,,203,0
Karluk,1968,0,,204,0
Karluk,1968,0,,205,0
Karluk,1968,0,,206,0
Karluk,1968,0,,207,0
Karluk,1968,0,,208,0
Karluk,1968,2,,209,2
Karluk,1968,0,,210,2
Karluk,1968,0,,211,2
Karluk,1968,0,,212,2
Karluk,1968,0,,213,2
Karluk,1968,0,,214,2
Karluk,1968,0,,215,2
Karluk,1968,0,,216,2
Karluk,1968,0,,217,2
Karluk,1968,4,,218,6
Karluk,1968,48,,219,54
Karluk,1968,276,,220,330
Karluk,1968,608,,221,938
Karluk,1968,1301,,222,2239
Karluk,1968,3216,,223,5455
Karluk,1968,3628,,224,9083
Karluk,1968,1195,,225,10278
Karluk,1968,2317,,226,12595
Karluk,1968,1464,,227,14059
Karluk,1968,2148,,228,16207
Karluk,1968,1628,,229,17835
Karluk,1968,1293,,230,19128
Karluk,1968,451,,231,19579
Karluk,1968,608,,232,20187
Karluk,1968,220,,233,20407
Karluk,1968,216,,234,20623
Karluk,1968,142,,235,20765
Karluk,1968,77,,236,20842
Karluk,1968,43,,237,20885
Karluk,1968,13,,238,20898
Karluk,1968,3,,239,20901
Karluk,1968,18,,240,20919
Karluk,1968,46,,241,20965
Karluk,1968,48,,242,21013
Karluk,1968,15,,243,21028
Karluk,1968,27,,244,21055
Karluk,1968,37,,245,21092
Karluk,1968,22,,246,21114
Karluk,1968,10,,247,21124
Karluk,1968,17,,248,21141
Karluk,1968,10,,249,21151
Karluk,1968,35,,250,21186
Karluk,1968,32,,251,21218
Karluk,1968,9,,252,21227
Karluk,1968,2,,253,21229
Karluk,1968,6,,254,21235
Karluk,1968,4,,255,21239
Karluk,1968,0,,256,21239
Karluk,1968,1,,257,21240
Karluk,1968,0,,258,21240
Karluk,1968,0,,259,21240
Karluk,1968,0,,260,21240
Karluk,1968,0,,261,21240
Karluk,1968,0,,262,21240
Karluk,1968,0,,263,21240
Karluk,1968,0,,264,21240
Karluk,1968,0,,265,21240
Karluk,1968,0,,266,21240
Karluk,1968,0,,267,21240
Karluk,1968,0,,268,21240
Karluk,1968,0,,269,21240
Karluk,1968,0,,270,21240
Karluk,1968,0,,271,21240
Karluk,1968,0,,272,21240
Karluk,1968,0,,273,21240
Karluk,1968,0,,274,21240
Karluk,1968,0,,275,21240
Karluk,1968,0,,276,21240
Karluk,1968,0,,277,21240
Karluk,1968,0,,278,21240
Karluk,1968,0,,279,21240
Karluk,1968,0,,280,21240
Karluk,1968,0,,281,21240
Karluk,1968,0,,282,21240
Karluk,1968,0,,283,21240
Karluk,1968,0,,284,21240
Karluk,1968,0,,285,21240
Karluk,1968,0,,286,21240
Karluk,1967,0,,154,0
Karluk,1967,0,,155,0
Karluk,1967,0,,156,0
Karluk,1967,0,,157,0
Karluk,1967,0,,158,0
Karluk,1967,0,,159,0
Karluk,1967,0,,160,0
Karluk,1967,0,,161,0
Karluk,1967,0,,162,0
Karluk,1967,0,,163,0
Karluk,1967,0,,164,0
Karluk,1967,0,,165,0
Karluk,1967,0,,166,0
Karluk,1967,0,,167,0
Karluk,1967,0,,168,0
Karluk,1967,0,,169,0
Karluk,1967,0,,170,0
Karluk,1967,0,,171,0
Karluk,1967,0,,172,0
Karluk,1967,0,,173,0
Karluk,1967,0,,174,0
Karluk,1967,0,,175,0
Karluk,1967,0,,176,0
Karluk,1967,0,,177,0
Karluk,1967,0,,178,0
Karluk,1967,0,,179,0
Karluk,1967,0,,180,0
Karluk,1967,0,,181,0
Karluk,1967,0,,182,0
Karluk,1967,0,,183,0
Karluk,1967,0,,184,0
Karluk,1967,0,,185,0
Karluk,1967,0,,186,0
Karluk,1967,0,,187,0
Karluk,1967,0,,188,0
Karluk,1967,0,,189,0
Karluk,1967,0,,190,0
Karluk,1967,0,,191,0
Karluk,1967,0,,192,0
Karluk,1967,0,,193,0
Karluk,1967,0,,194,0
Karluk,1967,0,,195,0
Karluk,1967,0,,196,0
Karluk,1967,0,,197,0
Karluk,1967,0,,198,0
Karluk,1967,0,,199,0
Karluk,1967,0,,200,0
Karluk,1967,0,,201,0
Karluk,1967,0,,202,0
Karluk,1967,0,,203,0
Karluk,1967,0,,204,0
Karluk,1967,0,,205,0
Karluk,1967,0,,206,0
Karluk,1967,0,,207,0
Karluk,1967,0,,208,0
Karluk,1967,0,,209,0
Karluk,1967,0,,210,0
Karluk,1967,0,,211,0
Karluk,1967,0,,212,0
Karluk,1967,3,,213,3
Karluk,1967,0,,214,3
Karluk,1967,0,,215,3
Karluk,1967,0,,216,3
Karluk,1967,0,,217,3
Karluk,1967,0,,218,3
Karluk,1967,0,,219,3
Karluk,1967,0,,220,3
Karluk,1967,1,,221,4
Karluk,1967,2,,222,6
Karluk,1967,0,,223,6
Karluk,1967,1,,224,7
Karluk,1967,0,,225,7
Karluk,1967,1,,226,8
Karluk,1967,1,,227,9
Karluk,1967,4,,228,13
Karluk,1967,8,,229,21
Karluk,1967,3,,230,24
Karluk,1967,2,,231,26
Karluk,1967,0,,232,26
Karluk,1967,2,,233,28
Karluk,1967,-5,,234,23
Karluk,1967,0,,235,23
Karluk,1967,-4,,236,19
Karluk,1967,28,,237,47
Karluk,1967,16,,238,63
Karluk,1967,41,,239,104
Karluk,1967,1009,,240,1113
Karluk,1967,1368,,241,2481
Karluk,1967,2374,,242,4855
Karluk,1967,560,,243,5415
Karluk,1967,316,,244,5731
Karluk,1967,669,,245,6400
Karluk,1967,423,,246,6823
Karluk,1967,469,,247,7292
Karluk,1967,308,,248,7600
Karluk,1967,30,,249,7630
Karluk,1967,85,,250,7715
Karluk,1967,155,,251,7870
Karluk,1967,99,,252,7969
Karluk,1967,9,,253,7978
Karluk,1967,5,,254,7983
Karluk,1967,19,,255,8002
Karluk,1967,7,,256,8009
Karluk,1967,4,,257,8013
Karluk,1967,6,,258,8019
Karluk,1967,0,,259,8019
Karluk,1967,0,,260,8019
Karluk,1967,0,,261,8019
Karluk,1967,0,,262,8019
Karluk,1967,0,,263,8019
Karluk,1967,0,,264,8019
Karluk,1967,0,,265,8019
Karluk,1967,0,,266,8019
Karluk,1967,0,,267,8019
Karluk,1967,0,,268,8019
Karluk,1967,0,,269,8019
Karluk,1967,0,,270,8019
Karluk,1967,0,,271,8019
Karluk,1967,0,,272,8019
Karluk,1967,0,,273,8019
Karluk,1967,0,,274,8019
Karluk,1967,0,,275,8019
Karluk,1967,0,,276,8019
Karluk,1967,0,,277,8019
Karluk,1967,0,,278,8019
Karluk,1967,0,,279,8019
Karluk,1967,0,,280,8019
Karluk,1967,0,,281,8019
Karluk,1967,0,,282,8019
Karluk,1967,0,,283,8019
Karluk,1967,0,,284,8019
Karluk,1967,0,,285,8019
Karluk,1966,1,,154,1
Karluk,1966,0,,155,1
Karluk,1966,0,,156,1
Karluk,1966,0,,157,1
Karluk,1966,2,,158,3
Karluk,1966,9,,159,12
Karluk,1966,0,,160,12
Karluk,1966,0,,161,12
Karluk,1966,0,,162,12
Karluk,1966,0,,163,12
Karluk,1966,1,,164,13
Karluk,1966,1,,165,14
Karluk,1966,2,,166,16
Karluk,1966,0,,167,16
Karluk,1966,3,,168,19
Karluk,1966,1,,169,20
Karluk,1966,0,,170,20
Karluk,1966,0,,171,20
Karluk,1966,0,,172,20
Karluk,1966,1,,173,21
Karluk,1966,1,,174,22
Karluk,1966,0,,175,22
Karluk,1966,0,,176,22
Karluk,1966,0,,177,22
Karluk,1966,0,,178,22
Karluk,1966,4,,179,26
Karluk,1966,0,,180,26
Karluk,1966,2,,181,28
Karluk,1966,0,,182,28
Karluk,1966,0,,183,28
Karluk,1966,0,,184,28
Karluk,1966,2,,185,30
Karluk,1966,1,,186,31
Karluk,1966,0,,187,31
Karluk,1966,3,,188,34
Karluk,1966,1,,189,35
Karluk,1966,2,,190,37
Karluk,1966,4,,191,41
Karluk,1966,0,,192,41
Karluk,1966,7,,193,48
Karluk,1966,2,,194,50
Karluk,1966,2,,195,52
Karluk,1966,0,,196,52
Karluk,1966,0,,197,52
Karluk,1966,0,,198,52
Karluk,1966,3,,199,55
Karluk,1966,1,,200,56
Karluk,1966,0,,201,56
Karluk,1966,1,,202,57
Karluk,1966,0,,203,57
Karluk,1966,0,,204,57
Karluk,1966,0,,205,57
Karluk,1966,0,,206,57
Karluk,1966,0,,207,57
Karluk,1966,1,,208,58
Karluk,1966,3,,209,61
Karluk,1966,1,,210,62
Karluk,1966,3,,211,65
Karluk,1966,0,,212,65
Karluk,1966,1,,213,66
Karluk,1966,15,,214,81
Karluk,1966,37,,215,118
Karluk,1966,77,,216,195
Karluk,1966,76,,217,271
Karluk,1966,123,,218,394
Karluk,1966,602,,219,996
Karluk,1966,405,,220,1401
Karluk,1966,215,,221,1616
Karluk,1966,126,,222,1742
Karluk,1966,272,,223,2014
Karluk,1966,186,,224,2200
Karluk,1966,177,,225,2377
Karluk,1966,186,,226,2563
Karluk,1966,249,,227,2812
Karluk,1966,138,,228,2950
Karluk,1966,280,,229,3230
Karluk,1966,197,,230,3427
Karluk,1966,109,,231,3536
Karluk,1966,56,,232,3592
Karluk,1966,175,,233,3767
Karluk,1966,500,,234,4267
Karluk,1966,146,,235,4413
Karluk,1966,55,,236,4468
Karluk,1966,140,,237,4608
Karluk,1966,189,,238,4797
Karluk,1966,132,,239,4929
Karluk,1966,46,,240,4975
Karluk,1966,36,,241,5011
Karluk,1966,18,,242,5029
Karluk,1966,25,,243,5054
Karluk,1966,11,,244,5065
Karluk,1966,8,,245,5073
Karluk,1966,0,,246,5073
Karluk,1966,0,,247,5073
Karluk,1966,0,,248,5073
Karluk,1966,0,,249,5073
Karluk,1966,0,,250,5073
Karluk,1966,0,,251,5073
Karluk,1966,0,,252,5073
Karluk,1966,0,,253,5073
Karluk,1966,0,,254,5073
Karluk,1966,0,,255,5073
Karluk,1966,0,,256,5073
Karluk,1966,0,,257,5073
Karluk,1966,0,,258,5073
Karluk,1966,0,,259,5073
Karluk,1966,0,,260,5073
Karluk,1966,0,,261,5073
Karluk,1966,0,,262,5073
Karluk,1966,0,,263,5073
Karluk,1966,0,,264,5073
Karluk,1966,0,,265,5073
Karluk,1966,0,,266,5073
Karluk,1966,0,,267,5073
Karluk,1966,0,,268,5073
Karluk,1966,0,,269,5073
Karluk,1966,0,,270,5073
Karluk,1966,0,,271,5073
Karluk,1966,0,,272,5073
Karluk,1966,0,,273,5073
Karluk,1966,0,,274,5073
Karluk,1966,0,,275,5073
Karluk,1966,0,,276,5073
Karluk,1966,0,,277,5073
Karluk,1966,0,,278,5073
Karluk,1966,0,,279,5073
Karluk,1966,0,,280,5073
Karluk,1966,0,,281,5073
Karluk,1966,0,,282,5073
Karluk,1966,0,,283,5073
Karluk,1966,0,,284,5073
Karluk,1966,0,,285,5073
Karluk,1965,0,,154,0
Karluk,1965,0,,155,0
Karluk,1965,0,,156,0
Karluk,1965,0,,157,0
Karluk,1965,0,,158,0
Karluk,1965,0,,159,0
Karluk,1965,0,,160,0
Karluk,1965,0,,161,0
Karluk,1965,0,,162,0
Karluk,1965,0,,163,0
Karluk,1965,0,,164,0
Karluk,1965,0,,165,0
Karluk,1965,0,,166,0
Karluk,1965,0,,167,0
Karluk,1965,0,,168,0
Karluk,1965,0,,169,0
Karluk,1965,0,,170,0
Karluk,1965,0,,171,0
Karluk,1965,0,,172,0
Karluk,1965,0,,173,0
Karluk,1965,0,,174,0
Karluk,1965,0,,175,0
Karluk,1965,0,,176,0
Karluk,1965,0,,177,0
Karluk,1965,0,,178,0
Karluk,1965,0,,179,0
Karluk,1965,0,,180,0
Karluk,1965,0,,181,0
Karluk,1965,0,,182,0
Karluk,1965,0,,183,0
Karluk,1965,0,,184,0
Karluk,1965,0,,185,0
Karluk,1965,0,,186,0
Karluk,1965,0,,187,0
Karluk,1965,1,,188,1
Karluk,1965,0,,189,1
Karluk,1965,0,,190,1
Karluk,1965,0,,191,1
Karluk,1965,0,,192,1
Karluk,1965,0,,193,1
Karluk,1965,0,,194,1
Karluk,1965,0,,195,1
Karluk,1965,0,,196,1
Karluk,1965,0,,197,1
Karluk,1965,0,,198,1
Karluk,1965,0,,199,1
Karluk,1965,0,,200,1
Karluk,1965,0,,201,1
Karluk,1965,0,,202,1
Karluk,1965,0,,203,1
Karluk,1965,0,,204,1
Karluk,1965,0,,205,1
Karluk,1965,0,,206,1
Karluk,1965,0,,207,1
Karluk,1965,0,,208,1
Karluk,1965,0,,209,1
Karluk,1965,0,,210,1
Karluk,1965,0,,211,1
Karluk,1965,0,,212,1
Karluk,1965,0,,213,1
Karluk,1965,0,,214,1
Karluk,1965,0,,215,1
Karluk,1965,0,,216,1
Karluk,1965,0,,217,1
Karluk,1965,0,,218,1
Karluk,1965,0,,219,1
Karluk,1965,0,,220,1
Karluk,1965,0,,221,1
Karluk,1965,0,,222,1
Karluk,1965,0,,223,1
Karluk,1965,0,,224,1
Karluk,1965,0,,225,1
Karluk,1965,0,,226,1
Karluk,1965,0,,227,1
Karluk,1965,0,,228,1
Karluk,1965,0,,229,1
Karluk,1965,0,,230,1
Karluk,1965,0,,231,1
Karluk,1965,0,,232,1
Karluk,1965,1,,233,2
Karluk,1965,2,,234,4
Karluk,1965,0,,235,4
Karluk,1965,0,,236,4
Karluk,1965,0,,237,4
Karluk,1965,0,,238,4
Karluk,1965,0,,239,4
Karluk,1965,0,,240,4
Karluk,1965,0,,241,4
Karluk,1965,0,,242,4
Karluk,1965,0,,243,4
Karluk,1965,1,,244,5
Karluk,1965,1,,245,6
Karluk,1965,3,,246,9
Karluk,1965,0,,247,9
Karluk,1965,0,,248,9
Karluk,1965,2,,249,11
Karluk,1965,1,,250,12
Karluk,1965,0,,251,12
Karluk,1965,0,,252,12
Karluk,1965,0,,253,12
Karluk,1965,0,,254,12
Karluk,1965,0,,255,12
Karluk,1965,0,,256,12
Karluk,1965,0,,257,12
Karluk,1965,0,,258,12
Karluk,1965,0,,259,12
Karluk,1965,0,,260,12
Karluk,1965,0,,261,12
Karluk,1965,0,,262,12
Karluk,1965,0,,263,12
Karluk,1965,0,,264,12
Karluk,1965,0,,265,12
Karluk,1965,0,,266,12
Karluk,1965,0,,267,12
Karluk,1965,0,,268,12
Karluk,1965,0,,269,12
Karluk,1965,0,,270,12
Karluk,1965,0,,271,12
Karluk,1965,0,,272,12
Karluk,1965,0,,273,12
Karluk,1965,0,,274,12
Karluk,1965,0,,275,12
Karluk,1965,0,,276,12
Karluk,1965,0,,277,12
Karluk,1965,0,,278,12
Karluk,1965,0,,279,12
Karluk,1965,0,,280,12
Karluk,1965,0,,281,12
Karluk,1965,0,,282,12
Karluk,1965,0,,283,12
Karluk,1965,0,,284,12
Karluk,1965,0,,285,12
Karluk,1964,0,,155,0
Karluk,1964,0,,156,0
Karluk,1964,0,,157,0
Karluk,1964,0,,158,0
Karluk,1964,0,,159,0
Karluk,1964,0,,160,0
Karluk,1964,0,,161,0
Karluk,1964,0,,162,0
Karluk,1964,0,,163,0
Karluk,1964,0,,164,0
Karluk,1964,0,,165,0
Karluk,1964,0,,166,0
Karluk,1964,0,,167,0
Karluk,1964,0,,168,0
Karluk,1964,0,,169,0
Karluk,1964,0,,170,0
Karluk,1964,0,,171,0
Karluk,1964,0,,172,0
Karluk,1964,0,,173,0
Karluk,1964,0,,174,0
Karluk,1964,0,,175,0
Karluk,1964,0,,176,0
Karluk,1964,0,,177,0
Karluk,1964,0,,178,0
Karluk,1964,0,,179,0
Karluk,1964,0,,180,0
Karluk,1964,0,,181,0
Karluk,1964,0,,182,0
Karluk,1964,0,,183,0
Karluk,1964,0,,184,0
Karluk,1964,0,,185,0
Karluk,1964,0,,186,0
Karluk,1964,0,,187,0
Karluk,1964,0,,188,0
Karluk,1964,0,,189,0
Karluk,1964,0,,190,0
Karluk,1964,0,,191,0
Karluk,1964,0,,192,0
Karluk,1964,0,,193,0
Karluk,1964,0,,194,0
Karluk,1964,0,,195,0
Karluk,1964,0,,196,0
Karluk,1964,0,,197,0
Karluk,1964,0,,198,0
Karluk,1964,0,,199,0
Karluk,1964,0,,200,0
Karluk,1964,0,,201,0
Karluk,1964,0,,202,0
Karluk,1964,0,,203,0
Karluk,1964,0,,204,0
Karluk,1964,0,,205,0
Karluk,1964,0,,206,0
Karluk,1964,0,,207,0
Karluk,1964,0,,208,0
Karluk,1964,0,,209,0
Karluk,1964,0,,210,0
Karluk,1964,-1,,211,-1
Karluk,1964,0,,212,-1
Karluk,1964,0,,213,-1
Karluk,1964,0,,214,-1
Karluk,1964,12,,215,11
Karluk,1964,45,,216,56
Karluk,1964,49,,217,105
Karluk,1964,7,,218,112
Karluk,1964,179,,219,291
Karluk,1964,553,,220,844
Karluk,1964,552,,221,1396
Karluk,1964,973,,222,2369
Karluk,1964,1701,,223,4070
Karluk,1964,-16,,224,4054
Karluk,1964,-32,,225,4022
Karluk,1964,747,,226,4769
Karluk,1964,495,,227,5264
Karluk,1964,3036,,228,8300
Karluk,1964,736,,229,9036
Karluk,1964,4041,,230,13077
Karluk,1964,7787,,231,20864
Karluk,1964,4407,,232,25271
Karluk,1964,3003,,233,28274
Karluk,1964,5613,,234,33887
Karluk,1964,4218,,235,38105
Karluk,1964,10448,,236,48553
Karluk,1964,2763,,237,51316
Karluk,1964,3339,,238,54655
Karluk,1964,2657,,239,57312
Karluk,1964,679,,240,57991
Karluk,1964,251,,241,58242
Karluk,1964,659,,242,58901
Karluk,1964,440,,243,59341
Karluk,1964,179,,244,59520
Karluk,1964,171,,245,59691
Karluk,1964,255,,246,59946
Karluk,1964,80,,247,60026
Karluk,1964,56,,248,60082
Karluk,1964,5,,249,60087
Karluk,1964,23,,250,60110
Karluk,1964,0,,251,60110
Karluk,1964,7,,252,60117
Karluk,1964,5,,253,60122
Karluk,1964,2,,254,60124
Karluk,1964,10,,255,60134
Karluk,1964,7,,256,60141
Karluk,1964,7,,257,60148
Karluk,1964,5,,258,60153
Karluk,1964,4,,259,60157
Karluk,1964,0,,260,60157
Karluk,1964,4,,261,60161
Karluk,1964,0,,262,60161
Karluk,1964,0,,263,60161
Karluk,1964,-1,,264,60160
Karluk,1964,1,,265,60161
Karluk,1964,27,,266,60188
Karluk,1964,3,,267,60191
Karluk,1964,0,,268,60191
Karluk,1964,0,,269,60191
Karluk,1964,-1,,270,60190
Karluk,1964,0,,271,60190
Karluk,1964,0,,272,60190
Karluk,1964,0,,273,60190
Karluk,1964,0,,274,60190
Karluk,1964,0,,275,60190
Karluk,1964,0,,276,60190
Karluk,1964,0,,277,60190
Karluk,1964,0,,278,60190
Karluk,1964,0,,279,60190
Karluk,1964,0,,280,60190
Karluk,1964,0,,281,60190
Karluk,1964,0,,282,60190
Karluk,1964,0,,283,60190
Karluk,1964,0,,284,60190
Karluk,1964,0,,285,60190
Karluk,1964,0,,286,60190
Karluk,1963,0,,154,0
Karluk,1963,0,,155,0
Karluk,1963,0,,156,0
Karluk,1963,0,,157,0
Karluk,1963,0,,158,0
Karluk,1963,0,,159,0
Karluk,1963,0,,160,0
Karluk,1963,0,,161,0
Karluk,1963,0,,162,0
Karluk,1963,0,,163,0
Karluk,1963,0,,164,0
Karluk,1963,0,,165,0
Karluk,1963,0,,166,0
Karluk,1963,0,,167,0
Karluk,1963,0,,168,0
Karluk,1963,0,,169,0
Karluk,1963,0,,170,0
Karluk,1963,0,,171,0
Karluk,1963,0,,172,0
Karluk,1963,0,,173,0
Karluk,1963,0,,174,0
Karluk,1963,0,,175,0
Karluk,1963,0,,176,0
Karluk,1963,0,,177,0
Karluk,1963,0,,178,0
Karluk,1963,0,,179,0
Karluk,1963,0,,180,0
Karluk,1963,0,,181,0
Karluk,1963,0,,182,0
Karluk,1963,0,,183,0
Karluk,1963,0,,184,0
Karluk,1963,0,,185,0
Karluk,1963,0,,186,0
Karluk,1963,0,,187,0
Karluk,1963,0,,188,0
Karluk,1963,0,,189,0
Karluk,1963,0,,190,0
Karluk,1963,0,,191,0
Karluk,1963,1,,192,1
Karluk,1963,2,,193,3
Karluk,1963,2,,194,5
Karluk,1963,1,,195,6
Karluk,1963,5,,196,11
Karluk,1963,2,,197,13
Karluk,1963,1,,198,14
Karluk,1963,0,,199,14
Karluk,1963,0,,200,14
Karluk,1963,1,,201,15
Karluk,1963,9,,202,24
Karluk,1963,9,,203,33
Karluk,1963,10,,204,43
Karluk,1963,2,,205,45
Karluk,1963,6,,206,51
Karluk,1963,10,,207,61
Karluk,1963,18,,208,79
Karluk,1963,4,,209,83
Karluk,1963,14,,210,97
Karluk,1963,24,,211,121
Karluk,1963,11,,212,132
Karluk,1963,13,,213,145
Karluk,1963,8,,214,153
Karluk,1963,0,,215,153
Karluk,1963,14,,216,167
Karluk,1963,14,,217,181
Karluk,1963,9,,218,190
Karluk,1963,11,,219,201
Karluk,1963,20,,220,221
Karluk,1963,3,,221,224
Karluk,1963,27,,222,251
Karluk,1963,18,,223,269
Karluk,1963,3,,224,272
Karluk,1963,1,,225,273
Karluk,1963,0,,226,273
Karluk,1963,3,,227,276
Karluk,1963,5,,228,281
Karluk,1963,0,,229,281
Karluk,1963,2,,230,283
Karluk,1963,1,,231,284
Karluk,1963,2,,232,286
Karluk,1963,5,,233,291
Karluk,1963,0,,234,291
Karluk,1963,7,,235,298
Karluk,1963,13,,236,311
Karluk,1963,15,,237,326
Karluk,1963,2,,238,328
Karluk,1963,2,,239,330
Karluk,1963,1,,240,331
Karluk,1963,1,,241,332
Karluk,1963,5,,242,337
Karluk,1963,1,,243,338
Karluk,1963,0,,244,338
Karluk,1963,1,,245,339
Karluk,1963,0,,246,339
Karluk,1963,0,,247,339
Karluk,1963,0,,248,339
Karluk,1963,0,,249,339
Karluk,1963,0,,250,339
Karluk,1963,0,,251,339
Karluk,1963,0,,252,339
Karluk,1963,0,,253,339
Karluk,1963,0,,254,339
Karluk,1963,0,,255,339
Karluk,1963,0,,256,339
Karluk,1963,0,,257,339
Karluk,1963,0,,258,339
Karluk,1963,0,,259,339
Karluk,1963,0,,260,339
Karluk,1963,0,,261,339
Karluk,1963,0,,262,339
Karluk,1963,0,,263,339
Karluk,1963,0,,264,339
Karluk,1963,0,,265,339
Karluk,1963,0,,266,339
Karluk,1963,0,,267,339
Karluk,1963,0,,268,339
Karluk,1963,0,,269,339
Karluk,1963,0,,270,339
Karluk,1963,0,,271,339
Karluk,1963,0,,272,339
Karluk,1963,0,,273,339
Karluk,1963,0,,274,339
Karluk,1963,0,,275,339
Karluk,1963,0,,276,339
Karluk,1963,0,,277,339
Karluk,1963,0,,278,339
Karluk,1963,0,,279,339
Karluk,1963,0,,280,339
Karluk,1963,0,,281,339
Karluk,1963,0,,282,339
Karluk,1963,0,,283,339
Karluk,1963,0,,284,339
Karluk,1963,0,,285,339
Karluk,1962,0,,154,0
Karluk,1962,0,,155,0
Karluk,1962,0,,156,0
Karluk,1962,0,,157,0
Karluk,1962,0,,158,0
Karluk,1962,0,,159,0
Karluk,1962,0,,160,0
Karluk,1962,0,,161,0
Karluk,1962,0,,162,0
Karluk,1962,0,,163,0
Karluk,1962,0,,164,0
Karluk,1962,0,,165,0
Karluk,1962,0,,166,0
Karluk,1962,0,,167,0
Karluk,1962,0,,168,0
Karluk,1962,0,,169,0
Karluk,1962,0,,170,0
Karluk,1962,0,,171,0
Karluk,1962,0,,172,0
Karluk,1962,0,,173,0
Karluk,1962,0,,174,0
Karluk,1962,0,,175,0
Karluk,1962,0,,176,0
Karluk,1962,0,,177,0
Karluk,1962,0,,178,0
Karluk,1962,0,,179,0
Karluk,1962,0,,180,0
Karluk,1962,0,,181,0
Karluk,1962,0,,182,0
Karluk,1962,0,,183,0
Karluk,1962,0,,184,0
Karluk,1962,0,,185,0
Karluk,1962,0,,186,0
Karluk,1962,0,,187,0
Karluk,1962,0,,188,0
Karluk,1962,1,,189,1
Karluk,1962,0,,190,1
Karluk,1962,0,,191,1
Karluk,1962,1,,192,2
Karluk,1962,3,,193,5
Karluk,1962,1,,194,6
Karluk,1962,1,,195,7
Karluk,1962,0,,196,7
Karluk,1962,0,,197,7
Karluk,1962,0,,198,7
Karluk,1962,0,,199,7
Karluk,1962,0,,200,7
Karluk,1962,0,,201,7
Karluk,1962,0,,202,7
Karluk,1962,7,,203,14
Karluk,1962,5,,204,19
Karluk,1962,8,,205,27
Karluk,1962,27,,206,54
Karluk,1962,11,,207,65
Karluk,1962,15,,208,80
Karluk,1962,31,,209,111
Karluk,1962,33,,210,144
Karluk,1962,137,,211,281
Karluk,1962,114,,212,395
Karluk,1962,117,,213,512
Karluk,1962,103,,214,615
Karluk,1962,123,,215,738
Karluk,1962,77,,216,815
Karluk,1962,51,,217,866
Karluk,1962,427,,218,1293
Karluk,1962,1801,,219,3094
Karluk,1962,2313,,220,5407
Karluk,1962,277,,221,5684
Karluk,1962,162,,222,5846
Karluk,1962,104,,223,5950
Karluk,1962,317,,224,6267
Karluk,1962,2123,,225,8390
Karluk,1962,5332,,226,13722
Karluk,1962,3330,,227,17052
Karluk,1962,8654,,228,25706
Karluk,1962,4196,,229,29902
Karluk,1962,1908,,230,31810
Karluk,1962,1874,,231,33684
Karluk,1962,1075,,232,34759
Karluk,1962,408,,233,35167
Karluk,1962,189,,234,35356
Karluk,1962,1429,,235,36785
Karluk,1962,262,,236,37047
Karluk,1962,221,,237,37268
Karluk,1962,1269,,238,38537
Karluk,1962,96,,239,38633
Karluk,1962,116,,240,38749
Karluk,1962,131,,241,38880
Karluk,1962,82,,242,38962
Karluk,1962,62,,243,39024
Karluk,1962,101,,244,39125
Karluk,1962,24,,245,39149
Karluk,1962,12,,246,39161
Karluk,1962,12,,247,39173
Karluk,1962,19,,248,39192
Karluk,1962,0,,249,39192
Karluk,1962,0,,250,39192
Karluk,1962,0,,251,39192
Karluk,1962,5,,252,39197
Karluk,1962,0,,253,39197
Karluk,1962,2,,254,39199
Karluk,1962,10,,255,39209
Karluk,1962,0,,256,39209
Karluk,1962,4,,257,39213
Karluk,1962,2,,258,39215
Karluk,1962,0,,259,39215
Karluk,1962,2,,260,39217
Karluk,1962,0,,261,39217
Karluk,1962,0,,262,39217
Karluk,1962,0,,263,39217
Karluk,1962,0,,264,39217
Karluk,1962,0,,265,39217
Karluk,1962,0,,266,39217
Karluk,1962,0,,267,39217
Karluk,1962,0,,268,39217
Karluk,1962,0,,269,39217
Karluk,1962,0,,270,39217
Karluk,1962,0,,271,39217
Karluk,1962,0,,272,39217
Karluk,1962,0,,273,39217
Karluk,1962,0,,274,39217
Karluk,1962,0,,275,39217
Karluk,1962,0,,276,39217
Karluk,1962,0,,277,39217
Karluk,1962,0,,278,39217
Karluk,1962,0,,279,39217
Karluk,1962,0,,280,39217
Karluk,1962,0,,281,39217
Karluk,1962,0,,282,39217
Karluk,1962,0,,283,39217
Karluk,1962,0,,284,39217
Karluk,1962,0,,285,39217
Karluk,1960,0,,155,0
Karluk,1960,0,,156,0
Karluk,1960,0,,157,0
Karluk,1960,0,,158,0
Karluk,1960,0,,159,0
Karluk,1960,0,,160,0
Karluk,1960,0,,161,0
Karluk,1960,0,,162,0
Karluk,1960,0,,163,0
Karluk,1960,0,,164,0
Karluk,1960,0,,165,0
Karluk,1960,0,,166,0
Karluk,1960,0,,167,0
Karluk,1960,0,,168,0
Karluk,1960,0,,169,0
Karluk,1960,0,,170,0
Karluk,1960,0,,171,0
Karluk,1960,0,,172,0
Karluk,1960,0,,173,0
Karluk,1960,0,,174,0
Karluk,1960,0,,175,0
Karluk,1960,0,,176,0
Karluk,1960,0,,177,0
Karluk,1960,0,,178,0
Karluk,1960,0,,179,0
Karluk,1960,0,,180,0
Karluk,1960,0,,181,0
Karluk,1960,0,,182,0
Karluk,1960,0,,183,0
Karluk,1960,0,,184,0
Karluk,1960,0,,185,0
Karluk,1960,0,,186,0
Karluk,1960,0,,187,0
Karluk,1960,0,,188,0
Karluk,1960,0,,189,0
Karluk,1960,0,,190,0
Karluk,1960,0,,191,0
Karluk,1960,0,,192,0
Karluk,1960,0,,193,0
Karluk,1960,0,,194,0
Karluk,1960,1,,195,1
Karluk,1960,0,,196,1
Karluk,1960,0,,197,1
Karluk,1960,1,,198,2
Karluk,1960,0,,199,2
Karluk,1960,0,,200,2
Karluk,1960,0,,201,2
Karluk,1960,0,,202,2
Karluk,1960,0,,203,2
Karluk,1960,0,,204,2
Karluk,1960,0,,205,2
Karluk,1960,0,,206,2
Karluk,1960,0,,207,2
Karluk,1960,0,,208,2
Karluk,1960,1,,209,3
Karluk,1960,1,,210,4
Karluk,1960,1,,211,5
Karluk,1960,0,,212,5
Karluk,1960,1,,213,6
Karluk,1960,1,,214,7
Karluk,1960,0,,215,7
Karluk,1960,0,,216,7
Karluk,1960,1,,217,8
Karluk,1960,19,,218,27
Karluk,1960,28,,219,55
Karluk,1960,86,,220,141
Karluk,1960,5,,221,146
Karluk,1960,39,,222,185
Karluk,1960,11,,223,196
Karluk,1960,77,,224,273
Karluk,1960,107,,225,380
Karluk,1960,137,,226,517
Karluk,1960,99,,227,616
Karluk,1960,227,,228,843
Karluk,1960,1036,,229,1879
Karluk,1960,540,,230,2419
Karluk,1960,842,,231,3261
Karluk,1960,441,,232,3702
Karluk,1960,322,,233,4024
Karluk,1960,624,,234,4648
Karluk,1960,657,,235,5305
Karluk,1960,151,,236,5456
Karluk,1960,183,,237,5639
Karluk,1960,143,,238,5782
Karluk,1960,115,,239,5897
Karluk,1960,31,,240,5928
Karluk,1960,0,,241,5928
Karluk,1960,0,,242,5928
Karluk,1960,0,,243,5928
Karluk,1960,0,,244,5928
Karluk,1960,0,,245,5928
Karluk,1960,0,,246,5928
Karluk,1960,0,,247,5928
Karluk,1960,0,,248,5928
Karluk,1960,0,,249,5928
Karluk,1960,0,,250,5928
Karluk,1960,0,,251,5928
Karluk,1960,0,,252,5928
Karluk,1960,0,,253,5928
Karluk,1960,0,,254,5928
Karluk,1960,0,,255,5928
Karluk,1960,0,,256,5928
Karluk,1960,0,,257,5928
Karluk,1960,0,,258,5928
Karluk,1960,0,,259,5928
Karluk,1960,0,,260,5928
Karluk,1960,0,,261,5928
Karluk,1960,0,,262,5928
Karluk,1960,0,,263,5928
Karluk,1960,0,,264,5928
Karluk,1960,0,,265,5928
Karluk,1960,0,,266,5928
Karluk,1960,0,,267,5928
Karluk,1960,0,,268,5928
Karluk,1960,0,,269,5928
Karluk,1960,0,,270,5928
Karluk,1960,0,,271,5928
Karluk,1960,0,,272,5928
Karluk,1960,0,,273,5928
Karluk,1960,0,,274,5928
Karluk,1960,0,,275,5928
Karluk,1960,0,,276,5928
Karluk,1960,0,,277,5928
Karluk,1960,0,,278,5928
Karluk,1960,0,,279,5928
Karluk,1960,0,,280,5928
Karluk,1960,0,,281,5928
Karluk,1960,0,,282,5928
Karluk,1960,0,,283,5928
Karluk,1960,0,,284,5928
Karluk,1960,0,,285,5928
Karluk,1960,0,,286,5928
Karluk,1958,0,,285,0
Karluk,1958,0,,286,0
Karluk,1958,0,,287,0
Karluk,1958,0,,288,0
Karluk,1958,0,,289,0
Karluk,1958,0,,290,0
Karluk,1958,0,,291,0
Karluk,1958,0,,292,0
Karluk,1958,0,,293,0
Karluk,1958,0,,294,0
Karluk,1958,0,,295,0
Karluk,1958,0,,296,0
Karluk,1958,0,,297,0
Karluk,1958,0,,298,0
Karluk,1958,0,,299,0
Karluk,1958,0,,300,0
Karluk,1958,0,,301,0
Karluk,1958,0,,302,0
Karluk,1958,0,,303,0
Karluk,1958,0,,304,0
Karluk,1958,0,,305,0
Karluk,1958,0,,306,0
Karluk,1958,0,,307,0
Karluk,1958,0,,308,0
Karluk,1958,0,,309,0
Karluk,1958,0,,310,0
Karluk,1958,0,,311,0
Karluk,1958,0,,312,0
Karluk,1958,0,,313,0
Karluk,1958,0,,314,0
Karluk,1958,0,,315,0
Karluk,1958,0,,316,0
Karluk,1958,0,,317,0
Karluk,1958,0,,318,0
Karluk,1958,0,,319,0
Karluk,1958,0,,320,0
Karluk,1958,0,,321,0
Karluk,1958,0,,322,0
Karluk,1958,0,,323,0
Karluk,1958,0,,324,0
Karluk,1958,0,,325,0
Karluk,1958,0,,326,0
Karluk,1958,0,,327,0
Karluk,1958,0,,328,0
Karluk,1958,0,,329,0
Karluk,1958,0,,330,0
Karluk,1958,0,,331,0
Karluk,1958,0,,332,0
Karluk,1958,0,,333,0
Karluk,1958,0,,334,0
Karluk,1958,0,,335,0
Karluk,1958,0,,336,0
Karluk,1958,0,,337,0
Karluk,1958,0,,338,0
Karluk,1958,0,,339,0
Karluk,1958,0,,340,0
Karluk,1958,30,,341,30
Karluk,1958,48,,342,78
Karluk,1958,120,,343,198
Karluk,1958,60,,344,258
Karluk,1958,78,,345,336
Karluk,1958,18,,346,354
Karluk,1958,36,,347,390
Karluk,1958,36,,348,426
Karluk,1958,120,,349,546
Karluk,1958,6,,350,552
Karluk,1958,576,,351,1128
Karluk,1958,630,,352,1758
Karluk,1958,552,,353,2310
Karluk,1958,528,,354,2838
Karluk,1958,384,,355,3222
Karluk,1958,168,,356,3390
Karluk,1958,516,,357,3906
Karluk,1958,0,,358,3906
Karluk,1958,264,,359,4170
Karluk,1958,48,,360,4218
Karluk,1958,192,,361,4410
Karluk,1958,66,,362,4476
Karluk,1958,84,,363,4560
Karluk,1958,156,,364,4716
Karluk,1958,102,,365,4818
Karluk,1958,42,,1,4860
Karluk,1958,18,,2,4878
Karluk,1958,6,,3,4884
Karluk,1958,18,,4,4902
Karluk,1958,6,,5,4908
Karluk,1958,42,,6,4950
Karluk,1958,12,,7,4962
Karluk,1958,42,,8,5004
Karluk,1958,24,,9,5028
Karluk,1958,12,,10,5040
Karluk,1958,0,,11,5040
Karluk,1958,12,,12,5052
Karluk,1958,0,,13,5052
Karluk,1958,0,,14,5052
Karluk,1958,0,,15,5052
Karluk,1958,6,,16,5058
Karluk,1958,0,,17,5058
Karluk,1958,0,,18,5058
Karluk,1958,0,,19,5058
Karluk,1958,0,,20,5058
Karluk,1958,42,,21,5100
Karluk,1958,0,,22,5100
Karluk,1958,0,,23,5100
Karluk,1958,0,,24,5100
Karluk,1958,0,,25,5100
Karluk,1958,0,,26,5100
Karluk,1958,0,,27,5100
Karluk,1958,0,,28,5100
Karluk,1958,0,,29,5100
Karluk,1958,0,,30,5100
Karluk,1958,0,,31,5100
Karluk,1958,0,,32,5100
Karluk,1958,0,,33,5100
Karluk,1958,0,,34,5100
Karluk,1958,0,,35,5100
Karluk,1958,0,,36,5100
Karluk,1958,0,,37,5100
Karluk,1958,0,,38,5100
Karluk,1958,0,,39,5100
Karluk,1958,0,,40,5100
Karluk,1958,0,,41,5100
Karluk,1958,0,,42,5100
Karluk,1958,0,,43,5100
Karluk,1958,0,,44,5100
Karluk,1958,0,,45,5100
Karluk,1958,0,,46,5100
Karluk,1958,0,,47,5100
Karluk,1958,0,,48,5100
Karluk,1958,0,,49,5100
Karluk,1958,0,,50,5100
Karluk,1958,0,,51,5100
Karluk,1948,0,,155,0
Karluk,1948,0,,156,0
Karluk,1948,0,,157,0
Karluk,1948,0,,158,0
Karluk,1948,0,,159,0
Karluk,1948,0,,160,0
Karluk,1948,0,,161,0
Karluk,1948,0,,162,0
Karluk,1948,0,,163,0
Karluk,1948,0,,164,0
Karluk,1948,0,,165,0
Karluk,1948,0,,166,0
Karluk,1948,0,,167,0
Karluk,1948,0,,168,0
Karluk,1948,0,,169,0
Karluk,1948,0,,170,0
Karluk,1948,0,,171,0
Karluk,1948,0,,172,0
Karluk,1948,0,,173,0
Karluk,1948,0,,174,0
Karluk,1948,0,,175,0
Karluk,1948,0,,176,0
Karluk,1948,0,,177,0
Karluk,1948,0,,178,0
Karluk,1948,0,,179,0
Karluk,1948,0,,180,0
Karluk,1948,0,,181,0
Karluk,1948,0,,182,0
Karluk,1948,0,,183,0
Karluk,1948,0,,184,0
Karluk,1948,0,,185,0
Karluk,1948,0,,186,0
Karluk,1948,0,,187,0
Karluk,1948,0,,188,0
Karluk,1948,0,,189,0
Karluk,1948,0,,190,0
Karluk,1948,0,,191,0
Karluk,1948,0,,192,0
Karluk,1948,0,,193,0
Karluk,1948,0,,194,0
Karluk,1948,0,,195,0
Karluk,1948,0,,196,0
Karluk,1948,0,,197,0
Karluk,1948,0,,198,0
Karluk,1948,0,,199,0
Karluk,1948,17,,200,17
Karluk,1948,21,,201,38
Karluk,1948,17,,202,55
Karluk,1948,2,,203,57
Karluk,1948,14,,204,71
Karluk,1948,11,,205,82
Karluk,1948,5,,206,87
Karluk,1948,3,,207,90
Karluk,1948,19,,208,109
Karluk,1948,16,,209,125
Karluk,1948,19,,210,144
Karluk,1948,7,,211,151
Karluk,1948,37,,212,188
Karluk,1948,42,,213,230
Karluk,1948,65,,214,295
Karluk,1948,193,,215,488
Karluk,1948,705,,216,1193
Karluk,1948,2409,,217,3602
Karluk,1948,2121,,218,5723
Karluk,1948,846,,219,6569
Karluk,1948,1471,,220,8040
Karluk,1948,1066,,221,9106
Karluk,1948,811,,222,9917
Karluk,1948,406,,223,10323
Karluk,1948,739,,224,11062
Karluk,1948,1075,,225,12137
Karluk,1948,1693,,226,13830
Karluk,1948,9174,,227,23004
Karluk,1948,5508,,228,28512
Karluk,1948,2850,,229,31362
Karluk,1948,1896,,230,33258
Karluk,1948,199,,231,33457
Karluk,1948,382,,232,33839
Karluk,1948,206,,233,34045
Karluk,1948,344,,234,34389
Karluk,1948,1224,,235,35613
Karluk,1948,471,,236,36084
Karluk,1948,646,,237,36730
Karluk,1948,278,,238,37008
Karluk,1948,368,,239,37376
Karluk,1948,65,,240,37441
Karluk,1948,18,,241,37459
Karluk,1948,11,,242,37470
Karluk,1948,6,,243,37476
Karluk,1948,10,,244,37486
Karluk,1948,6,,245,37492
Karluk,1948,4,,246,37496
Karluk,1948,3,,247,37499
Karluk,1948,7,,248,37506
Karluk,1948,13,,249,37519
Karluk,1948,13,,250,37532
Karluk,1948,5,,251,37537
Karluk,1948,6,,252,37543
Karluk,1948,4,,253,37547
Karluk,1948,0,,254,37547
Karluk,1948,2,,255,37549
Karluk,1948,0,,256,37549
Karluk,1948,1,,257,37550
Karluk,1948,0,,258,37550
Karluk,1948,0,,259,37550
Karluk,1948,0,,260,37550
Karluk,1948,0,,261,37550
Karluk,1948,1,,262,37551
Karluk,1948,0,,263,37551
Karluk,1948,0,,264,37551
Karluk,1948,0,,265,37551
Karluk,1948,0,,266,37551
Karluk,1948,1,,267,37552
Karluk,1948,1,,268,37553
Karluk,1948,1,,269,37554
Karluk,1948,0,,270,37554
Karluk,1948,0,,271,37554
Karluk,1948,1,,272,37555
Karluk,1948,0,,273,37555
Karluk,1948,2,,274,37557
Karluk,1948,0,,275,37557
Karluk,1948,0,,276,37557
Karluk,1948,0,,277,37557
Karluk,1948,0,,278,37557
Karluk,1948,0,,279,37557
Karluk,1948,0,,280,37557
Karluk,1948,0,,281,37557
Karluk,1948,0,,282,37557
Karluk,1948,0,,283,37557
Karluk,1948,0,,284,37557
Karluk,1948,0,,285,37557
Karluk,1948,0,,286,37557
Karluk,1947,0,,154,0
Karluk,1947,0,,155,0
Karluk,1947,0,,156,0
Karluk,1947,0,,157,0
Karluk,1947,0,,158,0
Karluk,1947,0,,159,0
Karluk,1947,0,,160,0
Karluk,1947,0,,161,0
Karluk,1947,0,,162,0
Karluk,1947,0,,163,0
Karluk,1947,0,,164,0
Karluk,1947,0,,165,0
Karluk,1947,0,,166,0
Karluk,1947,0,,167,0
Karluk,1947,0,,168,0
Karluk,1947,0,,169,0
Karluk,1947,0,,170,0
Karluk,1947,0,,171,0
Karluk,1947,0,,172,0
Karluk,1947,0,,173,0
Karluk,1947,0,,174,0
Karluk,1947,0,,175,0
Karluk,1947,0,,176,0
Karluk,1947,0,,177,0
Karluk,1947,0,,178,0
Karluk,1947,0,,179,0
Karluk,1947,0,,180,0
Karluk,1947,0,,181,0
Karluk,1947,0,,182,0
Karluk,1947,0,,183,0
Karluk,1947,0,,184,0
Karluk,1947,0,,185,0
Karluk,1947,0,,186,0
Karluk,1947,0,,187,0
Karluk,1947,0,,188,0
Karluk,1947,0,,189,0
Karluk,1947,0,,190,0
Karluk,1947,0,,191,0
Karluk,1947,0,,192,0
Karluk,1947,0,,193,0
Karluk,1947,1,,194,1
Karluk,1947,0,,195,1
Karluk,1947,0,,196,1
Karluk,1947,1,,197,2
Karluk,1947,0,,198,2
Karluk,1947,0,,199,2
Karluk,1947,0,,200,2
Karluk,1947,0,,201,2
Karluk,1947,0,,202,2
Karluk,1947,5,,203,7
Karluk,1947,2,,204,9
Karluk,1947,1,,205,10
Karluk,1947,0,,206,10
Karluk,1947,0,,207,10
Karluk,1947,0,,208,10
Karluk,1947,0,,209,10
Karluk,1947,0,,210,10
Karluk,1947,0,,211,10
Karluk,1947,0,,212,10
Karluk,1947,4,,213,14
Karluk,1947,1,,214,15
Karluk,1947,0,,215,15
Karluk,1947,1,,216,16
Karluk,1947,1,,217,17
Karluk,1947,0,,218,17
Karluk,1947,2,,219,19
Karluk,1947,7,,220,26
Karluk,1947,0,,221,26
Karluk,1947,0,,222,26
Karluk,1947,1,,223,27
Karluk,1947,0,,224,27
Karluk,1947,0,,225,27
Karluk,1947,0,,226,27
Karluk,1947,0,,227,27
Karluk,1947,0,,228,27
Karluk,1947,0,,229,27
Karluk,1947,0,,230,27
Karluk,1947,0,,231,27
Karluk,1947,0,,232,27
Karluk,1947,0,,233,27
Karluk,1947,0,,234,27
Karluk,1947,0,,235,27
Karluk,1947,0,,236,27
Karluk,1947,0,,237,27
Karluk,1947,0,,238,27
Karluk,1947,0,,239,27
Karluk,1947,0,,240,27
Karluk,1947,0,,241,27
Karluk,1947,0,,242,27
Karluk,1947,0,,243,27
Karluk,1947,1,,244,28
Karluk,1947,0,,245,28
Karluk,1947,0,,246,28
Karluk,1947,0,,247,28
Karluk,1947,1,,248,29
Karluk,1947,0,,249,29
Karluk,1947,0,,250,29
Karluk,1947,0,,251,29
Karluk,1947,0,,252,29
Karluk,1947,0,,253,29
Karluk,1947,0,,254,29
Karluk,1947,1,,255,30
Karluk,1947,3,,256,33
Karluk,1947,0,,257,33
Karluk,1947,0,,258,33
Karluk,1947,0,,259,33
Karluk,1947,0,,260,33
Karluk,1947,0,,261,33
Karluk,1947,3,,262,36
Karluk,1947,0,,263,36
Karluk,1947,0,,264,36
Karluk,1947,0,,265,36
Karluk,1947,0,,266,36
Karluk,1947,1,,267,37
Karluk,1947,0,,268,37
Karluk,1947,0,,269,37
Karluk,1947,0,,270,37
Karluk,1947,0,,271,37
Karluk,1947,0,,272,37
Karluk,1947,0,,273,37
Karluk,1947,0,,274,37
Karluk,1947,0,,275,37
Karluk,1947,0,,276,37
Karluk,1947,0,,277,37
Karluk,1947,0,,278,37
Karluk,1947,0,,279,37
Karluk,1947,0,,280,37
Karluk,1947,0,,281,37
Karluk,1947,0,,282,37
Karluk,1947,0,,283,37
Karluk,1947,0,,284,37
Karluk,1947,0,,285,37
Karluk,1946,0,,154,0
Karluk,1946,0,,155,0
Karluk,1946,0,,156,0
Karluk,1946,0,,157,0
Karluk,1946,0,,158,0
Karluk,1946,0,,159,0
Karluk,1946,0,,160,0
Karluk,1946,0,,161,0
Karluk,1946,0,,162,0
Karluk,1946,0,,163,0
Karluk,1946,0,,164,0
Karluk,1946,0,,165,0
Karluk,1946,0,,166,0
Karluk,1946,0,,167,0
Karluk,1946,0,,168,0
Karluk,1946,0,,169,0
Karluk,1946,0,,170,0
Karluk,1946,0,,171,0
Karluk,1946,0,,172,0
Karluk,1946,0,,173,0
Karluk,1946,0,,174,0
Karluk,1946,0,,175,0
Karluk,1946,0,,176,0
Karluk,1946,0,,177,0
Karluk,1946,0,,178,0
Karluk,1946,0,,179,0
Karluk,1946,0,,180,0
Karluk,1946,0,,181,0
Karluk,1946,0,,182,0
Karluk,1946,0,,183,0
Karluk,1946,0,,184,0
Karluk,1946,0,,185,0
Karluk,1946,0,,186,0
Karluk,1946,0,,187,0
Karluk,1946,0,,188,0
Karluk,1946,0,,189,0
Karluk,1946,0,,190,0
Karluk,1946,0,,191,0
Karluk,1946,0,,192,0
Karluk,1946,0,,193,0
Karluk,1946,0,,194,0
Karluk,1946,0,,195,0
Karluk,1946,0,,196,0
Karluk,1946,0,,197,0
Karluk,1946,0,,198,0
Karluk,1946,0,,199,0
Karluk,1946,0,,200,0
Karluk,1946,0,,201,0
Karluk,1946,0,,202,0
Karluk,1946,0,,203,0
Karluk,1946,0,,204,0
Karluk,1946,0,,205,0
Karluk,1946,0,,206,0
Karluk,1946,0,,207,0
Karluk,1946,0,,208,0
Karluk,1946,0,,209,0
Karluk,1946,0,,210,0
Karluk,1946,1,,211,1
Karluk,1946,2,,212,3
Karluk,1946,0,,213,3
Karluk,1946,0,,214,3
Karluk,1946,1,,215,4
Karluk,1946,0,,216,4
Karluk,1946,2,,217,6
Karluk,1946,8,,218,14
Karluk,1946,23,,219,37
Karluk,1946,235,,220,272
Karluk,1946,3427,,221,3699
Karluk,1946,8521,,222,12220
Karluk,1946,5594,,223,17814
Karluk,1946,3425,,224,21239
Karluk,1946,3674,,225,24913
Karluk,1946,2346,,226,27259
Karluk,1946,26027,,227,53286
Karluk,1946,3834,,228,57120
Karluk,1946,0,,229,57120
Karluk,1946,0,,230,57120
Karluk,1946,0,,231,57120
Karluk,1946,0,,232,57120
Karluk,1946,0,,233,57120
Karluk,1946,0,,234,57120
Karluk,1946,0,,235,57120
Karluk,1946,0,,236,57120
Karluk,1946,0,,237,57120
Karluk,1946,0,,238,57120
Karluk,1946,0,,239,57120
Karluk,1946,0,,240,57120
Karluk,1946,0,,241,57120
Karluk,1946,0,,242,57120
Karluk,1946,0,,243,57120
Karluk,1946,0,,244,57120
Karluk,1946,0,,245,57120
Karluk,1946,0,,246,57120
Karluk,1946,0,,247,57120
Karluk,1946,0,,248,57120
Karluk,1946,0,,249,57120
Karluk,1946,0,,250,57120
Karluk,1946,0,,251,57120
Karluk,1946,0,,252,57120
Karluk,1946,0,,253,57120
Karluk,1946,0,,254,57120
Karluk,1946,0,,255,57120
Karluk,1946,0,,256,57120
Karluk,1946,0,,257,57120
Karluk,1946,0,,258,57120
Karluk,1946,0,,259,57120
Karluk,1946,0,,260,57120
Karluk,1946,0,,261,57120
Karluk,1946,0,,262,57120
Karluk,1946,0,,263,57120
Karluk,1946,0,,264,57120
Karluk,1946,0,,265,57120
Karluk,1946,0,,266,57120
Karluk,1946,0,,267,57120
Karluk,1946,0,,268,57120
Karluk,1946,0,,269,57120
Karluk,1946,0,,270,57120
Karluk,1946,0,,271,57120
Karluk,1946,0,,272,57120
Karluk,1946,0,,273,57120
Karluk,1946,0,,274,57120
Karluk,1946,0,,275,57120
Karluk,1946,0,,276,57120
Karluk,1946,0,,277,57120
Karluk,1946,0,,278,57120
Karluk,1946,0,,279,57120
Karluk,1946,0,,280,57120
Karluk,1946,0,,281,57120
Karluk,1946,0,,282,57120
Karluk,1946,0,,283,57120
Karluk,1946,0,,284,57120
Karluk,1946,0,,285,57120
Karluk,1944,0,,155,0
Karluk,1944,0,,156,0
Karluk,1944,0,,157,0
Karluk,1944,0,,158,0
Karluk,1944,0,,159,0
Karluk,1944,0,,160,0
Karluk,1944,0,,161,0
Karluk,1944,0,,162,0
Karluk,1944,0,,163,0
Karluk,1944,0,,164,0
Karluk,1944,0,,165,0
Karluk,1944,0,,166,0
Karluk,1944,0,,167,0
Karluk,1944,0,,168,0
Karluk,1944,0,,169,0
Karluk,1944,0,,170,0
Karluk,1944,0,,171,0
Karluk,1944,0,,172,0
Karluk,1944,0,,173,0
Karluk,1944,0,,174,0
Karluk,1944,0,,175,0
Karluk,1944,0,,176,0
Karluk,1944,0,,177,0
Karluk,1944,0,,178,0
Karluk,1944,0,,179,0
Karluk,1944,0,,180,0
Karluk,1944,0,,181,0
Karluk,1944,0,,182,0
Karluk,1944,0,,183,0
Karluk,1944,0,,184,0
Karluk,1944,0,,185,0
Karluk,1944,0,,186,0
Karluk,1944,0,,187,0
Karluk,1944,0,,188,0
Karluk,1944,0,,189,0
Karluk,1944,0,,190,0
Karluk,1944,0,,191,0
Karluk,1944,0,,192,0
Karluk,1944,0,,193,0
Karluk,1944,0,,194,0
Karluk,1944,0,,195,0
Karluk,1944,0,,196,0
Karluk,1944,6,,197,6
Karluk,1944,7,,198,13
Karluk,1944,3,,199,16
Karluk,1944,0,,200,16
Karluk,1944,3,,201,19
Karluk,1944,0,,202,19
Karluk,1944,0,,203,19
Karluk,1944,0,,204,19
Karluk,1944,0,,205,19
Karluk,1944,0,,206,19
Karluk,1944,0,,207,19
Karluk,1944,0,,208,19
Karluk,1944,15,,209,34
Karluk,1944,22,,210,56
Karluk,1944,7,,211,63
Karluk,1944,1180,,212,1243
Karluk,1944,3383,,213,4626
Karluk,1944,1459,,214,6085
Karluk,1944,1765,,215,7850
Karluk,1944,4651,,216,12501
Karluk,1944,3848,,217,16349
Karluk,1944,6939,,218,23288
Karluk,1944,12019,,219,35307
Karluk,1944,102050,,220,137357
Karluk,1944,27413,,221,164770
Karluk,1944,7904,,222,172674
Karluk,1944,20619,,223,193293
Karluk,1944,0,,224,193293
Karluk,1944,0,,225,193293
Karluk,1944,0,,226,193293
Karluk,1944,0,,227,193293
Karluk,1944,0,,228,193293
Karluk,1944,0,,229,193293
Karluk,1944,0,,230,193293
Karluk,1944,0,,231,193293
Karluk,1944,0,,232,193293
Karluk,1944,0,,233,193293
Karluk,1944,0,,234,193293
Karluk,1944,0,,235,193293
Karluk,1944,0,,236,193293
Karluk,1944,0,,237,193293
Karluk,1944,0,,238,193293
Karluk,1944,0,,239,193293
Karluk,1944,0,,240,193293
Karluk,1944,0,,241,193293
Karluk,1944,0,,242,193293
Karluk,1944,0,,243,193293
Karluk,1944,0,,244,193293
Karluk,1944,0,,245,193293
Karluk,1944,0,,246,193293
Karluk,1944,0,,247,193293
Karluk,1944,0,,248,193293
Karluk,1944,0,,249,193293
Karluk,1944,0,,250,193293
Karluk,1944,0,,251,193293
Karluk,1944,0,,252,193293
Karluk,1944,0,,253,193293
Karluk,1944,0,,254,193293
Karluk,1944,0,,255,193293
Karluk,1944,0,,256,193293
Karluk,1944,0,,257,193293
Karluk,1944,0,,258,193293
Karluk,1944,0,,259,193293
Karluk,1944,0,,260,193293
Karluk,1944,0,,261,193293
Karluk,1944,0,,262,193293
Karluk,1944,0,,263,193293
Karluk,1944,0,,264,193293
Karluk,1944,0,,265,193293
Karluk,1944,0,,266,193293
Karluk,1944,0,,267,193293
Karluk,1944,0,,268,193293
Karluk,1944,0,,269,193293
Karluk,1944,0,,270,193293
Karluk,1944,0,,271,193293
Karluk,1944,0,,272,193293
Karluk,1944,0,,273,193293
Karluk,1944,0,,274,193293
Karluk,1944,0,,275,193293
Karluk,1944,0,,276,193293
Karluk,1944,0,,277,193293
Karluk,1944,0,,278,193293
Karluk,1944,0,,279,193293
Karluk,1944,0,,280,193293
Karluk,1944,0,,281,193293
Karluk,1944,0,,282,193293
Karluk,1944,0,,283,193293
Karluk,1944,0,,284,193293
Karluk,1944,0,,285,193293
Karluk,1944,0,,286,193293
Karluk,1943,0,,154,0
Karluk,1943,0,,155,0
Karluk,1943,0,,156,0
Karluk,1943,0,,157,0
Karluk,1943,0,,158,0
Karluk,1943,0,,159,0
Karluk,1943,0,,160,0
Karluk,1943,0,,161,0
Karluk,1943,0,,162,0
Karluk,1943,0,,163,0
Karluk,1943,0,,164,0
Karluk,1943,0,,165,0
Karluk,1943,0,,166,0
Karluk,1943,0,,167,0
Karluk,1943,0,,168,0
Karluk,1943,0,,169,0
Karluk,1943,0,,170,0
Karluk,1943,0,,171,0
Karluk,1943,0,,172,0
Karluk,1943,0,,173,0
Karluk,1943,0,,174,0
Karluk,1943,0,,175,0
Karluk,1943,0,,176,0
Karluk,1943,0,,177,0
Karluk,1943,0,,178,0
Karluk,1943,0,,179,0
Karluk,1943,0,,180,0
Karluk,1943,0,,181,0
Karluk,1943,0,,182,0
Karluk,1943,0,,183,0
Karluk,1943,0,,184,0
Karluk,1943,0,,185,0
Karluk,1943,0,,186,0
Karluk,1943,0,,187,0
Karluk,1943,0,,188,0
Karluk,1943,0,,189,0
Karluk,1943,0,,190,0
Karluk,1943,0,,191,0
Karluk,1943,0,,192,0
Karluk,1943,0,,193,0
Karluk,1943,0,,194,0
Karluk,1943,0,,195,0
Karluk,1943,0,,196,0
Karluk,1943,0,,197,0
Karluk,1943,0,,198,0
Karluk,1943,0,,199,0
Karluk,1943,4,,200,4
Karluk,1943,2,,201,6
Karluk,1943,2,,202,8
Karluk,1943,1,,203,9
Karluk,1943,2,,204,11
Karluk,1943,22,,205,33
Karluk,1943,0,,206,33
Karluk,1943,0,,207,33
Karluk,1943,7,,208,40
Karluk,1943,0,,209,40
Karluk,1943,4,,210,44
Karluk,1943,4,,211,48
Karluk,1943,2,,212,50
Karluk,1943,2,,213,52
Karluk,1943,2,,214,54
Karluk,1943,2,,215,56
Karluk,1943,0,,216,56
Karluk,1943,0,,217,56
Karluk,1943,0,,218,56
Karluk,1943,3,,219,59
Karluk,1943,1,,220,60
Karluk,1943,3,,221,63
Karluk,1943,9,,222,72
Karluk,1943,11,,223,83
Karluk,1943,2,,224,85
Karluk,1943,6,,225,91
Karluk,1943,8,,226,99
Karluk,1943,7,,227,106
Karluk,1943,4,,228,110
Karluk,1943,8,,229,118
Karluk,1943,2,,230,120
Karluk,1943,3,,231,123
Karluk,1943,3,,232,126
Karluk,1943,4,,233,130
Karluk,1943,6,,234,136
Karluk,1943,2,,235,138
Karluk,1943,15,,236,153
Karluk,1943,3,,237,156
Karluk,1943,6,,238,162
Karluk,1943,5,,239,167
Karluk,1943,1,,240,168
Karluk,1943,2,,241,170
Karluk,1943,0,,242,170
Karluk,1943,2,,243,172
Karluk,1943,1,,244,173
Karluk,1943,9,,245,182
Karluk,1943,1,,246,183
Karluk,1943,34,,247,217
Karluk,1943,10,,248,227
Karluk,1943,2,,249,229
Karluk,1943,0,,250,229
Karluk,1943,4,,251,233
Karluk,1943,1,,252,234
Karluk,1943,0,,253,234
Karluk,1943,0,,254,234
Karluk,1943,0,,255,234
Karluk,1943,0,,256,234
Karluk,1943,0,,257,234
Karluk,1943,0,,258,234
Karluk,1943,0,,259,234
Karluk,1943,0,,260,234
Karluk,1943,0,,261,234
Karluk,1943,0,,262,234
Karluk,1943,0,,263,234
Karluk,1943,0,,264,234
Karluk,1943,0,,265,234
Karluk,1943,0,,266,234
Karluk,1943,0,,267,234
Karluk,1943,0,,268,234
Karluk,1943,0,,269,234
Karluk,1943,0,,270,234
Karluk,1943,0,,271,234
Karluk,1943,0,,272,234
Karluk,1943,0,,273,234
Karluk,1943,0,,274,234
Karluk,1943,0,,275,234
Karluk,1943,0,,276,234
Karluk,1943,0,,277,234
Karluk,1943,0,,278,234
Karluk,1943,0,,279,234
Karluk,1943,0,,280,234
Karluk,1943,0,,281,234
Karluk,1943,0,,282,234
Karluk,1943,0,,283,234
Karluk,1943,0,,284,234
Karluk,1943,0,,285,234
Karluk,1942,0,,154,0
Karluk,1942,0,,155,0
Karluk,1942,0,,156,0
Karluk,1942,0,,157,0
Karluk,1942,0,,158,0
Karluk,1942,0,,159,0
Karluk,1942,0,,160,0
Karluk,1942,0,,161,0
Karluk,1942,0,,162,0
Karluk,1942,0,,163,0
Karluk,1942,0,,164,0
Karluk,1942,0,,165,0
Karluk,1942,0,,166,0
Karluk,1942,0,,167,0
Karluk,1942,0,,168,0
Karluk,1942,0,,169,0
Karluk,1942,0,,170,0
Karluk,1942,0,,171,0
Karluk,1942,0,,172,0
Karluk,1942,0,,173,0
Karluk,1942,0,,174,0
Karluk,1942,0,,175,0
Karluk,1942,0,,176,0
Karluk,1942,0,,177,0
Karluk,1942,0,,178,0
Karluk,1942,0,,179,0
Karluk,1942,0,,180,0
Karluk,1942,0,,181,0
Karluk,1942,0,,182,0
Karluk,1942,0,,183,0
Karluk,1942,0,,184,0
Karluk,1942,0,,185,0
Karluk,1942,0,,186,0
Karluk,1942,0,,187,0
Karluk,1942,0,,188,0
Karluk,1942,0,,189,0
Karluk,1942,0,,190,0
Karluk,1942,0,,191,0
Karluk,1942,0,,192,0
Karluk,1942,6,,193,6
Karluk,1942,3,,194,9
Karluk,1942,4,,195,13
Karluk,1942,3,,196,16
Karluk,1942,0,,197,16
Karluk,1942,1,,198,17
Karluk,1942,2,,199,19
Karluk,1942,4,,200,23
Karluk,1942,2,,201,25
Karluk,1942,4,,202,29
Karluk,1942,12,,203,41
Karluk,1942,2,,204,43
Karluk,1942,4,,205,47
Karluk,1942,0,,206,47
Karluk,1942,15,,207,62
Karluk,1942,23,,208,85
Karluk,1942,77,,209,162
Karluk,1942,44,,210,206
Karluk,1942,34,,211,240
Karluk,1942,28,,212,268
Karluk,1942,16,,213,284
Karluk,1942,76,,214,360
Karluk,1942,479,,215,839
Karluk,1942,177,,216,1016
Karluk,1942,476,,217,1492
Karluk,1942,46,,218,1538
Karluk,1942,5512,,219,7050
Karluk,1942,351,,220,7401
Karluk,1942,1079,,221,8480
Karluk,1942,1136,,222,9616
Karluk,1942,395,,223,10011
Karluk,1942,1106,,224,11117
Karluk,1942,1092,,225,12209
Karluk,1942,2665,,226,14874
Karluk,1942,2168,,227,17042
Karluk,1942,2017,,228,19059
Karluk,1942,1470,,229,20529
Karluk,1942,5126,,230,25655
Karluk,1942,6504,,231,32159
Karluk,1942,4273,,232,36432
Karluk,1942,9574,,233,46006
Karluk,1942,2842,,234,48848
Karluk,1942,4787,,235,53635
Karluk,1942,7438,,236,61073
Karluk,1942,11643,,237,72716
Karluk,1942,11255,,238,83971
Karluk,1942,5478,,239,89449
Karluk,1942,3986,,240,93435
Karluk,1942,2477,,241,95912
Karluk,1942,1632,,242,97544
Karluk,1942,1500,,243,99044
Karluk,1942,1500,,244,100544
Karluk,1942,1500,,245,102044
Karluk,1942,1500,,246,103544
Karluk,1942,1500,,247,105044
Karluk,1942,1225,,248,106269
Karluk,1942,12,,249,106281
Karluk,1942,62,,250,106343
Karluk,1942,15,,251,106358
Karluk,1942,0,,252,106358
Karluk,1942,0,,253,106358
Karluk,1942,0,,254,106358
Karluk,1942,0,,255,106358
Karluk,1942,0,,256,106358
Karluk,1942,0,,257,106358
Karluk,1942,0,,258,106358
Karluk,1942,0,,259,106358
Karluk,1942,0,,260,106358
Karluk,1942,0,,261,106358
Karluk,1942,0,,262,106358
Karluk,1942,0,,263,106358
Karluk,1942,0,,264,106358
Karluk,1942,0,,265,106358
Karluk,1942,0,,266,106358
Karluk,1942,0,,267,106358
Karluk,1942,0,,268,106358
Karluk,1942,0,,269,106358
Karluk,1942,0,,270,106358
Karluk,1942,0,,271,106358
Karluk,1942,0,,272,106358
Karluk,1942,0,,273,106358
Karluk,1942,0,,274,106358
Karluk,1942,0,,275,106358
Karluk,1942,0,,276,106358
Karluk,1942,0,,277,106358
Karluk,1942,0,,278,106358
Karluk,1942,0,,279,106358
Karluk,1942,0,,280,106358
Karluk,1942,0,,281,106358
Karluk,1942,0,,282,106358
Karluk,1942,0,,283,106358
Karluk,1942,0,,284,106358
Karluk,1942,0,,285,106358
Karluk,1941,0,,154,0
Karluk,1941,0,,155,0
Karluk,1941,0,,156,0
Karluk,1941,0,,157,0
Karluk,1941,0,,158,0
Karluk,1941,0,,159,0
Karluk,1941,0,,160,0
Karluk,1941,0,,161,0
Karluk,1941,0,,162,0
Karluk,1941,0,,163,0
Karluk,1941,0,,164,0
Karluk,1941,0,,165,0
Karluk,1941,0,,166,0
Karluk,1941,0,,167,0
Karluk,1941,0,,168,0
Karluk,1941,0,,169,0
Karluk,1941,0,,170,0
Karluk,1941,0,,171,0
Karluk,1941,0,,172,0
Karluk,1941,0,,173,0
Karluk,1941,0,,174,0
Karluk,1941,0,,175,0
Karluk,1941,0,,176,0
Karluk,1941,0,,177,0
Karluk,1941,0,,178,0
Karluk,1941,0,,179,0
Karluk,1941,0,,180,0
Karluk,1941,0,,181,0
Karluk,1941,0,,182,0
Karluk,1941,0,,183,0
Karluk,1941,0,,184,0
Karluk,1941,0,,185,0
Karluk,1941,0,,186,0
Karluk,1941,0,,187,0
Karluk,1941,3,,188,3
Karluk,1941,0,,189,3
Karluk,1941,0,,190,3
Karluk,1941,1,,191,4
Karluk,1941,0,,192,4
Karluk,1941,0,,193,4
Karluk,1941,22,,194,26
Karluk,1941,10,,195,36
Karluk,1941,16,,196,52
Karluk,1941,4,,197,56
Karluk,1941,9,,198,65
Karluk,1941,2,,199,67
Karluk,1941,6,,200,73
Karluk,1941,47,,201,120
Karluk,1941,334,,202,454
Karluk,1941,483,,203,937
Karluk,1941,506,,204,1443
Karluk,1941,205,,205,1648
Karluk,1941,188,,206,1836
Karluk,1941,490,,207,2326
Karluk,1941,101,,208,2427
Karluk,1941,357,,209,2784
Karluk,1941,527,,210,3311
Karluk,1941,13594,,211,16905
Karluk,1941,6865,,212,23770
Karluk,1941,12810,,213,36580
Karluk,1941,4225,,214,40805
Karluk,1941,45500,,215,86305
Karluk,1941,30225,,216,116530
Karluk,1941,2954,,217,119484
Karluk,1941,26,,218,119510
Karluk,1941,34,,219,119544
Karluk,1941,142,,220,119686
Karluk,1941,389,,221,120075
Karluk,1941,435,,222,120510
Karluk,1941,329,,223,120839
Karluk,1941,349,,224,121188
Karluk,1941,272,,225,121460
Karluk,1941,428,,226,121888
Karluk,1941,379,,227,122267
Karluk,1941,268,,228,122535
Karluk,1941,211,,229,122746
Karluk,1941,302,,230,123048
Karluk,1941,323,,231,123371
Karluk,1941,244,,232,123615
Karluk,1941,135,,233,123750
Karluk,1941,165,,234,123915
Karluk,1941,104,,235,124019
Karluk,1941,304,,236,124323
Karluk,1941,217,,237,124540
Karluk,1941,563,,238,125103
Karluk,1941,1420,,239,126523
Karluk,1941,384,,240,126907
Karluk,1941,921,,241,127828
Karluk,1941,782,,242,128610
Karluk,1941,959,,243,129569
Karluk,1941,450,,244,130019
Karluk,1941,522,,245,130541
Karluk,1941,544,,246,131085
Karluk,1941,469,,247,131554
Karluk,1941,188,,248,131742
Karluk,1941,344,,249,132086
Karluk,1941,321,,250,132407
Karluk,1941,878,,251,133285
Karluk,1941,0,,252,133285
Karluk,1941,0,,253,133285
Karluk,1941,0,,254,133285
Karluk,1941,0,,255,133285
Karluk,1941,0,,256,133285
Karluk,1941,0,,257,133285
Karluk,1941,0,,258,133285
Karluk,1941,0,,259,133285
Karluk,1941,0,,260,133285
Karluk,1941,0,,261,133285
Karluk,1941,0,,262,133285
Karluk,1941,0,,263,133285
Karluk,1941,0,,264,133285
Karluk,1941,0,,265,133285
Karluk,1941,0,,266,133285
Karluk,1941,0,,267,133285
Karluk,1941,0,,268,133285
Karluk,1941,0,,269,133285
Karluk,1941,0,,270,133285
Karluk,1941,0,,271,133285
Karluk,1941,0,,272,133285
Karluk,1941,0,,273,133285
Karluk,1941,0,,274,133285
Karluk,1941,0,,275,133285
Karluk,1941,0,,276,133285
Karluk,1941,0,,277,133285
Karluk,1941,0,,278,133285
Karluk,1941,0,,279,133285
Karluk,1941,0,,280,133285
Karluk,1941,0,,281,133285
Karluk,1941,0,,282,133285
Karluk,1941,0,,283,133285
Karluk,1941,0,,284,133285
Karluk,1941,0,,285,133285
Karluk,1940,0,,155,0
Karluk,1940,0,,156,0
Karluk,1940,0,,157,0
Karluk,1940,0,,158,0
Karluk,1940,0,,159,0
Karluk,1940,0,,160,0
Karluk,1940,0,,161,0
Karluk,1940,0,,162,0
Karluk,1940,0,,163,0
Karluk,1940,0,,164,0
Karluk,1940,0,,165,0
Karluk,1940,0,,166,0
Karluk,1940,0,,167,0
Karluk,1940,0,,168,0
Karluk,1940,0,,169,0
Karluk,1940,0,,170,0
Karluk,1940,0,,171,0
Karluk,1940,0,,172,0
Karluk,1940,0,,173,0
Karluk,1940,0,,174,0
Karluk,1940,0,,175,0
Karluk,1940,0,,176,0
Karluk,1940,0,,177,0
Karluk,1940,0,,178,0
Karluk,1940,0,,179,0
Karluk,1940,0,,180,0
Karluk,1940,0,,181,0
Karluk,1940,0,,182,0
Karluk,1940,0,,183,0
Karluk,1940,0,,184,0
Karluk,1940,0,,185,0
Karluk,1940,0,,186,0
Karluk,1940,0,,187,0
Karluk,1940,0,,188,0
Karluk,1940,0,,189,0
Karluk,1940,0,,190,0
Karluk,1940,0,,191,0
Karluk,1940,0,,192,0
Karluk,1940,0,,193,0
Karluk,1940,0,,194,0
Karluk,1940,0,,195,0
Karluk,1940,0,,196,0
Karluk,1940,0,,197,0
Karluk,1940,28,,198,28
Karluk,1940,76,,199,104
Karluk,1940,2,,200,106
Karluk,1940,64,,201,170
Karluk,1940,2917,,202,3087
Karluk,1940,5815,,203,8902
Karluk,1940,4240,,204,13142
Karluk,1940,4398,,205,17540
Karluk,1940,2384,,206,19924
Karluk,1940,57502,,207,77426
Karluk,1940,93566,,208,170992
Karluk,1940,52642,,209,223634
Karluk,1940,48518,,210,272152
Karluk,1940,9277,,211,281429
Karluk,1940,4223,,212,285652
Karluk,1940,166,,213,285818
Karluk,1940,997,,214,286815
Karluk,1940,978,,215,287793
Karluk,1940,5420,,216,293213
Karluk,1940,26674,,217,319887
Karluk,1940,12851,,218,332738
Karluk,1940,21521,,219,354259
Karluk,1940,81664,,220,435923
Karluk,1940,41278,,221,477201
Karluk,1940,18642,,222,495843
Karluk,1940,3450,,223,499293
Karluk,1940,7001,,224,506294
Karluk,1940,3330,,225,509624
Karluk,1940,11399,,226,521023
Karluk,1940,23713,,227,544736
Karluk,1940,38005,,228,582741
Karluk,1940,65304,,229,648045
Karluk,1940,93214,,230,741259
Karluk,1940,10421,,231,751680
Karluk,1940,13126,,232,764806
Karluk,1940,18211,,233,783017
Karluk,1940,17513,,234,800530
Karluk,1940,16182,,235,816712
Karluk,1940,16421,,236,833133
Karluk,1940,19340,,237,852473
Karluk,1940,0,,238,852473
Karluk,1940,0,,239,852473
Karluk,1940,0,,240,852473
Karluk,1940,0,,241,852473
Karluk,1940,0,,242,852473
Karluk,1940,0,,243,852473
Karluk,1940,0,,244,852473
Karluk,1940,0,,245,852473
Karluk,1940,0,,246,852473
Karluk,1940,0,,247,852473
Karluk,1940,0,,248,852473
Karluk,1940,0,,249,852473
Karluk,1940,0,,250,852473
Karluk,1940,0,,251,852473
Karluk,1940,0,,252,852473
Karluk,1940,0,,253,852473
Karluk,1940,0,,254,852473
Karluk,1940,0,,255,852473
Karluk,1940,0,,256,852473
Karluk,1940,0,,257,852473
Karluk,1940,0,,258,852473
Karluk,1940,0,,259,852473
Karluk,1940,0,,260,852473
Karluk,1940,0,,261,852473
Karluk,1940,0,,262,852473
Karluk,1940,0,,263,852473
Karluk,1940,0,,264,852473
Karluk,1940,0,,265,852473
Karluk,1940,0,,266,852473
Karluk,1940,0,,267,852473
Karluk,1940,0,,268,852473
Karluk,1940,0,,269,852473
Karluk,1940,0,,270,852473
Karluk,1940,0,,271,852473
Karluk,1940,0,,272,852473
Karluk,1940,0,,273,852473
Karluk,1940,0,,274,852473
Karluk,1940,0,,275,852473
Karluk,1940,0,,276,852473
Karluk,1940,0,,277,852473
Karluk,1940,0,,278,852473
Karluk,1940,0,,279,852473
Karluk,1940,0,,280,852473
Karluk,1940,0,,281,852473
Karluk,1940,0,,282,852473
Karluk,1940,0,,283,852473
Karluk,1940,0,,284,852473
Karluk,1940,0,,285,852473
Karluk,1940,0,,286,852473
Karluk,1939,0,,154,0
Karluk,1939,0,,155,0
Karluk,1939,0,,156,0
Karluk,1939,0,,157,0
Karluk,1939,0,,158,0
Karluk,1939,0,,159,0
Karluk,1939,0,,160,0
Karluk,1939,0,,161,0
Karluk,1939,0,,162,0
Karluk,1939,0,,163,0
Karluk,1939,0,,164,0
Karluk,1939,0,,165,0
Karluk,1939,0,,166,0
Karluk,1939,0,,167,0
Karluk,1939,0,,168,0
Karluk,1939,0,,169,0
Karluk,1939,0,,170,0
Karluk,1939,0,,171,0
Karluk,1939,0,,172,0
Karluk,1939,0,,173,0
Karluk,1939,0,,174,0
Karluk,1939,0,,175,0
Karluk,1939,0,,176,0
Karluk,1939,0,,177,0
Karluk,1939,0,,178,0
Karluk,1939,0,,179,0
Karluk,1939,0,,180,0
Karluk,1939,0,,181,0
Karluk,1939,0,,182,0
Karluk,1939,0,,183,0
Karluk,1939,0,,184,0
Karluk,1939,0,,185,0
Karluk,1939,0,,186,0
Karluk,1939,0,,187,0
Karluk,1939,0,,188,0
Karluk,1939,0,,189,0
Karluk,1939,0,,190,0
Karluk,1939,0,,191,0
Karluk,1939,0,,192,0
Karluk,1939,0,,193,0
Karluk,1939,0,,194,0
Karluk,1939,0,,195,0
Karluk,1939,0,,196,0
Karluk,1939,0,,197,0
Karluk,1939,0,,198,0
Karluk,1939,0,,199,0
Karluk,1939,0,,200,0
Karluk,1939,0,,201,0
Karluk,1939,0,,202,0
Karluk,1939,0,,203,0
Karluk,1939,30,,204,30
Karluk,1939,22,,205,52
Karluk,1939,40,,206,92
Karluk,1939,52,,207,144
Karluk,1939,59,,208,203
Karluk,1939,136,,209,339
Karluk,1939,37,,210,376
Karluk,1939,37,,211,413
Karluk,1939,134,,212,547
Karluk,1939,237,,213,784
Karluk,1939,498,,214,1282
Karluk,1939,368,,215,1650
Karluk,1939,772,,216,2422
Karluk,1939,154,,217,2576
Karluk,1939,82,,218,2658
Karluk,1939,204,,219,2862
Karluk,1939,265,,220,3127
Karluk,1939,562,,221,3689
Karluk,1939,156,,222,3845
Karluk,1939,302,,223,4147
Karluk,1939,920,,224,5067
Karluk,1939,467,,225,5534
Karluk,1939,118,,226,5652
Karluk,1939,199,,227,5851
Karluk,1939,375,,228,6226
Karluk,1939,79,,229,6305
Karluk,1939,1179,,230,7484
Karluk,1939,289,,231,7773
Karluk,1939,406,,232,8179
Karluk,1939,790,,233,8969
Karluk,1939,666,,234,9635
Karluk,1939,565,,235,10200
Karluk,1939,297,,236,10497
Karluk,1939,188,,237,10685
Karluk,1939,589,,238,11274
Karluk,1939,305,,239,11579
Karluk,1939,201,,240,11780
Karluk,1939,2075,,241,13855
Karluk,1939,796,,242,14651
Karluk,1939,225,,243,14876
Karluk,1939,6601,,244,21477
Karluk,1939,511,,245,21988
Karluk,1939,261,,246,22249
Karluk,1939,339,,247,22588
Karluk,1939,156,,248,22744
Karluk,1939,7145,,249,29889
Karluk,1939,1643,,250,31532
Karluk,1939,341,,251,31873
Karluk,1939,71,,252,31944
Karluk,1939,0,,253,31944
Karluk,1939,0,,254,31944
Karluk,1939,0,,255,31944
Karluk,1939,0,,256,31944
Karluk,1939,0,,257,31944
Karluk,1939,0,,258,31944
Karluk,1939,0,,259,31944
Karluk,1939,0,,260,31944
Karluk,1939,0,,261,31944
Karluk,1939,0,,262,31944
Karluk,1939,0,,263,31944
Karluk,1939,0,,264,31944
Karluk,1939,0,,265,31944
Karluk,1939,0,,266,31944
Karluk,1939,0,,267,31944
Karluk,1939,0,,268,31944
Karluk,1939,0,,269,31944
Karluk,1939,0,,270,31944
Karluk,1939,0,,271,31944
Karluk,1939,0,,272,31944
Karluk,1939,0,,273,31944
Karluk,1939,0,,274,31944
Karluk,1939,0,,275,31944
Karluk,1939,0,,276,31944
Karluk,1939,0,,277,31944
Karluk,1939,0,,278,31944
Karluk,1939,0,,279,31944
Karluk,1939,0,,280,31944
Karluk,1939,0,,281,31944
Karluk,1939,0,,282,31944
Karluk,1939,0,,283,31944
Karluk,1939,0,,284,31944
Karluk,1939,0,,285,31944
Karluk,1938,0,,154,0
Karluk,1938,0,,155,0
Karluk,1938,0,,156,0
Karluk,1938,0,,157,0
Karluk,1938,0,,158,0
Karluk,1938,0,,159,0
Karluk,1938,0,,160,0
Karluk,1938,0,,161,0
Karluk,1938,0,,162,0
Karluk,1938,0,,163,0
Karluk,1938,0,,164,0
Karluk,1938,0,,165,0
Karluk,1938,0,,166,0
Karluk,1938,0,,167,0
Karluk,1938,0,,168,0
Karluk,1938,0,,169,0
Karluk,1938,0,,170,0
Karluk,1938,0,,171,0
Karluk,1938,0,,172,0
Karluk,1938,0,,173,0
Karluk,1938,0,,174,0
Karluk,1938,0,,175,0
Karluk,1938,0,,176,0
Karluk,1938,0,,177,0
Karluk,1938,0,,178,0
Karluk,1938,0,,179,0
Karluk,1938,0,,180,0
Karluk,1938,0,,181,0
Karluk,1938,0,,182,0
Karluk,1938,0,,183,0
Karluk,1938,0,,184,0
Karluk,1938,0,,185,0
Karluk,1938,0,,186,0
Karluk,1938,0,,187,0
Karluk,1938,0,,188,0
Karluk,1938,0,,189,0
Karluk,1938,0,,190,0
Karluk,1938,0,,191,0
Karluk,1938,0,,192,0
Karluk,1938,0,,193,0
Karluk,1938,0,,194,0
Karluk,1938,0,,195,0
Karluk,1938,0,,196,0
Karluk,1938,0,,197,0
Karluk,1938,0,,198,0
Karluk,1938,0,,199,0
Karluk,1938,0,,200,0
Karluk,1938,0,,201,0
Karluk,1938,0,,202,0
Karluk,1938,0,,203,0
Karluk,1938,0,,204,0
Karluk,1938,0,,205,0
Karluk,1938,0,,206,0
Karluk,1938,0,,207,0
Karluk,1938,0,,208,0
Karluk,1938,0,,209,0
Karluk,1938,0,,210,0
Karluk,1938,0,,211,0
Karluk,1938,90,,212,90
Karluk,1938,271,,213,361
Karluk,1938,374,,214,735
Karluk,1938,2779,,215,3514
Karluk,1938,4134,,216,7648
Karluk,1938,32884,,217,40532
Karluk,1938,20772,,218,61304
Karluk,1938,39158,,219,100462
Karluk,1938,32069,,220,132531
Karluk,1938,37562,,221,170093
Karluk,1938,47421,,222,217514
Karluk,1938,51073,,223,268587
Karluk,1938,43824,,224,312411
Karluk,1938,65446,,225,377857
Karluk,1938,125243,,226,503100
Karluk,1938,36294,,227,539394
Karluk,1938,117519,,228,656913
Karluk,1938,108720,,229,765633
Karluk,1938,98711,,230,864344
Karluk,1938,78660,,231,943004
Karluk,1938,27569,,232,970573
Karluk,1938,41861,,233,1012434
Karluk,1938,126730,,234,1139164
Karluk,1938,88154,,235,1227318
Karluk,1938,45108,,236,1272426
Karluk,1938,76495,,237,1348921
Karluk,1938,19283,,238,1368204
Karluk,1938,22757,,239,1390961
Karluk,1938,20663,,240,1411624
Karluk,1938,27817,,241,1439441
Karluk,1938,85181,,242,1524622
Karluk,1938,55341,,243,1579963
Karluk,1938,32589,,244,1612552
Karluk,1938,21354,,245,1633906
Karluk,1938,5683,,246,1639589
Karluk,1938,8695,,247,1648284
Karluk,1938,8695,,248,1656979
Karluk,1938,8695,,249,1665674
Karluk,1938,8695,,250,1674369
Karluk,1938,8695,,251,1683064
Karluk,1938,8695,,252,1691759
Karluk,1938,8695,,253,1700454
Karluk,1938,8695,,254,1709149
Karluk,1938,8695,,255,1717844
Karluk,1938,8695,,256,1726539
Karluk,1938,8695,,257,1735234
Karluk,1938,8696,,258,1743930
Karluk,1938,8696,,259,1752626
Karluk,1938,8696,,260,1761322
Karluk,1938,8696,,261,1770018
Karluk,1938,8696,,262,1778714
Karluk,1938,8696,,263,1787410
Karluk,1938,8696,,264,1796106
Karluk,1938,8696,,265,1804802
Karluk,1938,8696,,266,1813498
Karluk,1938,8696,,267,1822194
Karluk,1938,8696,,268,1830890
Karluk,1938,8699,,269,1839589
Karluk,1938,0,,270,1839589
Karluk,1938,0,,271,1839589
Karluk,1938,0,,272,1839589
Karluk,1938,0,,273,1839589
Karluk,1938,0,,274,1839589
Karluk,1938,0,,275,1839589
Karluk,1938,0,,276,1839589
Karluk,1938,0,,277,1839589
Karluk,1938,0,,278,1839589
Karluk,1938,0,,279,1839589
Karluk,1938,0,,280,1839589
Karluk,1938,0,,281,1839589
Karluk,1938,0,,282,1839589
Karluk,1938,0,,283,1839589
Karluk,1938,0,,284,1839589
Karluk,1938,0,,285,1839589
Karluk,1937,0,,154,0
Karluk,1937,0,,155,0
Karluk,1937,0,,156,0
Karluk,1937,0,,157,0
Karluk,1937,0,,158,0
Karluk,1937,0,,159,0
Karluk,1937,0,,160,0
Karluk,1937,0,,161,0
Karluk,1937,0,,162,0
Karluk,1937,0,,163,0
Karluk,1937,0,,164,0
Karluk,1937,0,,165,0
Karluk,1937,0,,166,0
Karluk,1937,0,,167,0
Karluk,1937,0,,168,0
Karluk,1937,0,,169,0
Karluk,1937,0,,170,0
Karluk,1937,0,,171,0
Karluk,1937,0,,172,0
Karluk,1937,0,,173,0
Karluk,1937,0,,174,0
Karluk,1937,0,,175,0
Karluk,1937,0,,176,0
Karluk,1937,0,,177,0
Karluk,1937,0,,178,0
Karluk,1937,0,,179,0
Karluk,1937,0,,180,0
Karluk,1937,0,,181,0
Karluk,1937,0,,182,0
Karluk,1937,0,,183,0
Karluk,1937,0,,184,0
Karluk,1937,0,,185,0
Karluk,1937,0,,186,0
Karluk,1937,0,,187,0
Karluk,1937,0,,188,0
Karluk,1937,0,,189,0
Karluk,1937,0,,190,0
Karluk,1937,0,,191,0
Karluk,1937,0,,192,0
Karluk,1937,0,,193,0
Karluk,1937,0,,194,0
Karluk,1937,0,,195,0
Karluk,1937,0,,196,0
Karluk,1937,0,,197,0
Karluk,1937,0,,198,0
Karluk,1937,0,,199,0
Karluk,1937,0,,200,0
Karluk,1937,0,,201,0
Karluk,1937,0,,202,0
Karluk,1937,0,,203,0
Karluk,1937,0,,204,0
Karluk,1937,29,,205,29
Karluk,1937,11,,206,40
Karluk,1937,14,,207,54
Karluk,1937,29,,208,83
Karluk,1937,73,,209,156
Karluk,1937,65,,210,221
Karluk,1937,58,,211,279
Karluk,1937,51,,212,330
Karluk,1937,19,,213,349
Karluk,1937,160,,214,509
Karluk,1937,209,,215,718
Karluk,1937,96,,216,814
Karluk,1937,95,,217,909
Karluk,1937,48,,218,957
Karluk,1937,49,,219,1006
Karluk,1937,168,,220,1174
Karluk,1937,878,,221,2052
Karluk,1937,150,,222,2202
Karluk,1937,451,,223,2653
Karluk,1937,107,,224,2760
Karluk,1937,31,,225,2791
Karluk,1937,64,,226,2855
Karluk,1937,105,,227,2960
Karluk,1937,224,,228,3184
Karluk,1937,274,,229,3458
Karluk,1937,110,,230,3568
Karluk,1937,116,,231,3684
Karluk,1937,125,,232,3809
Karluk,1937,44,,233,3853
Karluk,1937,44,,234,3897
Karluk,1937,834,,235,4731
Karluk,1937,253,,236,4984
Karluk,1937,26,,237,5010
Karluk,1937,19,,238,5029
Karluk,1937,42,,239,5071
Karluk,1937,126,,240,5197
Karluk,1937,197,,241,5394
Karluk,1937,37,,242,5431
Karluk,1937,14,,243,5445
Karluk,1937,102,,244,5547
Karluk,1937,52,,245,5599
Karluk,1937,64,,246,5663
Karluk,1937,75,,247,5738
Karluk,1937,0,,248,5738
Karluk,1937,0,,249,5738
Karluk,1937,0,,250,5738
Karluk,1937,0,,251,5738
Karluk,1937,0,,252,5738
Karluk,1937,0,,253,5738
Karluk,1937,0,,254,5738
Karluk,1937,0,,255,5738
Karluk,1937,0,,256,5738
Karluk,1937,0,,257,5738
Karluk,1937,0,,258,5738
Karluk,1937,0,,259,5738
Karluk,1937,0,,260,5738
Karluk,1937,0,,261,5738
Karluk,1937,0,,262,5738
Karluk,1937,0,,263,5738
Karluk,1937,0,,264,5738
Karluk,1937,0,,265,5738
Karluk,1937,0,,266,5738
Karluk,1937,0,,267,5738
Karluk,1937,0,,268,5738
Karluk,1937,0,,269,5738
Karluk,1937,0,,270,5738
Karluk,1937,0,,271,5738
Karluk,1937,0,,272,5738
Karluk,1937,0,,273,5738
Karluk,1937,0,,274,5738
Karluk,1937,0,,275,5738
Karluk,1937,0,,276,5738
Karluk,1937,0,,277,5738
Karluk,1937,0,,278,5738
Karluk,1937,0,,279,5738
Karluk,1937,0,,280,5738
Karluk,1937,0,,281,5738
Karluk,1937,0,,282,5738
Karluk,1937,0,,283,5738
Karluk,1937,0,,284,5738
Karluk,1937,0,,285,5738
Karluk,1936,0,,155,0
Karluk,1936,0,,156,0
Karluk,1936,0,,157,0
Karluk,1936,0,,158,0
Karluk,1936,0,,159,0
Karluk,1936,0,,160,0
Karluk,1936,0,,161,0
Karluk,1936,0,,162,0
Karluk,1936,0,,163,0
Karluk,1936,0,,164,0
Karluk,1936,0,,165,0
Karluk,1936,0,,166,0
Karluk,1936,0,,167,0
Karluk,1936,0,,168,0
Karluk,1936,0,,169,0
Karluk,1936,0,,170,0
Karluk,1936,0,,171,0
Karluk,1936,0,,172,0
Karluk,1936,0,,173,0
Karluk,1936,0,,174,0
Karluk,1936,0,,175,0
Karluk,1936,0,,176,0
Karluk,1936,0,,177,0
Karluk,1936,0,,178,0
Karluk,1936,0,,179,0
Karluk,1936,0,,180,0
Karluk,1936,0,,181,0
Karluk,1936,0,,182,0
Karluk,1936,0,,183,0
Karluk,1936,0,,184,0
Karluk,1936,0,,185,0
Karluk,1936,0,,186,0
Karluk,1936,0,,187,0
Karluk,1936,0,,188,0
Karluk,1936,0,,189,0
Karluk,1936,0,,190,0
Karluk,1936,0,,191,0
Karluk,1936,0,,192,0
Karluk,1936,106,,193,106
Karluk,1936,28,,194,134
Karluk,1936,103,,195,237
Karluk,1936,93,,196,330
Karluk,1936,235,,197,565
Karluk,1936,393,,198,958
Karluk,1936,124,,199,1082
Karluk,1936,245,,200,1327
Karluk,1936,90,,201,1417
Karluk,1936,931,,202,2348
Karluk,1936,2566,,203,4914
Karluk,1936,5596,,204,10510
Karluk,1936,13565,,205,24075
Karluk,1936,19370,,206,43445
Karluk,1936,21649,,207,65094
Karluk,1936,21355,,208,86449
Karluk,1936,52804,,209,139253
Karluk,1936,9665,,210,148918
Karluk,1936,104,,211,149022
Karluk,1936,106,,212,149128
Karluk,1936,161,,213,149289
Karluk,1936,150,,214,149439
Karluk,1936,224,,215,149663
Karluk,1936,42,,216,149705
Karluk,1936,36,,217,149741
Karluk,1936,1762,,218,151503
Karluk,1936,1821,,219,153324
Karluk,1936,198,,220,153522
Karluk,1936,620,,221,154142
Karluk,1936,4632,,222,158774
Karluk,1936,18876,,223,177650
Karluk,1936,64819,,224,242469
Karluk,1936,13324,,225,255793
Karluk,1936,2219,,226,258012
Karluk,1936,15912,,227,273924
Karluk,1936,52754,,228,326678
Karluk,1936,9985,,229,336663
Karluk,1936,23645,,230,360308
Karluk,1936,12364,,231,372672
Karluk,1936,2840,,232,375512
Karluk,1936,7097,,233,382609
Karluk,1936,15591,,234,398200
Karluk,1936,2668,,235,400868
Karluk,1936,5059,,236,405927
Karluk,1936,9983,,237,415910
Karluk,1936,4287,,238,420197
Karluk,1936,2949,,239,423146
Karluk,1936,8604,,240,431750
Karluk,1936,35686,,241,467436
Karluk,1936,7118,,242,474554
Karluk,1936,8151,,243,482705
Karluk,1936,17835,,244,500540
Karluk,1936,19874,,245,520414
Karluk,1936,3024,,246,523438
Karluk,1936,976,,247,524414
Karluk,1936,524,,248,524938
Karluk,1936,425,,249,525363
Karluk,1936,245,,250,525608
Karluk,1936,0,,251,525608
Karluk,1936,0,,252,525608
Karluk,1936,0,,253,525608
Karluk,1936,0,,254,525608
Karluk,1936,0,,255,525608
Karluk,1936,0,,256,525608
Karluk,1936,0,,257,525608
Karluk,1936,0,,258,525608
Karluk,1936,0,,259,525608
Karluk,1936,0,,260,525608
Karluk,1936,0,,261,525608
Karluk,1936,0,,262,525608
Karluk,1936,0,,263,525608
Karluk,1936,0,,264,525608
Karluk,1936,0,,265,525608
Karluk,1936,0,,266,525608
Karluk,1936,0,,267,525608
Karluk,1936,0,,268,525608
Karluk,1936,0,,269,525608
Karluk,1936,0,,270,525608
Karluk,1936,0,,271,525608
Karluk,1936,0,,272,525608
Karluk,1936,0,,273,525608
Karluk,1936,0,,274,525608
Karluk,1936,0,,275,525608
Karluk,1936,0,,276,525608
Karluk,1936,0,,277,525608
Karluk,1936,0,,278,525608
Karluk,1936,0,,279,525608
Karluk,1936,0,,280,525608
Karluk,1936,0,,281,525608
Karluk,1936,0,,282,525608
Karluk,1936,0,,283,525608
Karluk,1936,0,,284,525608
Karluk,1936,0,,285,525608
Karluk,1936,0,,286,525608
Karluk,1935,0,,154,0
Karluk,1935,0,,155,0
Karluk,1935,0,,156,0
Karluk,1935,0,,157,0
Karluk,1935,0,,158,0
Karluk,1935,0,,159,0
Karluk,1935,0,,160,0
Karluk,1935,0,,161,0
Karluk,1935,0,,162,0
Karluk,1935,0,,163,0
Karluk,1935,0,,164,0
Karluk,1935,0,,165,0
Karluk,1935,0,,166,0
Karluk,1935,0,,167,0
Karluk,1935,0,,168,0
Karluk,1935,0,,169,0
Karluk,1935,0,,170,0
Karluk,1935,0,,171,0
Karluk,1935,0,,172,0
Karluk,1935,0,,173,0
Karluk,1935,0,,174,0
Karluk,1935,0,,175,0
Karluk,1935,0,,176,0
Karluk,1935,0,,177,0
Karluk,1935,0,,178,0
Karluk,1935,0,,179,0
Karluk,1935,0,,180,0
Karluk,1935,0,,181,0
Karluk,1935,0,,182,0
Karluk,1935,0,,183,0
Karluk,1935,0,,184,0
Karluk,1935,0,,185,0
Karluk,1935,0,,186,0
Karluk,1935,0,,187,0
Karluk,1935,0,,188,0
Karluk,1935,0,,189,0
Karluk,1935,0,,190,0
Karluk,1935,0,,191,0
Karluk,1935,0,,192,0
Karluk,1935,0,,193,0
Karluk,1935,0,,194,0
Karluk,1935,0,,195,0
Karluk,1935,0,,196,0
Karluk,1935,0,,197,0
Karluk,1935,0,,198,0
Karluk,1935,0,,199,0
Karluk,1935,0,,200,0
Karluk,1935,0,,201,0
Karluk,1935,0,,202,0
Karluk,1935,0,,203,0
Karluk,1935,0,,204,0
Karluk,1935,16,,205,16
Karluk,1935,75,,206,91
Karluk,1935,42,,207,133
Karluk,1935,33,,208,166
Karluk,1935,74,,209,240
Karluk,1935,200,,210,440
Karluk,1935,129,,211,569
Karluk,1935,57,,212,626
Karluk,1935,214,,213,840
Karluk,1935,280,,214,1120
Karluk,1935,249,,215,1369
Karluk,1935,75,,216,1444
Karluk,1935,25,,217,1469
Karluk,1935,51,,218,1520
Karluk,1935,344,,219,1864
Karluk,1935,278,,220,2142
Karluk,1935,132,,221,2274
Karluk,1935,109,,222,2383
Karluk,1935,110,,223,2493
Karluk,1935,36,,224,2529
Karluk,1935,34,,225,2563
Karluk,1935,167,,226,2730
Karluk,1935,19,,227,2749
Karluk,1935,763,,228,3512
Karluk,1935,684,,229,4196
Karluk,1935,59,,230,4255
Karluk,1935,27,,231,4282
Karluk,1935,427,,232,4709
Karluk,1935,124,,233,4833
Karluk,1935,24,,234,4857
Karluk,1935,310,,235,5167
Karluk,1935,505,,236,5672
Karluk,1935,45,,237,5717
Karluk,1935,8,,238,5725
Karluk,1935,23,,239,5748
Karluk,1935,10,,240,5758
Karluk,1935,8,,241,5766
Karluk,1935,14,,242,5780
Karluk,1935,6,,243,5786
Karluk,1935,0,,244,5786
Karluk,1935,0,,245,5786
Karluk,1935,0,,246,5786
Karluk,1935,0,,247,5786
Karluk,1935,0,,248,5786
Karluk,1935,0,,249,5786
Karluk,1935,0,,250,5786
Karluk,1935,0,,251,5786
Karluk,1935,0,,252,5786
Karluk,1935,0,,253,5786
Karluk,1935,0,,254,5786
Karluk,1935,0,,255,5786
Karluk,1935,0,,256,5786
Karluk,1935,0,,257,5786
Karluk,1935,0,,258,5786
Karluk,1935,0,,259,5786
Karluk,1935,0,,260,5786
Karluk,1935,0,,261,5786
Karluk,1935,0,,262,5786
Karluk,1935,0,,263,5786
Karluk,1935,0,,264,5786
Karluk,1935,0,,265,5786
Karluk,1935,0,,266,5786
Karluk,1935,0,,267,5786
Karluk,1935,0,,268,5786
Karluk,1935,0,,269,5786
Karluk,1935,0,,270,5786
Karluk,1935,0,,271,5786
Karluk,1935,0,,272,5786
Karluk,1935,0,,273,5786
Karluk,1935,0,,274,5786
Karluk,1935,0,,275,5786
Karluk,1935,0,,276,5786
Karluk,1935,0,,277,5786
Karluk,1935,0,,278,5786
Karluk,1935,0,,279,5786
Karluk,1935,0,,280,5786
Karluk,1935,0,,281,5786
Karluk,1935,0,,282,5786
Karluk,1935,0,,283,5786
Karluk,1935,0,,284,5786
Karluk,1935,0,,285,5786
Karluk,1934,0,,154,0
Karluk,1934,0,,155,0
Karluk,1934,0,,156,0
Karluk,1934,0,,157,0
Karluk,1934,0,,158,0
Karluk,1934,0,,159,0
Karluk,1934,0,,160,0
Karluk,1934,0,,161,0
Karluk,1934,0,,162,0
Karluk,1934,0,,163,0
Karluk,1934,0,,164,0
Karluk,1934,0,,165,0
Karluk,1934,0,,166,0
Karluk,1934,0,,167,0
Karluk,1934,0,,168,0
Karluk,1934,0,,169,0
Karluk,1934,0,,170,0
Karluk,1934,0,,171,0
Karluk,1934,0,,172,0
Karluk,1934,0,,173,0
Karluk,1934,0,,174,0
Karluk,1934,0,,175,0
Karluk,1934,0,,176,0
Karluk,1934,0,,177,0
Karluk,1934,0,,178,0
Karluk,1934,0,,179,0
Karluk,1934,0,,180,0
Karluk,1934,0,,181,0
Karluk,1934,0,,182,0
Karluk,1934,1,,183,1
Karluk,1934,12,,184,13
Karluk,1934,4,,185,17
Karluk,1934,8,,186,25
Karluk,1934,6,,187,31
Karluk,1934,12,,188,43
Karluk,1934,3,,189,46
Karluk,1934,0,,190,46
Karluk,1934,4,,191,50
Karluk,1934,0,,192,50
Karluk,1934,7,,193,57
Karluk,1934,0,,194,57
Karluk,1934,17,,195,74
Karluk,1934,3,,196,77
Karluk,1934,22,,197,99
Karluk,1934,6,,198,105
Karluk,1934,4,,199,109
Karluk,1934,68,,200,177
Karluk,1934,59,,201,236
Karluk,1934,95,,202,331
Karluk,1934,340,,203,671
Karluk,1934,3339,,204,4010
Karluk,1934,7904,,205,11914
Karluk,1934,40402,,206,52316
Karluk,1934,59440,,207,111756
Karluk,1934,37642,,208,149398
Karluk,1934,71412,,209,220810
Karluk,1934,9290,,210,230100
Karluk,1934,237,,211,230337
Karluk,1934,112,,212,230449
Karluk,1934,11340,,213,241789
Karluk,1934,8017,,214,249806
Karluk,1934,38972,,215,288778
Karluk,1934,53238,,216,342016
Karluk,1934,33309,,217,375325
Karluk,1934,85577,,218,460902
Karluk,1934,11616,,219,472518
Karluk,1934,9440,,220,481958
Karluk,1934,36312,,221,518270
Karluk,1934,40373,,222,558643
Karluk,1934,69457,,223,628100
Karluk,1934,52103,,224,680203
Karluk,1934,38462,,225,718665
Karluk,1934,43514,,226,762179
Karluk,1934,8920,,227,771099
Karluk,1934,38809,,228,809908
Karluk,1934,5410,,229,815318
Karluk,1934,37050,,230,852368
Karluk,1934,32163,,231,884531
Karluk,1934,125856,,232,1010387
Karluk,1934,21786,,233,1032173
Karluk,1934,0,,234,1032173
Karluk,1934,0,,235,1032173
Karluk,1934,0,,236,1032173
Karluk,1934,0,,237,1032173
Karluk,1934,0,,238,1032173
Karluk,1934,0,,239,1032173
Karluk,1934,0,,240,1032173
Karluk,1934,0,,241,1032173
Karluk,1934,0,,242,1032173
Karluk,1934,0,,243,1032173
Karluk,1934,0,,244,1032173
Karluk,1934,0,,245,1032173
Karluk,1934,0,,246,1032173
Karluk,1934,0,,247,1032173
Karluk,1934,0,,248,1032173
Karluk,1934,0,,249,1032173
Karluk,1934,0,,250,1032173
Karluk,1934,0,,251,1032173
Karluk,1934,0,,252,1032173
Karluk,1934,0,,253,1032173
Karluk,1934,0,,254,1032173
Karluk,1934,0,,255,1032173
Karluk,1934,0,,256,1032173
Karluk,1934,0,,257,1032173
Karluk,1934,0,,258,1032173
Karluk,1934,0,,259,1032173
Karluk,1934,0,,260,1032173
Karluk,1934,0,,261,1032173
Karluk,1934,0,,262,1032173
Karluk,1934,0,,263,1032173
Karluk,1934,0,,264,1032173
Karluk,1934,0,,265,1032173
Karluk,1934,0,,266,1032173
Karluk,1934,0,,267,1032173
Karluk,1934,0,,268,1032173
Karluk,1934,0,,269,1032173
Karluk,1934,0,,270,1032173
Karluk,1934,0,,271,1032173
Karluk,1934,0,,272,1032173
Karluk,1934,0,,273,1032173
Karluk,1934,0,,274,1032173
Karluk,1934,0,,275,1032173
Karluk,1934,0,,276,1032173
Karluk,1934,0,,277,1032173
Karluk,1934,0,,278,1032173
Karluk,1934,0,,279,1032173
Karluk,1934,0,,280,1032173
Karluk,1934,0,,281,1032173
Karluk,1934,0,,282,1032173
Karluk,1934,0,,283,1032173
Karluk,1934,0,,284,1032173
Karluk,1934,0,,285,1032173
Karluk,1933,0,,154,0
Karluk,1933,0,,155,0
Karluk,1933,0,,156,0
Karluk,1933,0,,157,0
Karluk,1933,0,,158,0
Karluk,1933,0,,159,0
Karluk,1933,0,,160,0
Karluk,1933,0,,161,0
Karluk,1933,0,,162,0
Karluk,1933,0,,163,0
Karluk,1933,0,,164,0
Karluk,1933,0,,165,0
Karluk,1933,0,,166,0
Karluk,1933,0,,167,0
Karluk,1933,0,,168,0
Karluk,1933,0,,169,0
Karluk,1933,0,,170,0
Karluk,1933,0,,171,0
Karluk,1933,0,,172,0
Karluk,1933,0,,173,0
Karluk,1933,0,,174,0
Karluk,1933,0,,175,0
Karluk,1933,0,,176,0
Karluk,1933,0,,177,0
Karluk,1933,0,,178,0
Karluk,1933,0,,179,0
Karluk,1933,0,,180,0
Karluk,1933,0,,181,0
Karluk,1933,0,,182,0
Karluk,1933,0,,183,0
Karluk,1933,0,,184,0
Karluk,1933,0,,185,0
Karluk,1933,0,,186,0
Karluk,1933,0,,187,0
Karluk,1933,0,,188,0
Karluk,1933,0,,189,0
Karluk,1933,0,,190,0
Karluk,1933,0,,191,0
Karluk,1933,0,,192,0
Karluk,1933,0,,193,0
Karluk,1933,0,,194,0
Karluk,1933,0,,195,0
Karluk,1933,0,,196,0
Karluk,1933,0,,197,0
Karluk,1933,0,,198,0
Karluk,1933,0,,199,0
Karluk,1933,0,,200,0
Karluk,1933,54,,201,54
Karluk,1933,30,,202,84
Karluk,1933,102,,203,186
Karluk,1933,42,,204,228
Karluk,1933,63,,205,291
Karluk,1933,303,,206,594
Karluk,1933,1551,,207,2145
Karluk,1933,1471,,208,3616
Karluk,1933,1314,,209,4930
Karluk,1933,629,,210,5559
Karluk,1933,2136,,211,7695
Karluk,1933,2830,,212,10525
Karluk,1933,833,,213,11358
Karluk,1933,1783,,214,13141
Karluk,1933,3577,,215,16718
Karluk,1933,4676,,216,21394
Karluk,1933,4817,,217,26211
Karluk,1933,3054,,218,29265
Karluk,1933,13486,,219,42751
Karluk,1933,2504,,220,45255
Karluk,1933,2004,,221,47259
Karluk,1933,444,,222,47703
Karluk,1933,483,,223,48186
Karluk,1933,1274,,224,49460
Karluk,1933,3395,,225,52855
Karluk,1933,661,,226,53516
Karluk,1933,1374,,227,54890
Karluk,1933,3048,,228,57938
Karluk,1933,5436,,229,63374
Karluk,1933,5433,,230,68807
Karluk,1933,1595,,231,70402
Karluk,1933,20627,,232,91029
Karluk,1933,6831,,233,97860
Karluk,1933,317,,234,98177
Karluk,1933,1102,,235,99279
Karluk,1933,2719,,236,101998
Karluk,1933,700,,237,102698
Karluk,1933,409,,238,103107
Karluk,1933,564,,239,103671
Karluk,1933,249,,240,103920
Karluk,1933,2500,,241,106420
Karluk,1933,216,,242,106636
Karluk,1933,142,,243,106778
Karluk,1933,88,,244,106866
Karluk,1933,32,,245,106898
Karluk,1933,297,,246,107195
Karluk,1933,348,,247,107543
Karluk,1933,14,,248,107557
Karluk,1933,106,,249,107663
Karluk,1933,0,,250,107663
Karluk,1933,0,,251,107663
Karluk,1933,0,,252,107663
Karluk,1933,0,,253,107663
Karluk,1933,0,,254,107663
Karluk,1933,0,,255,107663
Karluk,1933,0,,256,107663
Karluk,1933,0,,257,107663
Karluk,1933,0,,258,107663
Karluk,1933,0,,259,107663
Karluk,1933,0,,260,107663
Karluk,1933,0,,261,107663
Karluk,1933,0,,262,107663
Karluk,1933,0,,263,107663
Karluk,1933,0,,264,107663
Karluk,1933,0,,265,107663
Karluk,1933,0,,266,107663
Karluk,1933,0,,267,107663
Karluk,1933,0,,268,107663
Karluk,1933,0,,269,107663
Karluk,1933,0,,270,107663
Karluk,1933,0,,271,107663
Karluk,1933,0,,272,107663
Karluk,1933,0,,273,107663
Karluk,1933,0,,274,107663
Karluk,1933,0,,275,107663
Karluk,1933,0,,276,107663
Karluk,1933,0,,277,107663
Karluk,1933,0,,278,107663
Karluk,1933,0,,279,107663
Karluk,1933,0,,280,107663
Karluk,1933,0,,281,107663
Karluk,1933,0,,282,107663
Karluk,1933,0,,283,107663
Karluk,1933,0,,284,107663
Karluk,1933,0,,285,107663
Karluk,1932,0,,155,0
Karluk,1932,0,,156,0
Karluk,1932,0,,157,0
Karluk,1932,0,,158,0
Karluk,1932,0,,159,0
Karluk,1932,0,,160,0
Karluk,1932,0,,161,0
Karluk,1932,0,,162,0
Karluk,1932,0,,163,0
Karluk,1932,0,,164,0
Karluk,1932,0,,165,0
Karluk,1932,0,,166,0
Karluk,1932,0,,167,0
Karluk,1932,0,,168,0
Karluk,1932,0,,169,0
Karluk,1932,0,,170,0
Karluk,1932,0,,171,0
Karluk,1932,0,,172,0
Karluk,1932,0,,173,0
Karluk,1932,0,,174,0
Karluk,1932,0,,175,0
Karluk,1932,0,,176,0
Karluk,1932,0,,177,0
Karluk,1932,0,,178,0
Karluk,1932,0,,179,0
Karluk,1932,0,,180,0
Karluk,1932,0,,181,0
Karluk,1932,0,,182,0
Karluk,1932,0,,183,0
Karluk,1932,0,,184,0
Karluk,1932,0,,185,0
Karluk,1932,0,,186,0
Karluk,1932,0,,187,0
Karluk,1932,0,,188,0
Karluk,1932,0,,189,0
Karluk,1932,0,,190,0
Karluk,1932,0,,191,0
Karluk,1932,0,,192,0
Karluk,1932,0,,193,0
Karluk,1932,0,,194,0
Karluk,1932,0,,195,0
Karluk,1932,0,,196,0
Karluk,1932,0,,197,0
Karluk,1932,0,,198,0
Karluk,1932,0,,199,0
Karluk,1932,0,,200,0
Karluk,1932,0,,201,0
Karluk,1932,0,,202,0
Karluk,1932,622,,203,622
Karluk,1932,665,,204,1287
Karluk,1932,140,,205,1427
Karluk,1932,510,,206,1937
Karluk,1932,1173,,207,3110
Karluk,1932,3460,,208,6570
Karluk,1932,7940,,209,14510
Karluk,1932,3972,,210,18482
Karluk,1932,2387,,211,20869
Karluk,1932,4632,,212,25501
Karluk,1932,8689,,213,34190
Karluk,1932,16766,,214,50956
Karluk,1932,50446,,215,101402
Karluk,1932,48048,,216,149450
Karluk,1932,33238,,217,182688
Karluk,1932,24655,,218,207343
Karluk,1932,11339,,219,218682
Karluk,1932,49762,,220,268444
Karluk,1932,22527,,221,290971
Karluk,1932,48478,,222,339449
Karluk,1932,9720,,223,349169
Karluk,1932,8613,,224,357782
Karluk,1932,9613,,225,367395
Karluk,1932,40538,,226,407933
Karluk,1932,228238,,227,636171
Karluk,1932,100005,,228,736176
Karluk,1932,23128,,229,759304
Karluk,1932,3972,,230,763276
Karluk,1932,36845,,231,800121
Karluk,1932,75487,,232,875608
Karluk,1932,108406,,233,984014
Karluk,1932,22680,,234,1006694
Karluk,1932,22836,,235,1029530
Karluk,1932,1369,,236,1030899
Karluk,1932,30454,,237,1061353
Karluk,1932,24663,,238,1086016
Karluk,1932,65523,,239,1151539
Karluk,1932,137296,,240,1288835
Karluk,1932,30509,,241,1319344
Karluk,1932,29551,,242,1348895
Karluk,1932,18252,,243,1367147
Karluk,1932,27568,,244,1394715
Karluk,1932,3353,,245,1398068
Karluk,1932,10297,,246,1408365
Karluk,1932,5734,,247,1414099
Karluk,1932,1769,,248,1415868
Karluk,1932,1898,,249,1417766
Karluk,1932,526,,250,1418292
Karluk,1932,234,,251,1418526
Karluk,1932,314,,252,1418840
Karluk,1932,125,,253,1418965
Karluk,1932,179,,254,1419144
Karluk,1932,0,,255,1419144
Karluk,1932,0,,256,1419144
Karluk,1932,0,,257,1419144
Karluk,1932,0,,258,1419144
Karluk,1932,0,,259,1419144
Karluk,1932,0,,260,1419144
Karluk,1932,0,,261,1419144
Karluk,1932,0,,262,1419144
Karluk,1932,0,,263,1419144
Karluk,1932,0,,264,1419144
Karluk,1932,0,,265,1419144
Karluk,1932,0,,266,1419144
Karluk,1932,0,,267,1419144
Karluk,1932,0,,268,1419144
Karluk,1932,0,,269,1419144
Karluk,1932,0,,270,1419144
Karluk,1932,0,,271,1419144
Karluk,1932,0,,272,1419144
Karluk,1932,0,,273,1419144
Karluk,1932,0,,274,1419144
Karluk,1932,0,,275,1419144
Karluk,1932,0,,276,1419144
Karluk,1932,0,,277,1419144
Karluk,1932,0,,278,1419144
Karluk,1932,0,,279,1419144
Karluk,1932,0,,280,1419144
Karluk,1932,0,,281,1419144
Karluk,1932,0,,282,1419144
Karluk,1932,0,,283,1419144
Karluk,1932,0,,284,1419144
Karluk,1932,0,,285,1419144
Karluk,1932,0,,286,1419144
Karluk,1931,0,,154,0
Karluk,1931,0,,155,0
Karluk,1931,0,,156,0
Karluk,1931,0,,157,0
Karluk,1931,0,,158,0
Karluk,1931,0,,159,0
Karluk,1931,0,,160,0
Karluk,1931,0,,161,0
Karluk,1931,0,,162,0
Karluk,1931,0,,163,0
Karluk,1931,0,,164,0
Karluk,1931,0,,165,0
Karluk,1931,0,,166,0
Karluk,1931,0,,167,0
Karluk,1931,0,,168,0
Karluk,1931,0,,169,0
Karluk,1931,0,,170,0
Karluk,1931,0,,171,0
Karluk,1931,0,,172,0
Karluk,1931,0,,173,0
Karluk,1931,0,,174,0
Karluk,1931,0,,175,0
Karluk,1931,0,,176,0
Karluk,1931,0,,177,0
Karluk,1931,0,,178,0
Karluk,1931,0,,179,0
Karluk,1931,0,,180,0
Karluk,1931,0,,181,0
Karluk,1931,0,,182,0
Karluk,1931,0,,183,0
Karluk,1931,0,,184,0
Karluk,1931,0,,185,0
Karluk,1931,0,,186,0
Karluk,1931,0,,187,0
Karluk,1931,0,,188,0
Karluk,1931,0,,189,0
Karluk,1931,0,,190,0
Karluk,1931,0,,191,0
Karluk,1931,0,,192,0
Karluk,1931,0,,193,0
Karluk,1931,0,,194,0
Karluk,1931,0,,195,0
Karluk,1931,0,,196,0
Karluk,1931,0,,197,0
Karluk,1931,0,,198,0
Karluk,1931,0,,199,0
Karluk,1931,0,,200,0
Karluk,1931,0,,201,0
Karluk,1931,0,,202,0
Karluk,1931,0,,203,0
Karluk,1931,0,,204,0
Karluk,1931,0,,205,0
Karluk,1931,0,,206,0
Karluk,1931,0,,207,0
Karluk,1931,0,,208,0
Karluk,1931,0,,209,0
Karluk,1931,0,,210,0
Karluk,1931,0,,211,0
Karluk,1931,0,,212,0
Karluk,1931,0,,213,0
Karluk,1931,0,,214,0
Karluk,1931,0,,215,0
Karluk,1931,0,,216,0
Karluk,1931,97,,217,97
Karluk,1931,365,,218,462
Karluk,1931,1544,,219,2006
Karluk,1931,3754,,220,5760
Karluk,1931,2567,,221,8327
Karluk,1931,2157,,222,10484
Karluk,1931,2803,,223,13287
Karluk,1931,2851,,224,16138
Karluk,1931,736,,225,16874
Karluk,1931,300,,226,17174
Karluk,1931,1401,,227,18575
Karluk,1931,1030,,228,19605
Karluk,1931,293,,229,19898
Karluk,1931,508,,230,20406
Karluk,1931,167,,231,20573
Karluk,1931,445,,232,21018
Karluk,1931,1429,,233,22447
Karluk,1931,1138,,234,23585
Karluk,1931,418,,235,24003
Karluk,1931,250,,236,24253
Karluk,1931,0,,237,24253
Karluk,1931,4683,,238,28936
Karluk,1931,7061,,239,35997
Karluk,1931,2605,,240,38602
Karluk,1931,357,,241,38959
Karluk,1931,225,,242,39184
Karluk,1931,2132,,243,41316
Karluk,1931,3013,,244,44329
Karluk,1931,904,,245,45233
Karluk,1931,128,,246,45361
Karluk,1931,110,,247,45471
Karluk,1931,25,,248,45496
Karluk,1931,0,,249,45496
Karluk,1931,0,,250,45496
Karluk,1931,0,,251,45496
Karluk,1931,0,,252,45496
Karluk,1931,0,,253,45496
Karluk,1931,0,,254,45496
Karluk,1931,0,,255,45496
Karluk,1931,0,,256,45496
Karluk,1931,0,,257,45496
Karluk,1931,0,,258,45496
Karluk,1931,0,,259,45496
Karluk,1931,0,,260,45496
Karluk,1931,0,,261,45496
Karluk,1931,0,,262,45496
Karluk,1931,0,,263,45496
Karluk,1931,0,,264,45496
Karluk,1931,0,,265,45496
Karluk,1931,0,,266,45496
Karluk,1931,0,,267,45496
Karluk,1931,0,,268,45496
Karluk,1931,0,,269,45496
Karluk,1931,0,,270,45496
Karluk,1931,0,,271,45496
Karluk,1931,0,,272,45496
Karluk,1931,0,,273,45496
Karluk,1931,0,,274,45496
Karluk,1931,0,,275,45496
Karluk,1931,0,,276,45496
Karluk,1931,0,,277,45496
Karluk,1931,0,,278,45496
Karluk,1931,0,,279,45496
Karluk,1931,0,,280,45496
Karluk,1931,0,,281,45496
Karluk,1931,0,,282,45496
Karluk,1931,0,,283,45496
Karluk,1931,0,,284,45496
Karluk,1931,0,,285,45496
Karluk,1930,0,,154,0
Karluk,1930,0,,155,0
Karluk,1930,0,,156,0
Karluk,1930,0,,157,0
Karluk,1930,0,,158,0
Karluk,1930,0,,159,0
Karluk,1930,0,,160,0
Karluk,1930,0,,161,0
Karluk,1930,0,,162,0
Karluk,1930,0,,163,0
Karluk,1930,0,,164,0
Karluk,1930,0,,165,0
Karluk,1930,0,,166,0
Karluk,1930,0,,167,0
Karluk,1930,0,,168,0
Karluk,1930,0,,169,0
Karluk,1930,0,,170,0
Karluk,1930,0,,171,0
Karluk,1930,0,,172,0
Karluk,1930,0,,173,0
Karluk,1930,0,,174,0
Karluk,1930,0,,175,0
Karluk,1930,0,,176,0
Karluk,1930,0,,177,0
Karluk,1930,0,,178,0
Karluk,1930,0,,179,0
Karluk,1930,0,,180,0
Karluk,1930,0,,181,0
Karluk,1930,0,,182,0
Karluk,1930,0,,183,0
Karluk,1930,0,,184,0
Karluk,1930,0,,185,0
Karluk,1930,0,,186,0
Karluk,1930,0,,187,0
Karluk,1930,0,,188,0
Karluk,1930,0,,189,0
Karluk,1930,0,,190,0
Karluk,1930,0,,191,0
Karluk,1930,0,,192,0
Karluk,1930,0,,193,0
Karluk,1930,0,,194,0
Karluk,1930,0,,195,0
Karluk,1930,26,,196,26
Karluk,1930,17,,197,43
Karluk,1930,9,,198,52
Karluk,1930,21,,199,73
Karluk,1930,38,,200,111
Karluk,1930,70,,201,181
Karluk,1930,93,,202,274
Karluk,1930,72,,203,346
Karluk,1930,29,,204,375
Karluk,1930,325,,205,700
Karluk,1930,663,,206,1363
Karluk,1930,178,,207,1541
Karluk,1930,154,,208,1695
Karluk,1930,64,,209,1759
Karluk,1930,2019,,210,3778
Karluk,1930,3040,,211,6818
Karluk,1930,7365,,212,14183
Karluk,1930,7846,,213,22029
Karluk,1930,4920,,214,26949
Karluk,1930,6394,,215,33343
Karluk,1930,4186,,216,37529
Karluk,1930,1271,,217,38800
Karluk,1930,1650,,218,40450
Karluk,1930,1549,,219,41999
Karluk,1930,3605,,220,45604
Karluk,1930,9279,,221,54883
Karluk,1930,4415,,222,59298
Karluk,1930,3178,,223,62476
Karluk,1930,1457,,224,63933
Karluk,1930,6641,,225,70574
Karluk,1930,5872,,226,76446
Karluk,1930,4458,,227,80904
Karluk,1930,6196,,228,87100
Karluk,1930,11595,,229,98695
Karluk,1930,4204,,230,102899
Karluk,1930,2436,,231,105335
Karluk,1930,2967,,232,108302
Karluk,1930,3769,,233,112071
Karluk,1930,2610,,234,114681
Karluk,1930,1649,,235,116330
Karluk,1930,0,,236,116330
Karluk,1930,0,,237,116330
Karluk,1930,0,,238,116330
Karluk,1930,0,,239,116330
Karluk,1930,0,,240,116330
Karluk,1930,0,,241,116330
Karluk,1930,0,,242,116330
Karluk,1930,0,,243,116330
Karluk,1930,0,,244,116330
Karluk,1930,0,,245,116330
Karluk,1930,0,,246,116330
Karluk,1930,0,,247,116330
Karluk,1930,0,,248,116330
Karluk,1930,0,,249,116330
Karluk,1930,0,,250,116330
Karluk,1930,0,,251,116330
Karluk,1930,0,,252,116330
Karluk,1930,0,,253,116330
Karluk,1930,0,,254,116330
Karluk,1930,0,,255,116330
Karluk,1930,0,,256,116330
Karluk,1930,0,,257,116330
Karluk,1930,0,,258,116330
Karluk,1930,0,,259,116330
Karluk,1930,0,,260,116330
Karluk,1930,0,,261,116330
Karluk,1930,0,,262,116330
Karluk,1930,0,,263,116330
Karluk,1930,0,,264,116330
Karluk,1930,0,,265,116330
Karluk,1930,0,,266,116330
Karluk,1930,0,,267,116330
Karluk,1930,0,,268,116330
Karluk,1930,0,,269,116330
Karluk,1930,0,,270,116330
Karluk,1930,0,,271,116330
Karluk,1930,0,,272,116330
Karluk,1930,0,,273,116330
Karluk,1930,0,,274,116330
Karluk,1930,0,,275,116330
Karluk,1930,0,,276,116330
Karluk,1930,0,,277,116330
Karluk,1930,0,,278,116330
Karluk,1930,0,,279,116330
Karluk,1930,0,,280,116330
Karluk,1930,0,,281,116330
Karluk,1930,0,,282,116330
Karluk,1930,0,,283,116330
Karluk,1930,0,,284,116330
Karluk,1930,0,,285,116330
Karluk,1929,0,,154,0
Karluk,1929,0,,155,0
Karluk,1929,0,,156,0
Karluk,1929,0,,157,0
Karluk,1929,0,,158,0
Karluk,1929,0,,159,0
Karluk,1929,0,,160,0
Karluk,1929,0,,161,0
Karluk,1929,0,,162,0
Karluk,1929,0,,163,0
Karluk,1929,0,,164,0
Karluk,1929,0,,165,0
Karluk,1929,0,,166,0
Karluk,1929,0,,167,0
Karluk,1929,0,,168,0
Karluk,1929,0,,169,0
Karluk,1929,0,,170,0
Karluk,1929,0,,171,0
Karluk,1929,0,,172,0
Karluk,1929,0,,173,0
Karluk,1929,0,,174,0
Karluk,1929,0,,175,0
Karluk,1929,0,,176,0
Karluk,1929,0,,177,0
Karluk,1929,0,,178,0
Karluk,1929,0,,179,0
Karluk,1929,0,,180,0
Karluk,1929,0,,181,0
Karluk,1929,0,,182,0
Karluk,1929,0,,183,0
Karluk,1929,0,,184,0
Karluk,1929,0,,185,0
Karluk,1929,0,,186,0
Karluk,1929,0,,187,0
Karluk,1929,0,,188,0
Karluk,1929,0,,189,0
Karluk,1929,0,,190,0
Karluk,1929,0,,191,0
Karluk,1929,0,,192,0
Karluk,1929,0,,193,0
Karluk,1929,0,,194,0
Karluk,1929,0,,195,0
Karluk,1929,0,,196,0
Karluk,1929,57,,197,57
Karluk,1929,60,,198,117
Karluk,1929,43,,199,160
Karluk,1929,31,,200,191
Karluk,1929,0,,201,191
Karluk,1929,0,,202,191
Karluk,1929,2,,203,193
Karluk,1929,2,,204,195
Karluk,1929,4,,205,199
Karluk,1929,215,,206,414
Karluk,1929,71,,207,485
Karluk,1929,161,,208,646
Karluk,1929,136,,209,782
Karluk,1929,228,,210,1010
Karluk,1929,719,,211,1729
Karluk,1929,1680,,212,3409
Karluk,1929,1876,,213,5285
Karluk,1929,953,,214,6238
Karluk,1929,560,,215,6798
Karluk,1929,968,,216,7766
Karluk,1929,306,,217,8072
Karluk,1929,176,,218,8248
Karluk,1929,723,,219,8971
Karluk,1929,44,,220,9015
Karluk,1929,79,,221,9094
Karluk,1929,713,,222,9807
Karluk,1929,408,,223,10215
Karluk,1929,273,,224,10488
Karluk,1929,217,,225,10705
Karluk,1929,26,,226,10731
Karluk,1929,268,,227,10999
Karluk,1929,154,,228,11153
Karluk,1929,210,,229,11363
Karluk,1929,0,,230,11363
Karluk,1929,0,,231,11363
Karluk,1929,0,,232,11363
Karluk,1929,0,,233,11363
Karluk,1929,0,,234,11363
Karluk,1929,0,,235,11363
Karluk,1929,0,,236,11363
Karluk,1929,0,,237,11363
Karluk,1929,0,,238,11363
Karluk,1929,0,,239,11363
Karluk,1929,0,,240,11363
Karluk,1929,0,,241,11363
Karluk,1929,0,,242,11363
Karluk,1929,0,,243,11363
Karluk,1929,0,,244,11363
Karluk,1929,0,,245,11363
Karluk,1929,0,,246,11363
Karluk,1929,0,,247,11363
Karluk,1929,0,,248,11363
Karluk,1929,0,,249,11363
Karluk,1929,0,,250,11363
Karluk,1929,0,,251,11363
Karluk,1929,0,,252,11363
Karluk,1929,0,,253,11363
Karluk,1929,0,,254,11363
Karluk,1929,0,,255,11363
Karluk,1929,0,,256,11363
Karluk,1929,0,,257,11363
Karluk,1929,0,,258,11363
Karluk,1929,0,,259,11363
Karluk,1929,0,,260,11363
Karluk,1929,0,,261,11363
Karluk,1929,0,,262,11363
Karluk,1929,0,,263,11363
Karluk,1929,0,,264,11363
Karluk,1929,0,,265,11363
Karluk,1929,0,,266,11363
Karluk,1929,0,,267,11363
Karluk,1929,0,,268,11363
Karluk,1929,0,,269,11363
Karluk,1929,0,,270,11363
Karluk,1929,0,,271,11363
Karluk,1929,0,,272,11363
Karluk,1929,0,,273,11363
Karluk,1929,0,,274,11363
Karluk,1929,0,,275,11363
Karluk,1929,0,,276,11363
Karluk,1929,0,,277,11363
Karluk,1929,0,,278,11363
Karluk,1929,0,,279,11363
Karluk,1929,0,,280,11363
Karluk,1929,0,,281,11363
Karluk,1929,0,,282,11363
Karluk,1929,0,,283,11363
Karluk,1929,0,,284,11363
Karluk,1929,0,,285,11363
Karluk,1928,0,,155,0
Karluk,1928,0,,156,0
Karluk,1928,0,,157,0
Karluk,1928,0,,158,0
Karluk,1928,0,,159,0
Karluk,1928,0,,160,0
Karluk,1928,0,,161,0
Karluk,1928,0,,162,0
Karluk,1928,0,,163,0
Karluk,1928,0,,164,0
Karluk,1928,0,,165,0
Karluk,1928,0,,166,0
Karluk,1928,0,,167,0
Karluk,1928,0,,168,0
Karluk,1928,0,,169,0
Karluk,1928,0,,170,0
Karluk,1928,0,,171,0
Karluk,1928,0,,172,0
Karluk,1928,0,,173,0
Karluk,1928,0,,174,0
Karluk,1928,0,,175,0
Karluk,1928,0,,176,0
Karluk,1928,0,,177,0
Karluk,1928,0,,178,0
Karluk,1928,0,,179,0
Karluk,1928,0,,180,0
Karluk,1928,0,,181,0
Karluk,1928,0,,182,0
Karluk,1928,0,,183,0
Karluk,1928,0,,184,0
Karluk,1928,0,,185,0
Karluk,1928,0,,186,0
Karluk,1928,0,,187,0
Karluk,1928,0,,188,0
Karluk,1928,0,,189,0
Karluk,1928,0,,190,0
Karluk,1928,0,,191,0
Karluk,1928,0,,192,0
Karluk,1928,0,,193,0
Karluk,1928,0,,194,0
Karluk,1928,0,,195,0
Karluk,1928,0,,196,0
Karluk,1928,0,,197,0
Karluk,1928,0,,198,0
Karluk,1928,0,,199,0
Karluk,1928,0,,200,0
Karluk,1928,0,,201,0
Karluk,1928,0,,202,0
Karluk,1928,0,,203,0
Karluk,1928,0,,204,0
Karluk,1928,0,,205,0
Karluk,1928,0,,206,0
Karluk,1928,0,,207,0
Karluk,1928,0,,208,0
Karluk,1928,0,,209,0
Karluk,1928,0,,210,0
Karluk,1928,0,,211,0
Karluk,1928,0,,212,0
Karluk,1928,0,,213,0
Karluk,1928,0,,214,0
Karluk,1928,0,,215,0
Karluk,1928,0,,216,0
Karluk,1928,0,,217,0
Karluk,1928,472,,218,472
Karluk,1928,64,,219,536
Karluk,1928,37,,220,573
Karluk,1928,266,,221,839
Karluk,1928,182,,222,1021
Karluk,1928,85,,223,1106
Karluk,1928,42,,224,1148
Karluk,1928,55,,225,1203
Karluk,1928,0,,226,1203
Karluk,1928,0,,227,1203
Karluk,1928,0,,228,1203
Karluk,1928,0,,229,1203
Karluk,1928,0,,230,1203
Karluk,1928,0,,231,1203
Karluk,1928,0,,232,1203
Karluk,1928,0,,233,1203
Karluk,1928,0,,234,1203
Karluk,1928,0,,235,1203
Karluk,1928,0,,236,1203
Karluk,1928,0,,237,1203
Karluk,1928,0,,238,1203
Karluk,1928,0,,239,1203
Karluk,1928,0,,240,1203
Karluk,1928,0,,241,1203
Karluk,1928,0,,242,1203
Karluk,1928,0,,243,1203
Karluk,1928,0,,244,1203
Karluk,1928,0,,245,1203
Karluk,1928,0,,246,1203
Karluk,1928,0,,247,1203
Karluk,1928,0,,248,1203
Karluk,1928,0,,249,1203
Karluk,1928,0,,250,1203
Karluk,1928,0,,251,1203
Karluk,1928,0,,252,1203
Karluk,1928,0,,253,1203
Karluk,1928,0,,254,1203
Karluk,1928,0,,255,1203
Karluk,1928,0,,256,1203
Karluk,1928,113,,257,1316
Karluk,1928,106,,258,1422
Karluk,1928,976,,259,2398
Karluk,1928,574,,260,2972
Karluk,1928,92,,261,3064
Karluk,1928,28,,262,3092
Karluk,1928,40,,263,3132
Karluk,1928,25,,264,3157
Karluk,1928,13,,265,3170
Karluk,1928,816,,266,3986
Karluk,1928,528,,267,4514
Karluk,1928,158,,268,4672
Karluk,1928,5,,269,4677
Karluk,1928,0,,270,4677
Karluk,1928,0,,271,4677
Karluk,1928,0,,272,4677
Karluk,1928,0,,273,4677
Karluk,1928,0,,274,4677
Karluk,1928,0,,275,4677
Karluk,1928,0,,276,4677
Karluk,1928,0,,277,4677
Karluk,1928,0,,278,4677
Karluk,1928,0,,279,4677
Karluk,1928,0,,280,4677
Karluk,1928,0,,281,4677
Karluk,1928,0,,282,4677
Karluk,1928,0,,283,4677
Karluk,1928,0,,284,4677
Karluk,1928,0,,285,4677
Karluk,1928,0,,286,4677
Afognak River (Litnik),2015,7,,185,7
Afognak River (Litnik),2015,0,,186,7
Afognak River (Litnik),2015,1,,187,8
Afognak River (Litnik),2015,18,,188,26
Afognak River (Litnik),2015,1,,189,27
Afognak River (Litnik),2015,0,,190,27
Afognak River (Litnik),2015,6,,191,33
Afognak River (Litnik),2015,0,,192,33
Afognak River (Litnik),2015,1,,193,34
Afognak River (Litnik),2015,13,,194,47
Afognak River (Litnik),2015,0,,195,47
Afognak River (Litnik),2015,0,,196,47
Afognak River (Litnik),2015,100,,197,147
Afognak River (Litnik),2015,58,,198,205
Afognak River (Litnik),2015,0,,199,205
Afognak River (Litnik),2015,7,,200,212
Afognak River (Litnik),2015,0,,201,212
Afognak River (Litnik),2015,12,,202,224
Afognak River (Litnik),2015,8,,203,232
Afognak River (Litnik),2015,686,,204,918
Afognak River (Litnik),2015,127,,205,1045
Afognak River (Litnik),2015,101,,206,1146
Afognak River (Litnik),2015,30,,207,1176
Afognak River (Litnik),2015,39,,208,1215
Afognak River (Litnik),2015,60,,209,1275
Afognak River (Litnik),2015,21,,210,1296
Afognak River (Litnik),2015,9,,212,1305
Afognak River (Litnik),2015,2,,213,1307
Afognak River (Litnik),2015,7,,214,1314
Afognak River (Litnik),2015,26,,215,1340
Afognak River (Litnik),2015,452,,216,1792
Afognak River (Litnik),2015,8,,217,1800
Afognak River (Litnik),2015,25,,218,1825
Afognak River (Litnik),2015,29,,219,1854
Afognak River (Litnik),2015,29,,220,1883
Afognak River (Litnik),2015,360,,221,2243
Afognak River (Litnik),2015,63,,222,2306
Afognak River (Litnik),2015,95,,223,2401
Afognak River (Litnik),2015,13,,224,2414
Afognak River (Litnik),2015,49,,225,2463
Afognak River (Litnik),2015,92,,226,2555
Afognak River (Litnik),2015,368,,227,2923
Afognak River (Litnik),2015,193,,228,3116
Ayakulik River,2015,24,,185,3140
Ayakulik River,2015,26,,186,3166
Ayakulik River,2015,49,,187,3215
Ayakulik River,2015,4,,188,3219
Ayakulik River,2015,75,,189,3294
Ayakulik River,2015,35,,190,3329
Ayakulik River,2015,52,,191,3381
Ayakulik River,2015,820,,192,4201
Ayakulik River,2015,175,,193,4376
Ayakulik River,2015,366,,194,4742
Ayakulik River,2015,24,,195,4766
Ayakulik River,2015,29,,196,4795
Ayakulik River,2015,68,,197,4863
Ayakulik River,2015,265,,198,5128
Ayakulik River,2015,197,,199,5325
Ayakulik River,2015,228,,200,5553
Ayakulik River,2015,550,,201,6103
Ayakulik River,2015,1559,,202,7662
Ayakulik River,2015,229,,203,7891
Ayakulik River,2015,343,,204,8234
Ayakulik River,2015,161,,205,8395
Ayakulik River,2015,592,,206,8987
Ayakulik River,2015,382,,207,9369
Ayakulik River,2015,427,,208,9796
Ayakulik River,2015,815,,209,10611
Ayakulik River,2015,1079,,210,11690
Ayakulik River,2015,1418,,211,13108
Ayakulik River,2015,1667,,212,14775
Ayakulik River,2015,2325,,213,17100
Ayakulik River,2015,3341,,214,20441
Ayakulik River,2015,1885,,215,22326
Ayakulik River,2015,1640,,216,23966
Ayakulik River,2015,1506,,217,25472
Ayakulik River,2015,831,,218,26303
Ayakulik River,2015,1570,,219,27873
Ayakulik River,2015,1066,,220,28939
Ayakulik River,2015,1270,,221,30209
Ayakulik River,2015,1442,,222,31651
Ayakulik River,2015,2961,,223,34612
Ayakulik River,2015,1958,,224,36570
Ayakulik River,2015,5360,,225,41930
Ayakulik River,2015,4798,,226,46728
Ayakulik River,2015,3941,,227,50669
Ayakulik River,2015,2521,,228,53190
Ayakulik River,2015,2500,,229,55690
Ayakulik River,2015,500,,230,56190
Ayakulik River,2015,100,,231,56290
Ayakulik River,2015,5005,,232,61295
Ayakulik River,2015,4494,,233,65789
Ayakulik River,2015,1213,,234,67002
Ayakulik River,2015,1551,,235,68553
Ayakulik River,2015,1014,,236,69567
Bear River,2015,1,,182,1
Bear River,2015,3,,183,4
Bear River,2015,3,,184,7
Bear River,2015,3,,185,10
Bear River,2015,0,,186,10
Bear River,2015,0,,187,10
Bear River,2015,0,,188,10
Bear River,2015,2,,189,12
Bear River,2015,3,,190,15
Bear River,2015,21,,191,36
Bear River,2015,8,,192,44
Bear River,2015,13,,193,57
Bear River,2015,7,,194,64
Bear River,2015,13,,195,77
Bear River,2015,11,,196,88
Bear River,2015,11,,197,99
Bear River,2015,10,,198,109
Bear River,2015,9,,199,118
Bear River,2015,12,,200,130
Bear River,2015,5,,201,135
Bear River,2015,7,,202,142
Bear River,2015,1,,203,143
Bear River,2015,6,,204,149
Bear River,2015,35,,205,184
Bear River,2015,51,,206,235
Bear River,2015,18,,207,253
Bear River,2015,13,,208,266
Bear River,2015,23,,209,289
Bear River,2015,136,,210,425
Bear River,2015,28,,211,453
Bear River,2015,13,,212,466
Bear River,2015,29,,213,495
Bear River,2015,2,,214,497
Bear River,2015,140,,215,637
Bear River,2015,154,,216,791
Bear River,2015,70,,217,861
Bear River,2015,86,,218,947
Bear River,2015,207,,219,1154
Bear River,2015,269,,220,1423
Bear River,2015,130,,221,1553
Bear River,2015,40,,222,1593
Bear River,2015,152,,223,1745
Bear River,2015,189,,224,1934
Bear River,2015,137,,225,2071
Bear River,2015,144,,226,2215
Bear River,2015,163,,227,2378
Bear River,2015,277,,228,2655
Bear River,2015,334,,229,2989
Bear River,2015,224,,230,3213
Bear River,2015,270,,231,3483
Bear River,2015,474,,232,3957
Bear River,2015,265,,233,4222
Bear River,2015,208,,234,4430
Bear River,2015,182,,235,4612
Bear River,2015,478,,236,5090
Buskin River,2015,3,,191,3
Buskin River,2015,0,,192,3
Buskin River,2015,1,,193,4
Buskin River,2015,0,,194,4
Buskin River,2015,0,,195,4
Buskin River,2015,9,,196,13
Buskin River,2015,14,,197,27
Buskin River,2015,2,,198,29
Buskin River,2015,0,,199,29
Buskin River,2015,22,,200,51
Buskin River,2015,4,,201,55
Buskin River,2015,13,,202,68
Buskin River,2015,42,,203,110
Buskin River,2015,0,,204,110
Buskin River,2015,3,,205,113
Buskin River,2015,2,,206,115
Buskin River,2015,42,,207,157
Buskin River,2015,2,,208,159
Buskin River,2015,103,,209,262
Buskin River,2015,10,,211,272
Buskin River,2015,21,,212,293
Buskin River,2015,15,,213,308
Buskin River,2015,20,,214,328
Buskin River,2015,71,,215,399
Buskin River,2015,680,,216,1079
Buskin River,2015,186,,217,1265
Buskin River,2015,55,,218,1320
Buskin River,2015,176,,219,1496
Buskin River,2015,36,,220,1532
Buskin River,2015,164,,221,1696
Buskin River,2015,2,,222,1698
Buskin River,2015,462,,223,2160
Buskin River,2015,29851,,224,32011
Buskin River,2015,267,,225,32278
Buskin River,2015,975,,226,33253
Buskin River,2015,635,,227,33888
Buskin River,2015,242,,228,34130
Buskin River,2015,772,,229,34902
Buskin River,2015,225,,230,35127
Buskin River,2015,48,,231,35175
Buskin River,2015,143,,232,35318
Buskin River,2015,71,,233,35389
Buskin River,2015,62,,234,35451
Buskin River,2015,116,,235,35567
Buskin River,2015,241,,236,35808
Buskin River,2015,691,,237,36499
Buskin River,2015,995,,238,37494
Buskin River,2015,1389,,239,38883
Buskin River,2015,473,,240,39356
Buskin River,2015,1618,,241,40974
Buskin River,2015,721,,242,41695
Buskin River,2015,873,,243,42568
Buskin River,2015,1024,,244,43592
Buskin River,2015,890,,245,44482
Chignik River,2015,12,,189,12
Chignik River,2015,0,,190,12
Chignik River,2015,0,,191,12
Chignik River,2015,0,,192,12
Chignik River,2015,6,,193,18
Chignik River,2015,36,,194,54
Chignik River,2015,0,,195,54
Chignik River,2015,0,,196,54
Chignik River,2015,0,,197,54
Chignik River,2015,0,,198,54
Chignik River,2015,0,,199,54
Chignik River,2015,6,,200,60
Chignik River,2015,0,,201,60
Chignik River,2015,0,,202,60
Chignik River,2015,0,,203,60
Chignik River,2015,12,,204,72
Chignik River,2015,6,,205,78
Chignik River,2015,0,,206,78
Chignik River,2015,67,,207,145
Chignik River,2015,42,,208,187
Chignik River,2015,77,,209,264
Chignik River,2015,119,,210,383
Chignik River,2015,49,,211,432
Chignik River,2015,30,,212,462
Chignik River,2015,108,,213,570
Chignik River,2015,151,,214,721
Chignik River,2015,114,,215,835
Chignik River,2015,534,,216,1369
Chignik River,2015,150,,217,1519
Chignik River,2015,150,,218,1669
Chignik River,2015,217,,219,1886
Chignik River,2015,300,,220,2186
Chignik River,2015,224,,221,2410
Chignik River,2015,144,,222,2554
Chignik River,2015,180,,223,2734
Chignik River,2015,288,,224,3022
Chignik River,2015,116,,225,3138
Chignik River,2015,150,,226,3288
Chignik River,2015,240,,227,3528
Chignik River,2015,194,,228,3722
Chignik River,2015,246,,229,3968
Chignik River,2015,121,,230,4089
Chignik River,2015,84,,231,4173
Chignik River,2015,96,,232,4269
Chignik River,2015,71,,233,4340
Chignik River,2015,266,,234,4606
Chignik River,2015,359,,235,4965
Chignik River,2015,341,,236,5306
Chignik River,2015,0,,237,5306
Chignik River,2015,0,,239,5306
Chignik River,2015,0,,240,5306
Chignik River,2015,0,,241,5306
Chignik River,2015,0,,242,5306
Chignik River,2015,0,,243,5306
Coghill River,2015,2,,168,2
Coghill River,2015,2,,169,4
Coghill River,2015,4,,170,8
Coghill River,2015,5,,171,13
Coghill River,2015,5,,172,18
Coghill River,2015,3,,175,21
Coghill River,2015,9,,176,30
Coghill River,2015,5,,178,35
Coghill River,2015,6,,179,41
Coghill River,2015,9,,182,50
Coghill River,2015,26,,183,76
Coghill River,2015,1346,,184,1422
Coghill River,2015,4470,,185,5892
Coghill River,2015,2149,,186,8041
Coghill River,2015,794,,187,8835
Coghill River,2015,10149,,188,18984
Coghill River,2015,9873,,189,28857
Coghill River,2015,10455,,190,39312
Coghill River,2015,12457,,191,51769
Coghill River,2015,13496,,192,65265
Coghill River,2015,18561,,193,83826
Coghill River,2015,15156,,194,98982
Coghill River,2015,5180,,195,104162
Coghill River,2015,8337,,196,112499
Coghill River,2015,22199,,197,134698
Coghill River,2015,37742,,201,172440
Coghill River,2015,20799,,202,193239
Coghill River,2015,46264,,203,239503
Coghill River,2015,31703,,205,271206
Coghill River,2015,33390,,206,304596
Coghill River,2015,53810,Weir removed,207,358406
Deshka,2015,5,,311,5
Deshka,2015,4,,341,9
Deshka,2015,3,,182,12
Deshka,2015,10,,182,22
Deshka,2015,2,,182,24
Deshka,2015,9,,183,33
Deshka,2015,19,,182,52
Deshka,2015,18,,182,70
Deshka,2015,45,,182,115
Deshka,2015,87,,183,202
Deshka,2015,29,,182,231
Deshka,2015,39,,182,270
Deshka,2015,249,,182,519
Deshka,2015,167,,183,686
Deshka,2015,48,,182,734
Deshka,2015,642,,182,1376
Deshka,2015,84,,182,1460
Deshka,2015,228,,183,1688
Deshka,2015,428,,182,2116
Deshka,2015,1264,,182,3380
Deshka,2015,491,,182,3871
Deshka,2015,323,,8,4194
Deshka,2015,134,,39,4328
Deshka,2015,72,,67,4400
Deshka,2015,51,,98,4451
Deshka,2015,95,,128,4546
Deshka,2015,171,,159,4717
Deshka,2015,144,,189,4861
Deshka,2015,51,,220,4912
Deshka,2015,151,,251,5063
Deshka,2015,327,,281,5390
Deshka,2015,482,,312,5872
Deshka,2015,57,,342,5929
Deshka,2015,31,,213,5960
Deshka,2015,75,,213,6035
Deshka,2015,34,,213,6069
Deshka,2015,63,,214,6132
Deshka,2015,57,,213,6189
Deshka,2015,64,,213,6253
Deshka,2015,23,,213,6276
Deshka,2015,8,,214,6284
Deshka,2015,16,,213,6300
Deshka,2015,8,,213,6308
Deshka,2015,7,,213,6315
Deshka,2015,4,,214,6319
Deshka,2015,3,,213,6322
Deshka,2015,2,,213,6324
Deshka,2015,2,,213,6326
Dog Salmon River,2015,0,,170,0
Dog Salmon River,2015,7,,171,7
Dog Salmon River,2015,5,,172,12
Dog Salmon River,2015,20,,173,32
Dog Salmon River,2015,9,,174,41
Dog Salmon River,2015,10,,175,51
Dog Salmon River,2015,18,,176,69
Dog Salmon River,2015,88,,177,157
Dog Salmon River,2015,49,,178,206
Dog Salmon River,2015,49,,179,255
Dog Salmon River,2015,29,,180,284
Dog Salmon River,2015,86,,181,370
Dog Salmon River,2015,51,,182,421
Dog Salmon River,2015,188,,183,609
Dog Salmon River,2015,579,,184,1188
Dog Salmon River,2015,1047,,185,2235
Dog Salmon River,2015,1238,,186,3473
Dog Salmon River,2015,4484,,187,7957
Dog Salmon River,2015,5267,,188,13224
Dog Salmon River,2015,4902,,189,18126
Dog Salmon River,2015,6113,,190,24239
Dog Salmon River,2015,12859,,191,37098
Dog Salmon River,2015,12597,,192,49695
Dog Salmon River,2015,8909,,193,58604
Dog Salmon River,2015,11188,,194,69792
Dog Salmon River,2015,12135,,195,81927
Dog Salmon River,2015,13399,,196,95326
Dog Salmon River,2015,5158,,197,100484
Dog Salmon River,2015,2459,,198,102943
Dog Salmon River,2015,5582,,199,108525
Dog Salmon River,2015,16328,,200,124853
Dog Salmon River,2015,17945,,201,142798
Dog Salmon River,2015,12333,,202,155131
Dog Salmon River,2015,12493,,203,167624
Dog Salmon River,2015,8162,,204,175786
Dog Salmon River,2015,4119,,205,179905
Dog Salmon River,2015,5094,,206,184999
Dog Salmon River,2015,3940,,207,188939
Dog Salmon River,2015,4109,,208,193048
Dog Salmon River,2015,2028,,209,195076
Dog Salmon River,2015,4359,,210,199435
Dog Salmon River,2015,2341,,211,201776
Dog Salmon River,2015,923,,212,202699
Dog Salmon River,2015,1548,,213,204247
Dog Salmon River,2015,2773,,214,207020
Dog Salmon River,2015,1360,,215,208380
Dog Salmon River,2015,3545,,216,211925
Dog Salmon River,2015,1872,,217,213797
Dog Salmon River,2015,1768,,218,215565
Dog Salmon River,2015,2488,,219,218053
Fish Creek,2015,5,,199,5
Fish Creek,2015,1,,200,6
Fish Creek,2015,0,,201,6
Fish Creek,2015,0,,202,6
Fish Creek,2015,0,,203,6
Fish Creek,2015,0,,204,6
Fish Creek,2015,0,,205,6
Fish Creek,2015,0,,206,6
Fish Creek,2015,1,,207,7
Fish Creek,2015,30,,208,37
Fish Creek,2015,7,,209,44
Fish Creek,2015,2,,210,46
Fish Creek,2015,15,,211,61
Fish Creek,2015,14,,212,75
Fish Creek,2015,5,,213,80
Fish Creek,2015,5,,214,85
Fish Creek,2015,33,,215,118
Fish Creek,2015,29,,216,147
Fish Creek,2015,31,,217,178
Fish Creek,2015,16,,218,194
Fish Creek,2015,0,,219,194
Fish Creek,2015,12,,220,206
Fish Creek,2015,0,,221,206
Fish Creek,2015,41,,222,247
Fish Creek,2015,27,,223,274
Fish Creek,2015,55,,224,329
Fish Creek,2015,35,,225,364
Fish Creek,2015,21,,226,385
Fish Creek,2015,8,,227,393
Fish Creek,2015,5,,228,398
Fish Creek,2015,24,,229,422
Fish Creek,2015,43,,230,465
Fish Creek,2015,17,,231,482
Fish Creek,2015,9,,232,491
Fish Creek,2015,1,,234,492
Fish Creek,2015,10,,237,502
Fish Creek,2015,2,,238,504
Fish Creek,2015,1,,241,505
Fish Creek,2015,1,,242,506
Fish Creek,2015,1,,243,507
Karluk River,2015,1,,169,1
Karluk River,2015,0,,170,1
Karluk River,2015,4,,171,5
Karluk River,2015,0,,172,5
Karluk River,2015,0,,173,5
Karluk River,2015,0,,174,5
Karluk River,2015,0,,175,5
Karluk River,2015,0,,176,5
Karluk River,2015,0,,177,5
Karluk River,2015,0,,178,5
Karluk River,2015,0,,179,5
Karluk River,2015,0,,180,5
Karluk River,2015,2,,181,7
Karluk River,2015,0,,182,7
Karluk River,2015,0,,183,7
Karluk River,2015,2,,184,9
Karluk River,2015,3,,185,12
Karluk River,2015,5,,186,17
Karluk River,2015,3,,187,20
Karluk River,2015,15,,188,35
Karluk River,2015,7,,189,42
Karluk River,2015,153,,190,195
Karluk River,2015,9,,191,204
Karluk River,2015,12,,192,216
Karluk River,2015,39,,193,255
Karluk River,2015,57,,194,312
Karluk River,2015,468,,195,780
Karluk River,2015,128,,196,908
Karluk River,2015,270,,197,1178
Karluk River,2015,100,,198,1278
Karluk River,2015,5,,199,1283
Karluk River,2015,14,,200,1297
Karluk River,2015,21,,201,1318
Karluk River,2015,49,,202,1367
Karluk River,2015,308,,203,1675
Karluk River,2015,132,,204,1807
Karluk River,2015,60,,205,1867
Karluk River,2015,70,,206,1937
Karluk River,2015,133,,207,2070
Karluk River,2015,254,,208,2324
Karluk River,2015,352,,209,2676
Karluk River,2015,753,,210,3429
Karluk River,2015,235,,211,3664
Karluk River,2015,270,,212,3934
Karluk River,2015,418,,213,4352
Karluk River,2015,1222,,214,5574
Karluk River,2015,517,,215,6091
Karluk River,2015,1616,,216,7707
Karluk River,2015,732,,217,8439
Karluk River,2015,637,,218,9076
Karluk River,2015,525,,219,9601
Karluk River,2015,621,,220,10222
Karluk River,2015,5982,,221,16204
Karluk River,2015,2997,,222,19201
Karluk River,2015,1605,,223,20806
Karluk River,2015,1226,,224,22032
Karluk River,2015,1163,,225,23195
Karluk River,2015,690,,226,23885
Karluk River,2015,2530,,227,26415
Karluk River,2015,3028,,228,29443
Karluk River,2015,34868,,229,64311
Karluk River,2015,10800,,230,75111
Karluk River,2015,1755,,231,76866
Karluk River,2015,790,,232,77656
Karluk River,2015,1654,,233,79310
Karluk River,2015,5400,,234,84710
Karluk River,2015,7323,,235,92033
Karluk River,2015,5347,,236,97380
Karluk River,2015,7287,,237,104667
Karluk River,2015,15262,,238,119929
Karluk River,2015,29593,,239,149522
Karluk River,2015,9153,,240,158675
Karluk River,2015,15777,,241,174452
Karluk River,2015,25505,,242,199957
Karluk River,2015,12956,,243,212913
Karluk River,2015,2842,,244,215755
Karluk River,2015,18823,,245,234578
Little Susitna,2015,1,,192,1
Little Susitna,2015,2,,193,3
Little Susitna,2015,12,,194,15
Little Susitna,2015,3,,195,18
Little Susitna,2015,0,,196,18
Little Susitna,2015,1,,197,19
Little Susitna,2015,0,,198,19
Little Susitna,2015,8,,199,27
Little Susitna,2015,12,,200,39
Little Susitna,2015,9,,201,48
Little Susitna,2015,4,,202,52
Little Susitna,2015,2,,203,54
Little Susitna,2015,30,,204,84
Little Susitna,2015,54,,205,138
Little Susitna,2015,139,,206,277
Little Susitna,2015,59,,207,336
Little Susitna,2015,47,,208,383
Little Susitna,2015,45,,209,428
Little Susitna,2015,40,,210,468
Little Susitna,2015,160,,211,628
Little Susitna,2015,58,,212,686
Little Susitna,2015,111,,213,797
Little Susitna,2015,71,,214,868
Little Susitna,2015,32,,215,900
Little Susitna,2015,58,new staff gauge,216,958
Little Susitna,2015,38,,217,996
Little Susitna,2015,17,,218,1013
Little Susitna,2015,45,,219,1058
Little Susitna,2015,30,,220,1088
Little Susitna,2015,52,,221,1140
Little Susitna,2015,22,,222,1162
Little Susitna,2015,40,,223,1202
Little Susitna,2015,32,,224,1234
Little Susitna,2015,12,,225,1246
Little Susitna,2015,14,,226,1260
Little Susitna,2015,8,,227,1268
Little Susitna,2015,7,,228,1275
Little Susitna,2015,2,,229,1277
Little Susitna,2015,8,,230,1285
Little Susitna,2015,10,,231,1295
Little Susitna,2015,2,,232,1297
Little Susitna,2015,4,,233,1301
Little Susitna,2015,5,,234,1306
Little Susitna,2015,2,,235,1308
Little Susitna,2015,1,,236,1309
Little Susitna,2015,1,,237,1310
Little Susitna,2015,4,,238,1314
Nelson River (Sapsuk),2015,7,,166,7
Nelson River (Sapsuk),2015,0,,167,7
Nelson River (Sapsuk),2015,1,,168,8
Nelson River (Sapsuk),2015,0,,169,8
Nelson River (Sapsuk),2015,0,,170,8
Nelson River (Sapsuk),2015,0,,171,8
Nelson River (Sapsuk),2015,0,,172,8
Nelson River (Sapsuk),2015,0,,173,8
Nelson River (Sapsuk),2015,2,,174,10
Nelson River (Sapsuk),2015,0,,175,10
Nelson River (Sapsuk),2015,0,,176,10
Nelson River (Sapsuk),2015,1,,177,11
Nelson River (Sapsuk),2015,1,,178,12
Nelson River (Sapsuk),2015,0,,179,12
Nelson River (Sapsuk),2015,36,,180,48
Nelson River (Sapsuk),2015,49,,181,97
Nelson River (Sapsuk),2015,22,,182,119
Nelson River (Sapsuk),2015,36,,183,155
Nelson River (Sapsuk),2015,28,,184,183
Nelson River (Sapsuk),2015,19,,185,202
Nelson River (Sapsuk),2015,29,,186,231
Nelson River (Sapsuk),2015,87,,187,318
Nelson River (Sapsuk),2015,119,,188,437
Nelson River (Sapsuk),2015,165,,189,602
Nelson River (Sapsuk),2015,381,,190,983
Nelson River (Sapsuk),2015,606,,191,1589
Nelson River (Sapsuk),2015,785,,192,2374
Nelson River (Sapsuk),2015,310,,193,2684
Nelson River (Sapsuk),2015,195,,194,2879
Nelson River (Sapsuk),2015,370,,195,3249
Nelson River (Sapsuk),2015,399,,196,3648
Nelson River (Sapsuk),2015,374,,197,4022
Nelson River (Sapsuk),2015,279,,198,4301
Nelson River (Sapsuk),2015,479,,199,4780
Nelson River (Sapsuk),2015,771,,200,5551
Nelson River (Sapsuk),2015,547,,201,6098
Nelson River (Sapsuk),2015,356,,202,6454
Nelson River (Sapsuk),2015,171,,203,6625
Nelson River (Sapsuk),2015,271,,204,6896
Nelson River (Sapsuk),2015,313,,205,7209
Olga Creek (Upper Station),2015,2,,195,2
Olga Creek (Upper Station),2015,0,,196,2
Olga Creek (Upper Station),2015,1,,197,3
Olga Creek (Upper Station),2015,1,,198,4
Olga Creek (Upper Station),2015,1,,199,5
Olga Creek (Upper Station),2015,0,,200,5
Olga Creek (Upper Station),2015,0,,201,5
Olga Creek (Upper Station),2015,3,,202,8
Olga Creek (Upper Station),2015,5,,203,13
Olga Creek (Upper Station),2015,24,,204,37
Olga Creek (Upper Station),2015,19,,205,56
Olga Creek (Upper Station),2015,49,,206,105
Olga Creek (Upper Station),2015,17,,207,122
Olga Creek (Upper Station),2015,36,,208,158
Olga Creek (Upper Station),2015,23,,209,181
Olga Creek (Upper Station),2015,26,,211,207
Olga Creek (Upper Station),2015,11,,212,218
Olga Creek (Upper Station),2015,18,,213,236
Olga Creek (Upper Station),2015,6,,214,242
Olga Creek (Upper Station),2015,2,,215,244
Olga Creek (Upper Station),2015,52,,216,296
Olga Creek (Upper Station),2015,57,,217,353
Olga Creek (Upper Station),2015,114,,218,467
Olga Creek (Upper Station),2015,63,,219,530
Olga Creek (Upper Station),2015,134,,220,664
Olga Creek (Upper Station),2015,261,,221,925
Olga Creek (Upper Station),2015,277,,222,1202
Olga Creek (Upper Station),2015,259,,223,1461
Olga Creek (Upper Station),2015,929,,224,2390
Olga Creek (Upper Station),2015,582,,225,2972
Olga Creek (Upper Station),2015,981,,226,3953
Olga Creek (Upper Station),2015,917,,227,4870
Olga Creek (Upper Station),2015,538,,228,5408
Olga Creek (Upper Station),2015,1324,,229,6732
Olga Creek (Upper Station),2015,1003,,230,7735
Olga Creek (Upper Station),2015,1281,,231,9016
Olga Creek (Upper Station),2015,1256,,232,10272
Olga Creek (Upper Station),2015,723,,233,10995
Olga Creek (Upper Station),2015,3702,,234,14697
Olga Creek (Upper Station),2015,2917,,235,17614
Olga Creek (Upper Station),2015,949,,236,18563
Olga Creek (Upper Station),2015,1904,,237,20467
Olga Creek (Upper Station),2015,1907,,238,22374
Olga Creek (Upper Station),2015,2166,,239,24540
Olga Creek (Upper Station),2015,1438,,240,25978
Olga Creek (Upper Station),2015,1062,,241,27040
Olga Creek (Upper Station),2015,2130,,242,29170
Olga Creek (Upper Station),2015,1462,,243,30632
Olga Creek (Upper Station),2015,992,,244,31624
Olga Creek (Upper Station),2015,438,,245,32062
Orzinski Lake,2015,1,,184,1
Orzinski Lake,2015,1,,185,2
Orzinski Lake,2015,0,,186,2
Orzinski Lake,2015,0,,187,2
Orzinski Lake,2015,0,,188,2
Orzinski Lake,2015,2,,189,4
Orzinski Lake,2015,12,,190,16
Orzinski Lake,2015,3,,191,19
Orzinski Lake,2015,3,,192,22
Orzinski Lake,2015,2,,193,24
Orzinski Lake,2015,0,,194,24
Orzinski Lake,2015,13,,195,37
Orzinski Lake,2015,21,,196,58
Orzinski Lake,2015,13,,197,71
Orzinski Lake,2015,17,,198,88
Orzinski Lake,2015,0,,199,88
Orzinski Lake,2015,6,,200,94
Orzinski Lake,2015,7,,201,101
Orzinski Lake,2015,6,,202,107
Orzinski Lake,2015,5,,203,112
Orzinski Lake,2015,5,,204,117
Orzinski Lake,2015,3,,205,120
Orzinski Lake,2015,7,,206,127
Orzinski Lake,2015,10,,207,137
Orzinski Lake,2015,60,,208,197
Orzinski Lake,2015,68,,209,265
Orzinski Lake,2015,352,,211,617
Orzinski Lake,2015,327,,212,944
Orzinski Lake,2015,443,,213,1387
Orzinski Lake,2015,79,,214,1466
Orzinski Lake,2015,951,,215,2417
Orzinski Lake,2015,2943,,216,5360
Orzinski Lake,2015,1261,,217,6621
Pasagshak,2015,3,,173,3
Pasagshak,2015,0,,174,3
Pasagshak,2015,0,,175,3
Pasagshak,2015,0,,176,3
Pasagshak,2015,0,,177,3
Pasagshak,2015,1,,178,4
Pasagshak,2015,0,,179,4
Pasagshak,2015,0,,180,4
Pasagshak,2015,0,,181,4
Pasagshak,2015,1,,182,5
Pasagshak,2015,0,,183,5
Pasagshak,2015,0,,184,5
Pasagshak,2015,0,,185,5
Pasagshak,2015,0,,186,5
Pasagshak,2015,0,,187,5
Pasagshak,2015,0,,188,5
Pasagshak,2015,0,,189,5
Pasagshak,2015,0,,190,5
Pasagshak,2015,0,,191,5
Pasagshak,2015,0,,192,5
Pasagshak,2015,0,,193,5
Pasagshak,2015,0,,194,5
Pasagshak,2015,0,,195,5
Pasagshak,2015,0,,196,5
Pasagshak,2015,0,,197,5
Pasagshak,2015,0,,198,5
Pasagshak,2015,0,,199,5
Pasagshak,2015,0,,200,5
Pasagshak,2015,0,,201,5
Pasagshak,2015,0,,202,5
Pasagshak,2015,0,,203,5
Pasagshak,2015,0,,204,5
Pasagshak,2015,0,,205,5
Pasagshak,2015,0,,206,5
Pasagshak,2015,0,,207,5
Pasagshak,2015,0,,209,5
Pasagshak,2015,0,,210,5
Pasagshak,2015,0,,211,5
Pasagshak,2015,0,,212,5
Pasagshak,2015,0,,213,5
Pasagshak,2015,0,,214,5
Pasagshak,2015,0,,215,5
Pasagshak,2015,0,,216,5
Pasagshak,2015,0,,217,5
Pasagshak,2015,0,,218,5
Pasagshak,2015,2,,219,7
Pasagshak,2015,0,,220,7
Pasagshak,2015,1,,221,8
Pasagshak,2015,0,,222,8
Pasagshak,2015,2,,223,10
Pasagshak,2015,0,,224,10
Pasagshak,2015,0,,225,10
Pasagshak,2015,1,,226,11
Pasagshak,2015,0,,227,11
Pasagshak,2015,0,,228,11
Pauls Bay River,2015,1,,201,1
Pauls Bay River,2015,0,,202,1
Pauls Bay River,2015,0,,203,1
Pauls Bay River,2015,1,,204,2
Pauls Bay River,2015,0,,205,2
Pauls Bay River,2015,0,,206,2
Pauls Bay River,2015,7,,207,9
Pauls Bay River,2015,1,,208,10
Pauls Bay River,2015,0,,209,10
Pauls Bay River,2015,0,,210,10
Pauls Bay River,2015,10,,211,20
Pauls Bay River,2015,7,,212,27
Pauls Bay River,2015,0,,213,27
Pauls Bay River,2015,0,,214,27
Pauls Bay River,2015,18,,215,45
Pauls Bay River,2015,5,,216,50
Pauls Bay River,2015,0,,217,50
Pauls Bay River,2015,38,,218,88
Pauls Bay River,2015,10,,219,98
Pauls Bay River,2015,23,,220,121
Pauls Bay River,2015,26,,221,147
Pauls Bay River,2015,0,,222,147
Saltery Creek,2015,1,,187,1
Saltery Creek,2015,1,,188,2
Saltery Creek,2015,0,,189,2
Saltery Creek,2015,2,,190,4
Saltery Creek,2015,6,,191,10
Saltery Creek,2015,4,,192,14
Saltery Creek,2015,21,,193,35
Saltery Creek,2015,62,,194,97
Saltery Creek,2015,37,,195,134
Saltery Creek,2015,24,,196,158
Saltery Creek,2015,69,,197,227
Saltery Creek,2015,31,,198,258
Saltery Creek,2015,61,,199,319
Saltery Creek,2015,86,,200,405
Saltery Creek,2015,83,,201,488
Saltery Creek,2015,248,,202,736
Saltery Creek,2015,144,,203,880
Saltery Creek,2015,55,,204,935
Saltery Creek,2015,106,,205,1041
Saltery Creek,2015,42,,206,1083
Saltery Creek,2015,138,,207,1221
Saltery Creek,2015,81,,208,1302
Saltery Creek,2015,91,,209,1393
Saltery Creek,2015,202,,210,1595
Saltery Creek,2015,107,,211,1702
Saltery Creek,2015,42,,212,1744
Saltery Creek,2015,10,,213,1754
Saltery Creek,2015,237,,214,1991
Saltery Creek,2015,559,,215,2550
Saltery Creek,2015,637,,216,3187
Saltery Creek,2015,528,,217,3715
Saltery Creek,2015,69,,218,3784
Sandy River,2015,1,,185,1
Sandy River,2015,0,Weir out due to high water,186,1
Sandy River,2015,0,,187,1
Sandy River,2015,0,,188,1
Sandy River,2015,0,,189,1
Sandy River,2015,0,,190,1
Sandy River,2015,0,,191,1
Sandy River,2015,2,,192,3
Sandy River,2015,2,,193,5
Sandy River,2015,6,,194,11
Sandy River,2015,3,,195,14
Sandy River,2015,13,,196,27
Sandy River,2015,13,,197,40
Sandy River,2015,2,,198,42
Sandy River,2015,17,,199,59
Sandy River,2015,10,,200,69
Sandy River,2015,24,,201,93
Sandy River,2015,4,,202,97
Sandy River,2015,9,,203,106
Yukon River (Pilot Station),2015,0,Only right bank operational,150,0
Yukon River (Pilot Station),2015,0,,151,0
Yukon River (Pilot Station),2015,0,,152,0
Yukon River (Pilot Station),2015,0,,153,0
Yukon River (Pilot Station),2015,0,,154,0
Yukon River (Pilot Station),2015,0,,155,0
Yukon River (Pilot Station),2015,0,,156,0
Yukon River (Pilot Station),2015,0,,157,0
Yukon River (Pilot Station),2015,0,,158,0
Yukon River (Pilot Station),2015,0,,159,0
Yukon River (Pilot Station),2015,0,,160,0
Yukon River (Pilot Station),2015,0,,161,0
Yukon River (Pilot Station),2015,0,,162,0
Yukon River (Pilot Station),2015,0,,163,0
Yukon River (Pilot Station),2015,0,,164,0
Yukon River (Pilot Station),2015,0,,165,0
Yukon River (Pilot Station),2015,0,,166,0
Yukon River (Pilot Station),2015,0,,167,0
Yukon River (Pilot Station),2015,0,,168,0
Yukon River (Pilot Station),2015,0,,169,0
Yukon River (Pilot Station),2015,0,,170,0
Yukon River (Pilot Station),2015,0,,171,0
Yukon River (Pilot Station),2015,0,,172,0
Yukon River (Pilot Station),2015,0,,173,0
Yukon River (Pilot Station),2015,0,,174,0
Yukon River (Pilot Station),2015,0,,175,0
Yukon River (Pilot Station),2015,0,,176,0
Yukon River (Pilot Station),2015,0,,177,0
Yukon River (Pilot Station),2015,0,,178,0
Yukon River (Pilot Station),2015,0,,179,0
Yukon River (Pilot Station),2015,0,,180,0
Yukon River (Pilot Station),2015,0,,181,0
Yukon River (Pilot Station),2015,0,,182,0
Yukon River (Pilot Station),2015,0,,183,0
Yukon River (Pilot Station),2015,0,,184,0
Yukon River (Pilot Station),2015,915,,185,915
Yukon River (Pilot Station),2015,0,,186,915
Yukon River (Pilot Station),2015,366,,187,1281
Yukon River (Pilot Station),2015,0,,188,1281
Yukon River (Pilot Station),2015,0,,189,1281
Yukon River (Pilot Station),2015,553,,190,1834
Yukon River (Pilot Station),2015,647,,191,2481
Yukon River (Pilot Station),2015,142,,192,2623
Yukon River (Pilot Station),2015,87,,193,2710
Yukon River (Pilot Station),2015,495,,194,3205
Yukon River (Pilot Station),2015,504,,195,3709
Yukon River (Pilot Station),2015,124,,196,3833
Yukon River (Pilot Station),2015,110,,197,3943
Yukon River (Pilot Station),2015,575,,198,4518
Yukon River (Pilot Station),2015,560,,199,5078
Yukon River (Pilot Station),2015,927,,200,6005
Yukon River (Pilot Station),2015,210,,201,6215
Yukon River (Pilot Station),2015,964,,202,7179
Yukon River (Pilot Station),2015,364,,203,7543
Yukon River (Pilot Station),2015,0,,204,7543
Yukon River (Pilot Station),2015,242,,205,7785
Yukon River (Pilot Station),2015,759,,206,8544
Yukon River (Pilot Station),2015,637,,207,9181
Yukon River (Pilot Station),2015,546,,208,9727
Yukon River (Pilot Station),2015,1098,,209,10825
Yukon River (Pilot Station),2015,433,,210,11258
Yukon River (Pilot Station),2015,621,,211,11879
Yukon River (Pilot Station),2015,1887,,212,13766
Yukon River (Pilot Station),2015,1200,,213,14966
Yukon River (Pilot Station),2015,1154,,214,16120
Yukon River (Pilot Station),2015,1488,,215,17608
Yukon River (Pilot Station),2015,1190,,216,18798
Yukon River (Pilot Station),2015,1220,,217,20018
Yukon River (Pilot Station),2015,439,,218,20457
Yukon River (Pilot Station),2015,0,,219,20457
Yukon River (Pilot Station),2015,226,,220,20683
Yukon River (Pilot Station),2015,171,,221,20854
Yukon River (Pilot Station),2015,0,,222,20854
Yukon River (Pilot Station),2015,567,,223,21421
Yukon River (Pilot Station),2015,0,,224,21421
Yukon River (Pilot Station),2015,0,,225,21421
Yukon River (Pilot Station),2015,271,,226,21692
Yukon River (Pilot Station),2015,0,,227,21692
Yukon River (Pilot Station),2015,0,,228,21692
Yukon River (Pilot Station),2015,59,,229,21751
Yukon River (Pilot Station),2015,0,,230,21751
Yukon River (Pilot Station),2015,229,,231,21980
Yukon River (Pilot Station),2015,202,,232,22182
Yukon River (Pilot Station),2015,0,,233,22182
Yukon River (Pilot Station),2015,0,,234,22182
Yukon River (Pilot Station),2015,0,,235,22182
Yukon River (Pilot Station),2015,0,,236,22182
Yukon River (Pilot Station),2015,0,,237,22182
Yukon River (Pilot Station),2015,0,,238,22182
Yukon River (Pilot Station),2015,75,,239,22257
Yukon River (Pilot Station),2015,130,,240,22387
Yukon River (Pilot Station),2015,0,,241,22387
Yukon River (Pilot Station),2015,0,,242,22387
Yukon River (Pilot Station),2015,0,last day of operation,243,22387
Bear River,2016,3,,173,3
Bear River,2016,1,,174,4
Bear River,2016,3,,175,7
Bear River,2016,0,,176,7
Bear River,2016,2,,177,9
Bear River,2016,1,,178,10
Bear River,2016,0,,179,10
Bear River,2016,1,,180,11
Bear River,2016,0,,181,11
Bear River,2016,1,,182,12
Bear River,2016,0,,183,12
Bear River,2016,2,,184,14
Bear River,2016,3,,185,17
Bear River,2016,3,,186,20
Bear River,2016,14,,187,34
Bear River,2016,8,,188,42
Bear River,2016,13,,189,55
Bear River,2016,54,,190,109
Bear River,2016,51,,191,160
Bear River,2016,9,,192,169
Bear River,2016,19,,193,188
Bear River,2016,75,,194,263
Bear River,2016,49,,195,312
Bear River,2016,83,,196,395
Bear River,2016,34,,197,429
Bear River,2016,16,,198,445
Bear River,2016,29,,199,474
Bear River,2016,23,,200,497
Bear River,2016,9,,201,506
Bear River,2016,42,,202,548
Bear River,2016,8,,203,556
Bear River,2016,6,,204,562
Bear River,2016,9,,205,571
Bear River,2016,31,,206,602
Bear River,2016,15,,207,617
Bear River,2016,47,,208,664
Bear River,2016,99,,209,763
Bear River,2016,74,,210,837
Bear River,2016,66,,211,903
Bear River,2016,51,,212,954
Bear River,2016,55,,213,1009
Bear River,2016,55,,214,1064
Bear River,2016,92,,215,1156
Bear River,2016,142,,216,1298
Bear River,2016,47,,217,1345
Bear River,2016,32,,218,1377
Bear River,2016,20,,219,1397
Bear River,2016,43,,220,1440
Bear River,2016,55,,221,1495
Bear River,2016,41,,222,1536
Bear River,2016,63,,223,1599
Bear River,2016,47,,224,1646
Bear River,2016,66,,225,1712
Bear River,2016,42,,226,1754
Bear River,2016,43,,227,1797
Bear River,2016,64,,228,1861
Bear River,2016,115,,229,1976
Bear River,2016,82,,230,2058
Bear River,2016,42,,231,2100
Bear River,2016,3,,232,2103
Bear River,2016,130,,233,2233
Bear River,2016,67,,234,2300
Bear River,2016,57,,235,2357
Bear River,2016,102,,236,2459
Bear River,2016,187,,237,2646
Bear River,2016,125,,238,2771
Ayakulik River,2016,2,,178,2
Ayakulik River,2016,5,,179,7
Ayakulik River,2016,0,,180,7
Ayakulik River,2016,0,,181,7
Ayakulik River,2016,2,,182,9
Ayakulik River,2016,3,,183,12
Ayakulik River,2016,3,,184,15
Ayakulik River,2016,6,,185,21
Ayakulik River,2016,4,,186,25
Ayakulik River,2016,1,,187,26
Ayakulik River,2016,7,,188,33
Ayakulik River,2016,27,,189,60
Ayakulik River,2016,24,,190,84
Ayakulik River,2016,7,,191,91
Ayakulik River,2016,13,,192,104
Ayakulik River,2016,54,,193,158
Ayakulik River,2016,106,,194,264
Ayakulik River,2016,42,,195,306
Ayakulik River,2016,57,,196,363
Ayakulik River,2016,35,,197,398
Ayakulik River,2016,70,,198,468
Ayakulik River,2016,109,,199,577
Ayakulik River,2016,36,,200,613
Ayakulik River,2016,23,,201,636
Ayakulik River,2016,74,,202,710
Ayakulik River,2016,38,,203,748
Ayakulik River,2016,124,,204,872
Ayakulik River,2016,47,,205,919
Ayakulik River,2016,12,,206,931
Ayakulik River,2016,476,,207,1407
Ayakulik River,2016,172,,208,1579
Ayakulik River,2016,335,,209,1914
Ayakulik River,2016,466,,210,2380
Ayakulik River,2016,4139,,211,6519
Ayakulik River,2016,2065,,212,8584
Ayakulik River,2016,634,,213,9218
Ayakulik River,2016,906,,214,10124
Ayakulik River,2016,500,,215,10624
Ayakulik River,2016,57,,216,10681
Ayakulik River,2016,30,,217,10711
Ayakulik River,2016,200,,219,10911
Ayakulik River,2016,400,,220,11311
Ayakulik River,2016,2000,,221,13311
Ayakulik River,2016,2500,,222,15811
Ayakulik River,2016,15000,,223,30811
Ayakulik River,2016,15000,,224,45811
Ayakulik River,2016,5000,,225,50811
Ayakulik River,2016,1500,,226,52311
Ayakulik River,2016,2000,,227,54311
Ayakulik River,2016,2000,,228,56311
Ayakulik River,2016,1500,,229,57811
Ayakulik River,2016,1119,,230,58930
Ayakulik River,2016,287,,231,59217
Ayakulik River,2016,284,,232,59501
Ayakulik River,2016,501,,233,60002
Ayakulik River,2016,53,,234,60055
Ayakulik River,2016,100,,235,60155
Buskin River,2016,1,,186,1
Buskin River,2016,0,,187,1
Buskin River,2016,0,,188,1
Buskin River,2016,0,,189,1
Buskin River,2016,0,,190,1
Buskin River,2016,1,,191,2
Buskin River,2016,0,,192,2
Buskin River,2016,0,,193,2
Buskin River,2016,0,,194,2
Buskin River,2016,0,,195,2
Buskin River,2016,0,,196,2
Buskin River,2016,0,,197,2
Buskin River,2016,0,,198,2
Buskin River,2016,1,,199,3
Buskin River,2016,3,,200,6
Buskin River,2016,0,,201,6
Buskin River,2016,0,,202,6
Buskin River,2016,0,,203,6
Buskin River,2016,0,,204,6
Buskin River,2016,0,,205,6
Buskin River,2016,0,,206,6
Buskin River,2016,0,,207,6
Buskin River,2016,0,,208,6
Buskin River,2016,0,,209,6
Buskin River,2016,0,,210,6
Buskin River,2016,1,,211,7
Buskin River,2016,32,,212,39
Buskin River,2016,35,,213,74
Buskin River,2016,4,,214,78
Buskin River,2016,0,,215,78
Buskin River,2016,0,,216,78
Buskin River,2016,0,,217,78
Buskin River,2016,5,,218,83
Buskin River,2016,355,,219,438
Buskin River,2016,75,,220,513
Buskin River,2016,56,,221,569
Buskin River,2016,17047,,222,17616
Buskin River,2016,75,,223,17691
Buskin River,2016,35,,224,17726
Buskin River,2016,7,,225,17733
Buskin River,2016,286,,226,18019
Buskin River,2016,1205,,227,19224
Buskin River,2016,107,,228,19331
Buskin River,2016,110,,229,19441
Buskin River,2016,366,,230,19807
Buskin River,2016,308,,231,20115
Buskin River,2016,42,,232,20157
Buskin River,2016,87,,233,20244
Buskin River,2016,91,,234,20335
Buskin River,2016,92,,235,20427
Buskin River,2016,84,,236,20511
Buskin River,2016,19,,237,20530
Buskin River,2016,80,,238,20610
Buskin River,2016,13,,239,20623
Buskin River,2016,63,,240,20686
Buskin River,2016,13,,241,20699
Buskin River,2016,55,,242,20754
Buskin River,2016,46,,243,20800
Buskin River,2016,33,,244,20833
Buskin River,2016,28,,245,20861
Buskin River,2016,11,,246,20872
Buskin River,2016,74,,247,20946
Buskin River,2016,228,,248,21174
Buskin River,2016,51,,249,21225
Buskin River,2016,16,,250,21241
Buskin River,2016,2,,251,21243
Buskin River,2016,13,,252,21256
Buskin River,2016,28,,253,21284
Buskin River,2016,10,,254,21294
Buskin River,2016,105,,255,21399
Buskin River,2016,25,,256,21424
Buskin River,2016,9,,257,21433
Buskin River,2016,9,,258,21442
Buskin River,2016,0,,259,21442
Chignik River,2016,6,,188,6
Chignik River,2016,18,,189,24
Chignik River,2016,6,,190,30
Chignik River,2016,0,,191,30
Chignik River,2016,0,,192,30
Chignik River,2016,0,,193,30
Chignik River,2016,0,,194,30
Chignik River,2016,0,,195,30
Chignik River,2016,18,,196,48
Chignik River,2016,6,,197,54
Chignik River,2016,0,,198,54
Chignik River,2016,0,,199,54
Chignik River,2016,0,,200,54
Chignik River,2016,0,,201,54
Chignik River,2016,0,,202,54
Chignik River,2016,32,,203,86
Chignik River,2016,24,,204,110
Chignik River,2016,0,,205,110
Chignik River,2016,6,,206,116
Chignik River,2016,0,,207,116
Chignik River,2016,0,,208,116
Chignik River,2016,1,,209,117
Chignik River,2016,12,,210,129
Chignik River,2016,30,,211,159
Chignik River,2016,37,,212,196
Chignik River,2016,79,,213,275
Chignik River,2016,30,,214,305
Chignik River,2016,30,,215,335
Chignik River,2016,18,,216,353
Chignik River,2016,0,,217,353
Chignik River,2016,0,,218,353
Chignik River,2016,0,,219,353
Chignik River,2016,12,,220,365
Chignik River,2016,0,,221,365
Chignik River,2016,12,,222,377
Chignik River,2016,6,,223,383
Chignik River,2016,12,,224,395
Chignik River,2016,6,,225,401
Chignik River,2016,0,,226,401
Chignik River,2016,0,,227,401
Chignik River,2016,6,,228,407
Chignik River,2016,0,,229,407
Chignik River,2016,6,,230,413
Chignik River,2016,6,,231,419
Chignik River,2016,12,,232,431
Chignik River,2016,7,,233,438
Chignik River,2016,0,,234,438
Chignik River,2016,12,,235,450
Chignik River,2016,0,,236,450
Chignik River,2016,6,,237,456
Chignik River,2016,0,,238,456
Chignik River,2016,0,,239,456
Chignik River,2016,0,,240,456
Chignik River,2016,0,,241,456
Chignik River,2016,0,,242,456
Chignik River,2016,0,,243,456
Chignik River,2016,0,,244,456
Chignik River,2016,0,,245,456
Chignik River,2016,0,,246,456
Chignik River,2016,0,,247,456
Chignik River,2016,0,,248,456
Chignik River,2016,12,,249,468
Chignik River,2016,18,,250,486
Chignik River,2016,0,,251,486
Chignik River,2016,0,,252,486
Chignik River,2016,0,,253,486
Chignik River,2016,0,,254,486
Chignik River,2016,0,,255,486
Chignik River,2016,0,,256,486
Coghill River,2016,4,,185,490
Coghill River,2016,37,,186,527
Coghill River,2016,23,,187,550
Coghill River,2016,47,,188,597
Coghill River,2016,84,,189,681
Coghill River,2016,271,,190,952
Coghill River,2016,686,,191,1638
Coghill River,2016,575,,192,2213
Coghill River,2016,889,,193,3102
Coghill River,2016,925,,194,4027
Coghill River,2016,789,,195,4816
Coghill River,2016,884,,196,5700
Coghill River,2016,1053,,197,6753
Coghill River,2016,1033,,198,7786
Coghill River,2016,1158,,199,8944
Coghill River,2016,1705,,200,10649
Coghill River,2016,1021,,201,11670
Coghill River,2016,1646,,202,13316
Coghill River,2016,1524,,203,14840
Coghill River,2016,1160,,204,16000
Coghill River,2016,528,,205,16528
Coghill River,2016,1162,,206,17690
Coghill River,2016,1387,,209,19077
Deshka,2016,1,,188,1
Deshka,2016,19,,189,20
Deshka,2016,17,,190,37
Deshka,2016,9,,191,46
Deshka,2016,189,,192,235
Deshka,2016,133,,193,368
Deshka,2016,210,,194,578
Deshka,2016,249,,195,827
Deshka,2016,703,,196,1530
Deshka,2016,1492,,197,3022
Deshka,2016,7185,,198,10207
Deshka,2016,3799,,199,14006
Deshka,2016,4376,,200,18382
Deshka,2016,1631,,201,20013
Deshka,2016,9964,,202,29977
Deshka,2016,9947,,203,39924
Deshka,2016,7278,,204,47202
Deshka,2016,3055,,205,50257
Deshka,2016,2779,,206,53036
Deshka,2016,1434,,207,54470
Deshka,2016,2242,,208,56712
Deshka,2016,2042,,209,58754
Deshka,2016,1162,,210,59916
Deshka,2016,842,,211,60758
Deshka,2016,682,,212,61440
Deshka,2016,393,,213,61833
Deshka,2016,179,,214,62012
Deshka,2016,464,,215,62476
Deshka,2016,351,,216,62827
Deshka,2016,468,,217,63295
Deshka,2016,461,,218,63756
Deshka,2016,647,,219,64403
Deshka,2016,449,,220,64852
Deshka,2016,75,,221,64927
Deshka,2016,41,,222,64968
Deshka,2016,37,,223,65005
Deshka,2016,26,,224,65031
Deshka,2016,93,,225,65124
Deshka,2016,127,,226,65251
Deshka,2016,58,,227,65309
Deshka,2016,50,,228,65359
Deshka,2016,29,,229,65388
Deshka,2016,19,,230,65407
Deshka,2016,12,,231,65419
Deshka,2016,6,,232,65425
Deshka,2016,9,,233,65434
Deshka,2016,11,,234,65445
Deshka,2016,4,,235,65449
Deshka,2016,1,,236,65450
Deshka,2016,1,,237,65451
Deshka,2016,0,,238,65451
Deshka,2016,0,,239,65451
Deshka,2016,0,,240,65451
Deshka,2016,1,,241,65452
Deshka,2016,2,,242,65454
Deshka,2016,0,,243,65454
Deshka,2016,1,,244,65455
Deshka,2016,1,,245,65456
Dog Salmon River,2016,2,,186,2
Dog Salmon River,2016,0,,187,2
Dog Salmon River,2016,1,,188,3
Dog Salmon River,2016,0,,189,3
Dog Salmon River,2016,2,,190,5
Dog Salmon River,2016,3,,191,8
Dog Salmon River,2016,5,,192,13
Dog Salmon River,2016,5,,193,18
Dog Salmon River,2016,8,,194,26
Dog Salmon River,2016,1,,195,27
Dog Salmon River,2016,0,,196,27
Dog Salmon River,2016,0,,197,27
Dog Salmon River,2016,0,,198,27
Dog Salmon River,2016,0,,199,27
Dog Salmon River,2016,10,,200,37
Dog Salmon River,2016,0,,201,37
Dog Salmon River,2016,58,,202,95
Dog Salmon River,2016,28,,203,123
Dog Salmon River,2016,1,,204,124
Dog Salmon River,2016,1,,205,125
Dog Salmon River,2016,0,,206,125
Dog Salmon River,2016,4,,207,129
Dog Salmon River,2016,242,,208,371
Dog Salmon River,2016,121,,209,492
Dog Salmon River,2016,105,,210,597
Dog Salmon River,2016,707,,211,1304
Dog Salmon River,2016,6296,,212,7600
Dog Salmon River,2016,3706,,213,11306
Dog Salmon River,2016,6278,,214,17584
Dog Salmon River,2016,8765,,215,26349
Dog Salmon River,2016,5839,,216,32188
Dog Salmon River,2016,11458,,217,43646
Dog Salmon River,2016,18672,,218,62318
Dog Salmon River,2016,12000,,219,74318
Dog Salmon River,2016,6000,,220,80318
Dog Salmon River,2016,0,,221,80318
Dog Salmon River,2016,45000,,222,125318
Fish Creek,2016,1,,195,1
Fish Creek,2016,11,,199,12
Fish Creek,2016,4,,207,16
Fish Creek,2016,2,,209,18
Fish Creek,2016,4,,210,22
Fish Creek,2016,2,,211,24
Fish Creek,2016,5,,213,29
Fish Creek,2016,1,,214,30
Fish Creek,2016,1,,215,31
Fish Creek,2016,1,,216,32
Fish Creek,2016,9,,217,41
Fish Creek,2016,8,,218,49
Fish Creek,2016,4,,219,53
Fish Creek,2016,24,,220,77
Fish Creek,2016,5,,221,82
Fish Creek,2016,5,,222,87
Fish Creek,2016,3,,224,90
Fish Creek,2016,2,,225,92
Fish Creek,2016,1,,227,93
Fish Creek,2016,0,,228,93
Ilnik River,2016,1,,190,1
Ilnik River,2016,4,,191,5
Ilnik River,2016,0,,192,5
Ilnik River,2016,3,,193,8
Ilnik River,2016,2,,194,10
Ilnik River,2016,0,,195,10
Ilnik River,2016,0,,196,10
Karluk River,2016,14,,178,14
Karluk River,2016,12,,179,26
Karluk River,2016,18,,180,44
Karluk River,2016,16,,181,60
Karluk River,2016,42,,182,102
Karluk River,2016,27,,183,129
Karluk River,2016,253,,184,382
Karluk River,2016,85,,185,467
Karluk River,2016,1000,,186,1467
Karluk River,2016,34,,187,1501
Karluk River,2016,23,,188,1524
Karluk River,2016,33,,189,1557
Karluk River,2016,33,,190,1590
Karluk River,2016,14,,191,1604
Karluk River,2016,17,,192,1621
Karluk River,2016,17,,193,1638
Karluk River,2016,12,,194,1650
Karluk River,2016,7,,195,1657
Karluk River,2016,10,,196,1667
Karluk River,2016,6,,197,1673
Karluk River,2016,4,,198,1677
Karluk River,2016,99,,199,1776
Karluk River,2016,1140,,200,2916
Karluk River,2016,1310,,201,4226
Karluk River,2016,238,,202,4464
Karluk River,2016,159,,203,4623
Karluk River,2016,670,,204,5293
Karluk River,2016,4420,,205,9713
Karluk River,2016,9088,,206,18801
Karluk River,2016,581,,207,19382
Karluk River,2016,1180,,208,20562
Karluk River,2016,149,,209,20711
Karluk River,2016,1547,,210,22258
Karluk River,2016,1832,,211,24090
Karluk River,2016,2371,,212,26461
Karluk River,2016,2838,,213,29299
Karluk River,2016,12678,,214,41977
Karluk River,2016,4233,,215,46210
Karluk River,2016,6482,,216,52692
Karluk River,2016,32694,,217,85386
Karluk River,2016,10559,,218,95945
Karluk River,2016,42269,,219,138214
Karluk River,2016,39465,,220,177679
Karluk River,2016,20495,,221,198174
Karluk River,2016,2675,,222,200849
Karluk River,2016,3156,,223,204005
Karluk River,2016,3017,,224,207022
Karluk River,2016,2494,,225,209516
Karluk River,2016,3521,,226,213037
Karluk River,2016,1270,,227,214307
Karluk River,2016,9036,,228,223343
Karluk River,2016,5305,,229,228648
Karluk River,2016,25196,,230,253844
Karluk River,2016,22651,,231,276495
Karluk River,2016,11832,,232,288327
Karluk River,2016,4721,,233,293048
Karluk River,2016,6556,,234,299604
Karluk River,2016,22146,,235,321750
Karluk River,2016,7265,,236,329015
Karluk River,2016,3365,,237,332380
Karluk River,2016,7346,,238,339726
Karluk River,2016,3098,,239,342824
Karluk River,2016,164,,240,342988
Karluk River,2016,322,,241,343310
Karluk River,2016,452,,242,343762
Karluk River,2016,452,,243,344214
Karluk River,2016,707,,244,344921
Karluk River,2016,1262,,245,346183
Karluk River,2016,2952,,246,349135
Karluk River,2016,3667,,247,352802
Karluk River,2016,2028,,248,354830
Karluk River,2016,4799,,249,359629
Karluk River,2016,1156,,250,360785
Karluk River,2016,378,,251,361163
Karluk River,2016,253,,252,361416
Karluk River,2016,257,,253,361673
Karluk River,2016,346,,254,362019
Karluk River,2016,261,,255,362280
Karluk River,2016,731,,256,363011
Karluk River,2016,430,,257,363441
Karluk River,2016,108,,258,363549
Karluk River,2016,65,,259,363614
Little Susitna,2016,3,,182,3
Little Susitna,2016,5,,191,8
Little Susitna,2016,9,,192,17
Little Susitna,2016,8,,193,25
Little Susitna,2016,11,,194,36
Little Susitna,2016,29,,195,65
Little Susitna,2016,80,,196,145
Little Susitna,2016,113,,197,258
Little Susitna,2016,161,,198,419
Little Susitna,2016,244,,199,663
Little Susitna,2016,131,,200,794
Little Susitna,2016,226,,201,1020
Little Susitna,2016,188,,202,1208
Little Susitna,2016,118,,203,1326
Little Susitna,2016,107,,204,1433
Little Susitna,2016,471,,205,1904
Little Susitna,2016,61,,206,1965
Little Susitna,2016,60,,207,2025
Little Susitna,2016,173,,208,2198
Little Susitna,2016,83,,209,2281
Little Susitna,2016,129,,210,2410
Little Susitna,2016,74,,211,2484
Little Susitna,2016,73,,212,2557
Little Susitna,2016,76,,213,2633
Little Susitna,2016,36,,214,2669
Little Susitna,2016,18,,215,2687
Little Susitna,2016,113,,216,2800
Little Susitna,2016,99,,217,2899
Little Susitna,2016,110,,218,3009
Little Susitna,2016,124,,219,3133
Little Susitna,2016,139,,220,3272
Little Susitna,2016,67,,221,3339
Little Susitna,2016,75,,222,3414
Little Susitna,2016,73,,223,3487
Little Susitna,2016,34,,224,3521
Little Susitna,2016,30,,225,3551
Little Susitna,2016,29,,226,3580
Little Susitna,2016,27,,227,3607
Little Susitna,2016,22,,228,3629
Little Susitna,2016,9,,229,3638
Little Susitna,2016,4,,231,3642
Little Susitna,2016,7,,233,3649
Little Susitna,2016,12,,233,3661
Little Susitna,2016,7,,234,3668
Little Susitna,2016,19,,235,3687
Little Susitna,2016,9,,236,3696
Little Susitna,2016,3,,237,3699
Little Susitna,2016,6,,238,3705
Little Susitna,2016,2,,239,3707
Little Susitna,2016,4,,240,3711
Little Susitna,2016,2,,241,3713
Little Susitna,2016,1,,242,3714
Little Susitna,2016,1,,243,3715
Little Susitna,2016,0,,245,3715
Little Susitna,2016,2,,251,3717
Nelson River (Sapsuk),2016,3,,179,3
Nelson River (Sapsuk),2016,15,,180,18
Nelson River (Sapsuk),2016,0,,181,18
Nelson River (Sapsuk),2016,0,,182,18
Nelson River (Sapsuk),2016,0,,183,18
Nelson River (Sapsuk),2016,0,,184,18
Nelson River (Sapsuk),2016,0,,185,18
Nelson River (Sapsuk),2016,0,,186,18
Nelson River (Sapsuk),2016,0,,187,18
Nelson River (Sapsuk),2016,0,,188,18
Nelson River (Sapsuk),2016,0,,189,18
Nelson River (Sapsuk),2016,0,,190,18
Nelson River (Sapsuk),2016,3,,191,21
Nelson River (Sapsuk),2016,0,,192,21
Nelson River (Sapsuk),2016,11,,193,32
Nelson River (Sapsuk),2016,28,,194,60
Nelson River (Sapsuk),2016,43,,195,103
Nelson River (Sapsuk),2016,69,,196,172
Nelson River (Sapsuk),2016,65,,197,237
Nelson River (Sapsuk),2016,69,,198,306
Nelson River (Sapsuk),2016,43,,199,349
Nelson River (Sapsuk),2016,51,,200,400
Nelson River (Sapsuk),2016,48,,201,448
Nelson River (Sapsuk),2016,118,,202,566
Nelson River (Sapsuk),2016,133,,203,699
Nelson River (Sapsuk),2016,137,,204,836
Nelson River (Sapsuk),2016,74,,205,910
Nelson River (Sapsuk),2016,83,,206,993
Nelson River (Sapsuk),2016,49,,207,1042
Nelson River (Sapsuk),2016,67,,208,1109
Olga Creek (Upper Station),2016,1,,202,1
Olga Creek (Upper Station),2016,0,,203,1
Olga Creek (Upper Station),2016,2,,204,3
Olga Creek (Upper Station),2016,0,,205,3
Olga Creek (Upper Station),2016,0,,206,3
Olga Creek (Upper Station),2016,0,,207,3
Olga Creek (Upper Station),2016,1,,208,4
Olga Creek (Upper Station),2016,0,,209,4
Olga Creek (Upper Station),2016,13,,210,17
Olga Creek (Upper Station),2016,8,,211,25
Olga Creek (Upper Station),2016,33,,212,58
Olga Creek (Upper Station),2016,25,,213,83
Olga Creek (Upper Station),2016,11,,214,94
Olga Creek (Upper Station),2016,1,,215,95
Olga Creek (Upper Station),2016,4,,216,99
Olga Creek (Upper Station),2016,27,,217,126
Olga Creek (Upper Station),2016,25,,218,151
Olga Creek (Upper Station),2016,31,,219,182
Olga Creek (Upper Station),2016,44,,220,226
Olga Creek (Upper Station),2016,44,,221,270
Olga Creek (Upper Station),2016,27,,222,297
Olga Creek (Upper Station),2016,169,,223,466
Olga Creek (Upper Station),2016,97,,224,563
Olga Creek (Upper Station),2016,21,,225,584
Olga Creek (Upper Station),2016,89,,226,673
Olga Creek (Upper Station),2016,12,,227,685
Olga Creek (Upper Station),2016,49,,228,734
Olga Creek (Upper Station),2016,96,,229,830
Olga Creek (Upper Station),2016,100,,230,930
Olga Creek (Upper Station),2016,50,,231,980
Olga Creek (Upper Station),2016,32,,232,1012
Olga Creek (Upper Station),2016,23,,233,1035
Olga Creek (Upper Station),2016,62,,234,1097
Olga Creek (Upper Station),2016,27,,235,1124
Olga Creek (Upper Station),2016,13,,236,1137
Olga Creek (Upper Station),2016,13,,237,1150
Olga Creek (Upper Station),2016,29,,238,1179
Olga Creek (Upper Station),2016,52,,239,1231
Olga Creek (Upper Station),2016,7,,240,1238
Olga Creek (Upper Station),2016,46,,241,1284
Olga Creek (Upper Station),2016,25,,242,1309
Olga Creek (Upper Station),2016,11,,243,1320
Olga Creek (Upper Station),2016,9,,244,1329
Olga Creek (Upper Station),2016,6,,245,1335
Olga Creek (Upper Station),2016,7,,246,1342
Olga Creek (Upper Station),2016,2,,247,1344
Olga Creek (Upper Station),2016,2,,248,1346
Olga Creek (Upper Station),2016,0,,249,1346
Olga Creek (Upper Station),2016,3,,250,1349
Olga Creek (Upper Station),2016,7,,251,1356
Olga Creek (Upper Station),2016,3,,252,1359
Olga Creek (Upper Station),2016,1,,253,1360
Olga Creek (Upper Station),2016,0,,254,1360
Pasagshak,2016,1,,211,1
Pasagshak,2016,0,,212,1
Pasagshak,2016,0,,213,1
Pasagshak,2016,0,,214,1
Pasagshak,2016,0,,215,1
Pasagshak,2016,0,,216,1
Pasagshak,2016,0,,217,1
Pasagshak,2016,0,,218,1
Pasagshak,2016,0,,219,1
Pasagshak,2016,0,,220,1
Pasagshak,2016,0,,221,1
Pasagshak,2016,1,,222,2
Pasagshak,2016,0,,223,2
Pasagshak,2016,0,,224,2
Pasagshak,2016,0,,225,2
Pasagshak,2016,0,,226,2
Pasagshak,2016,0,,227,2
Pasagshak,2016,0,,228,2
Pauls Bay River,2016,2,,193,2
Pauls Bay River,2016,0,,194,2
Pauls Bay River,2016,1,,195,3
Pauls Bay River,2016,0,,196,3
Pauls Bay River,2016,0,,197,3
Pauls Bay River,2016,0,,198,3
Pauls Bay River,2016,0,,199,3
Pauls Bay River,2016,0,,200,3
Pauls Bay River,2016,0,,201,3
Pauls Bay River,2016,0,,202,3
Pauls Bay River,2016,0,,203,3
Pauls Bay River,2016,0,,204,3
Pauls Bay River,2016,1,,205,4
Pauls Bay River,2016,2,,206,6
Pauls Bay River,2016,0,,207,6
Pauls Bay River,2016,0,,208,6
Pauls Bay River,2016,0,,209,6
Pauls Bay River,2016,0,,210,6
Pauls Bay River,2016,3,,211,9
Pauls Bay River,2016,14,,212,23
Pauls Bay River,2016,1,,213,24
Pauls Bay River,2016,8,,214,32
Pauls Bay River,2016,9,,215,41
Pauls Bay River,2016,20,,216,61
Pauls Bay River,2016,68,,217,129
Pauls Bay River,2016,11,,218,140
Pauls Bay River,2016,65,,219,205
Pauls Bay River,2016,105,,220,310
Pauls Bay River,2016,110,,221,420
Pauls Bay River,2016,144,,222,564
Pauls Bay River,2016,49,,223,613
Pauls Bay River,2016,130,,224,743
Pauls Bay River,2016,7,,225,750
Saltery Creek,2016,2,,198,2
Saltery Creek,2016,0,,199,2
Saltery Creek,2016,22,,200,24
Saltery Creek,2016,59,,201,83
Saltery Creek,2016,360,,202,443
Saltery Creek,2016,294,,203,737
Saltery Creek,2016,220,,204,957
Saltery Creek,2016,39,,205,996
Saltery Creek,2016,225,,206,1221
Saltery Creek,2016,82,,207,1303
Saltery Creek,2016,133,,208,1436
Saltery Creek,2016,102,,209,1538
Saltery Creek,2016,100,,210,1638
Saltery Creek,2016,173,,211,1811
Saltery Creek,2016,65,,212,1876
Saltery Creek,2016,159,,213,2035
Saltery Creek,2016,65,,214,2100
Saltery Creek,2016,33,,215,2133
Sandy River,2016,4,,181,4
Sandy River,2016,12,,182,16
Sandy River,2016,3,,183,19
Sandy River,2016,8,,184,27
Sandy River,2016,7,,185,34
Sandy River,2016,5,,186,39
Sandy River,2016,2,,187,41
Sandy River,2016,4,,188,45
Sandy River,2016,19,,189,64
Sandy River,2016,15,,190,79
Sandy River,2016,11,,191,90
Sandy River,2016,18,,192,108
Sandy River,2016,4,,193,112
Sandy River,2016,49,,194,161
Sandy River,2016,42,,195,203
Sandy River,2016,29,,196,232
Sandy River,2016,12,,197,244
Sandy River,2016,30,,198,274
Sandy River,2016,84,,199,358
Sandy River,2016,69,,200,427
Sandy River,2016,42,,201,469
Yukon River (Anvik River),2016,0,,168,0
Yukon River (Anvik River),2016,0,,169,0
Yukon River (Anvik River),2016,0,,170,0
Yukon River (Anvik River),2016,0,,171,0
Yukon River (Anvik River),2016,0,,172,0
Yukon River (Anvik River),2016,0,,173,0
Yukon River (Anvik River),2016,0,,174,0
Yukon River (Anvik River),2016,0,,175,0
Yukon River (Anvik River),2016,0,,176,0
Yukon River (Anvik River),2016,0,,177,0
Yukon River (Anvik River),2016,37,,178,37
Yukon River (Anvik River),2016,27,,179,64
Yukon River (Anvik River),2016,41,,180,105
Yukon River (Anvik River),2016,178,,181,283
Yukon River (Anvik River),2016,53,,182,336
Yukon River (Anvik River),2016,166,,183,502
Yukon River (Anvik River),2016,470,,184,972
Yukon River (Anvik River),2016,359,,185,1331
Yukon River (Anvik River),2016,920,,186,2251
Yukon River (Anvik River),2016,1919,,187,4170
Yukon River (Anvik River),2016,2526,,188,6696
Yukon River (Anvik River),2016,5680,,189,12376
Yukon River (Anvik River),2016,6954,,190,19330
Yukon River (Anvik River),2016,9097,,191,28427
Yukon River (Anvik River),2016,16737,,192,45164
Yukon River (Anvik River),2016,19791,,193,64955
Yukon River (Anvik River),2016,22646,,194,87601
Yukon River (Anvik River),2016,42650,,195,130251
Yukon River (Anvik River),2016,37073,,196,167324
Yukon River (Anvik River),2016,32005,,197,199329
Yukon River (Anvik River),2016,21658,,198,220987
Yukon River (Anvik River),2016,26888,,199,247875
Yukon River (Anvik River),2016,31248,,200,279123
Yukon River (Anvik River),2016,27293,,201,306416
Yukon River (Anvik River),2016,20080,,202,326496
Yukon River (Anvik River),2016,29660,,203,356156
Yukon River (Anvik River),2016,47131,,204,403287
Yukon River (Anvik River),2016,41748,,205,445035
Yukon River (Anvik River),2016,56851,,206,501886
Yukon River (Anvik River),2016,74319,,207,576205
Yukon River (Anvik River),2016,91323,,208,667528
Yukon River (Pilot Station),2016,0,,151,667528
Yukon River (Pilot Station),2016,0,,152,667528
Yukon River (Pilot Station),2016,0,,153,667528
Yukon River (Pilot Station),2016,0,,154,667528
Yukon River (Pilot Station),2016,0,,155,667528
Yukon River (Pilot Station),2016,0,,156,667528
Yukon River (Pilot Station),2016,0,,157,667528
Yukon River (Pilot Station),2016,0,,158,667528
Yukon River (Pilot Station),2016,0,,159,667528
Yukon River (Pilot Station),2016,0,,160,667528
Yukon River (Pilot Station),2016,0,,161,667528
Yukon River (Pilot Station),2016,0,,162,667528
Yukon River (Pilot Station),2016,0,,163,667528
Yukon River (Pilot Station),2016,0,,164,667528
Yukon River (Pilot Station),2016,0,,165,667528
Yukon River (Pilot Station),2016,0,,166,667528
Yukon River (Pilot Station),2016,0,,167,667528
Yukon River (Pilot Station),2016,0,,168,667528
Yukon River (Pilot Station),2016,0,,169,667528
Yukon River (Pilot Station),2016,0,,170,667528
Yukon River (Pilot Station),2016,0,,171,667528
Yukon River (Pilot Station),2016,0,,172,667528
Yukon River (Pilot Station),2016,246,,173,667774
Yukon River (Pilot Station),2016,0,,174,667774
Yukon River (Pilot Station),2016,2008,,175,669782
Yukon River (Pilot Station),2016,918,,176,670700
Yukon River (Pilot Station),2016,2998,,177,673698
Yukon River (Pilot Station),2016,4852,,178,678550
Yukon River (Pilot Station),2016,370,,179,678920
Yukon River (Pilot Station),2016,9114,,180,688034
Yukon River (Pilot Station),2016,5099,,181,693133
Yukon River (Pilot Station),2016,8144,,182,701277
Yukon River (Pilot Station),2016,11731,,183,713008
Yukon River (Pilot Station),2016,7441,,184,720449
Yukon River (Pilot Station),2016,18185,,185,738634
Yukon River (Pilot Station),2016,17401,,186,756035
Yukon River (Pilot Station),2016,20969,,187,777004
Yukon River (Pilot Station),2016,23287,,188,800291
Yukon River (Pilot Station),2016,12421,,189,812712
Yukon River (Pilot Station),2016,21086,,190,833798
Yukon River (Pilot Station),2016,15923,,191,849721
Yukon River (Pilot Station),2016,26200,,192,875921
Yukon River (Pilot Station),2016,37820,,193,913741
Yukon River (Pilot Station),2016,56153,,194,969894
Yukon River (Pilot Station),2016,69001,,195,1038895
Yukon River (Pilot Station),2016,65515,,196,1104410
Yukon River (Pilot Station),2016,67803,,197,1172213
Yukon River (Pilot Station),2016,49270,,198,1221483
Yukon River (Pilot Station),2016,63590,,199,1285073
Yukon River (Pilot Station),2016,37852,,200,1322925
Yukon River (Pilot Station),2016,33899,,201,1356824
Yukon River (Pilot Station),2016,56056,,202,1412880
Yukon River (Pilot Station),2016,101886,,203,1514766
Yukon River (Pilot Station),2016,76379,,204,1591145
Yukon River (Pilot Station),2016,65883,,205,1657028
Yukon River (Pilot Station),2016,41934,,206,1698962
Yukon River (Pilot Station),2016,46697,,207,1745659
Yukon River (Pilot Station),2016,31341,,208,1777000
Yukon River (Pilot Station),2016,25348,,209,1802348
Yukon River (Pilot Station),2016,26769,,210,1829117
Yukon River (Pilot Station),2016,21583,,211,1850700
Yukon River (Pilot Station),2016,22242,,212,1872942
Yukon River (Pilot Station),2016,30998,,213,1903940
Yukon River (Pilot Station),2016,22281,,214,1926221
Yukon River (Pilot Station),2016,14470,,215,1940691
Yukon River (Pilot Station),2016,12836,,216,1953527
Yukon River (Pilot Station),2016,11212,,217,1964739
Yukon River (Pilot Station),2016,10271,,218,1975010
Yukon River (Pilot Station),2016,9370,,219,1984380
Yukon River (Pilot Station),2016,5311,,220,1989691
Yukon River (Pilot Station),2016,9294,,221,1998985
Yukon River (Pilot Station),2016,7189,,222,2006174
Yukon River (Pilot Station),2016,4797,,223,2010971
Yukon River (Pilot Station),2016,3720,,224,2014691
Yukon River (Pilot Station),2016,2313,,225,2017004
Yukon River (Pilot Station),2016,3781,,226,2020785
Yukon River (Pilot Station),2016,2616,,227,2023401
Yukon River (Pilot Station),2016,1013,,228,2024414
Yukon River (Pilot Station),2016,1565,,229,2025979
Yukon River (Pilot Station),2016,782,,230,2026761
Yukon River (Pilot Station),2016,652,,231,2027413
Yukon River (Pilot Station),2016,603,,232,2028016
Yukon River (Pilot Station),2016,314,,233,2028330
Yukon River (Pilot Station),2016,217,,234,2028547
Yukon River (Pilot Station),2016,203,,235,2028750
Yukon River (Pilot Station),2016,610,,236,2029360
Yukon River (Pilot Station),2016,0,,237,2029360
Yukon River (Pilot Station),2016,0,,238,2029360
Yukon River (Pilot Station),2016,0,,239,2029360
Yukon River (Pilot Station),2016,0,,240,2029360
Yukon River (Pilot Station),2016,0,,241,2029360
Yukon River (Pilot Station),2016,0,,242,2029360
Yukon River (Pilot Station),2016,0,,243,2029360
Yukon River (Pilot Station),2016,0,,244,2029360
Nass Gitwinksihlkw,1992,0,,152,0
Nass Gitwinksihlkw,1992,0,,153,0
Nass Gitwinksihlkw,1992,0,,154,0
Nass Gitwinksihlkw,1992,0,,155,0
Nass Gitwinksihlkw,1992,0,,156,0
Nass Gitwinksihlkw,1992,0,,157,0
Nass Gitwinksihlkw,1992,0,,158,0
Nass Gitwinksihlkw,1992,0,,159,0
Nass Gitwinksihlkw,1992,0,,160,0
Nass Gitwinksihlkw,1992,0,,161,0
Nass Gitwinksihlkw,1992,0,,162,0
Nass Gitwinksihlkw,1992,0,,163,0
Nass Gitwinksihlkw,1992,0,,164,0
Nass Gitwinksihlkw,1992,0,,165,0
Nass Gitwinksihlkw,1992,0,,166,0
Nass Gitwinksihlkw,1992,0,,167,0
Nass Gitwinksihlkw,1992,0,,168,0
Nass Gitwinksihlkw,1992,0,,169,0
Nass Gitwinksihlkw,1992,0,,170,0
Nass Gitwinksihlkw,1992,0,,171,0
Nass Gitwinksihlkw,1992,0,,172,0
Nass Gitwinksihlkw,1992,0,,173,0
Nass Gitwinksihlkw,1992,0,,174,0
Nass Gitwinksihlkw,1992,0,,175,0
Nass Gitwinksihlkw,1992,0,,176,0
Nass Gitwinksihlkw,1992,0,,177,0
Nass Gitwinksihlkw,1992,0,,178,0
Nass Gitwinksihlkw,1992,0,,179,0
Nass Gitwinksihlkw,1992,0,,180,0
Nass Gitwinksihlkw,1992,0,,181,0
Nass Gitwinksihlkw,1992,0,,182,0
Nass Gitwinksihlkw,1992,0,,183,0
Nass Gitwinksihlkw,1992,0,,184,0
Nass Gitwinksihlkw,1992,0,,185,0
Nass Gitwinksihlkw,1992,0,,186,0
Nass Gitwinksihlkw,1992,0,,187,0
Nass Gitwinksihlkw,1992,0,,188,0
Nass Gitwinksihlkw,1992,0,,189,0
Nass Gitwinksihlkw,1992,0,,190,0
Nass Gitwinksihlkw,1992,0,,191,0
Nass Gitwinksihlkw,1992,0,,192,0
Nass Gitwinksihlkw,1992,1,,193,1
Nass Gitwinksihlkw,1992,3,,194,4
Nass Gitwinksihlkw,1992,3,,195,7
Nass Gitwinksihlkw,1992,11,,196,18
Nass Gitwinksihlkw,1992,11,,197,29
Nass Gitwinksihlkw,1992,14,,198,43
Nass Gitwinksihlkw,1992,40,,199,83
Nass Gitwinksihlkw,1992,33,,200,116
Nass Gitwinksihlkw,1992,47,,201,163
Nass Gitwinksihlkw,1992,76,,202,239
Nass Gitwinksihlkw,1992,46,,203,285
Nass Gitwinksihlkw,1992,57,,204,342
Nass Gitwinksihlkw,1992,41,,205,383
Nass Gitwinksihlkw,1992,51,,206,434
Nass Gitwinksihlkw,1992,72,,207,506
Nass Gitwinksihlkw,1992,65,,208,571
Nass Gitwinksihlkw,1992,20,,209,591
Nass Gitwinksihlkw,1992,21,,210,612
Nass Gitwinksihlkw,1992,40,,211,652
Nass Gitwinksihlkw,1992,60,,212,712
Nass Gitwinksihlkw,1992,66,,213,778
Nass Gitwinksihlkw,1992,72,,214,850
Nass Gitwinksihlkw,1992,87,,215,937
Nass Gitwinksihlkw,1992,61,,216,998
Nass Gitwinksihlkw,1992,53,,217,1051
Nass Gitwinksihlkw,1992,18,,218,1069
Nass Gitwinksihlkw,1992,114,,219,1183
Nass Gitwinksihlkw,1992,161,,220,1344
Nass Gitwinksihlkw,1992,223,,221,1567
Nass Gitwinksihlkw,1992,291,,222,1858
Nass Gitwinksihlkw,1992,273,,223,2131
Nass Gitwinksihlkw,1992,232,,224,2363
Nass Gitwinksihlkw,1992,211,,225,2574
Nass Gitwinksihlkw,1992,183,,226,2757
Nass Gitwinksihlkw,1992,117,,227,2874
Nass Gitwinksihlkw,1992,41,,228,2915
Nass Gitwinksihlkw,1992,61,,229,2976
Nass Gitwinksihlkw,1992,131,,230,3107
Nass Gitwinksihlkw,1992,162,,231,3269
Nass Gitwinksihlkw,1992,203,,232,3472
Nass Gitwinksihlkw,1992,243,,233,3715
Nass Gitwinksihlkw,1992,88,,234,3803
Nass Gitwinksihlkw,1992,105,,235,3908
Nass Gitwinksihlkw,1992,115,,236,4023
Nass Gitwinksihlkw,1992,144,,237,4167
Nass Gitwinksihlkw,1992,108,,238,4275
Nass Gitwinksihlkw,1992,157,,239,4432
Nass Gitwinksihlkw,1992,145,,240,4577
Nass Gitwinksihlkw,1992,256,,241,4833
Nass Gitwinksihlkw,1992,121,,242,4954
Nass Gitwinksihlkw,1992,122,,243,5076
Nass Gitwinksihlkw,1992,104,,244,5180
Nass Gitwinksihlkw,1992,111,,245,5291
Nass Gitwinksihlkw,1992,143,,246,5434
Nass Gitwinksihlkw,1992,86,,247,5520
Nass Gitwinksihlkw,1992,77,,248,5597
Nass Gitwinksihlkw,1992,49,,249,5646
Nass Gitwinksihlkw,1992,0,,250,5646
Nass Gitwinksihlkw,1992,0,,251,5646
Nass Gitwinksihlkw,1992,0,,252,5646
Nass Gitwinksihlkw,1992,14,,253,5660
Nass Gitwinksihlkw,1992,17,,254,5677
Nass Gitwinksihlkw,1992,6,,255,5683
Nass Gitwinksihlkw,1992,7,,256,5690
Nass Gitwinksihlkw,1992,8,,257,5698
Nass Gitwinksihlkw,1992,0,,258,5698
Nass Gitwinksihlkw,1992,0,,259,5698
Nass Gitwinksihlkw,1992,0,,260,5698
Nass Gitwinksihlkw,1992,0,,261,5698
Nass Gitwinksihlkw,1992,0,,262,5698
Nass Gitwinksihlkw,1992,0,,263,5698
Nass Gitwinksihlkw,1992,1,,264,5699
Nass Gitwinksihlkw,1992,0,,265,5699
Nass Gitwinksihlkw,1992,0,,266,5699
Nass Gitwinksihlkw,1992,0,,267,5699
Nass Gitwinksihlkw,1992,0,,268,5699
Nass Gitwinksihlkw,1992,0,,269,5699
Nass Gitwinksihlkw,1992,0,,270,5699
Nass Gitwinksihlkw,1992,0,,271,5699
Nass Gitwinksihlkw,1992,0,,272,5699
Nass Gitwinksihlkw,1992,0,,273,5699
Nass Gitwinksihlkw,1992,0,,274,5699
Nass Gitwinksihlkw,1992,0,,275,5699
Nass Gitwinksihlkw,1992,0,,276,5699
Nass Gitwinksihlkw,1992,0,,277,5699
Nass Gitwinksihlkw,1992,0,,278,5699
Nass Gitwinksihlkw,1992,0,,279,5699
Nass Gitwinksihlkw,1992,0,,280,5699
Nass Gitwinksihlkw,1992,0,,281,5699
Nass Gitwinksihlkw,1992,0,,282,5699
Nass Gitwinksihlkw,1992,0,,283,5699
Nass Gitwinksihlkw,1992,0,,284,5699
Nass Gitwinksihlkw,1992,0,,285,5699
Nass Gitwinksihlkw,1992,0,,286,5699
Nass Gitwinksihlkw,1992,0,,287,5699
Nass Gitwinksihlkw,1994,0,,151,0
Nass Gitwinksihlkw,1994,0,,152,0
Nass Gitwinksihlkw,1994,0,,153,0
Nass Gitwinksihlkw,1994,0,,154,0
Nass Gitwinksihlkw,1994,0,,155,0
Nass Gitwinksihlkw,1994,0,,156,0
Nass Gitwinksihlkw,1994,0,,157,0
Nass Gitwinksihlkw,1994,0,,158,0
Nass Gitwinksihlkw,1994,0,,159,0
Nass Gitwinksihlkw,1994,0,,160,0
Nass Gitwinksihlkw,1994,0,,161,0
Nass Gitwinksihlkw,1994,0,,162,0
Nass Gitwinksihlkw,1994,0,,163,0
Nass Gitwinksihlkw,1994,0,,164,0
Nass Gitwinksihlkw,1994,0,,165,0
Nass Gitwinksihlkw,1994,0,,166,0
Nass Gitwinksihlkw,1994,0,,167,0
Nass Gitwinksihlkw,1994,0,,168,0
Nass Gitwinksihlkw,1994,0,,169,0
Nass Gitwinksihlkw,1994,0,,170,0
Nass Gitwinksihlkw,1994,0,,171,0
Nass Gitwinksihlkw,1994,0,,172,0
Nass Gitwinksihlkw,1994,0,,173,0
Nass Gitwinksihlkw,1994,0,,174,0
Nass Gitwinksihlkw,1994,0,,175,0
Nass Gitwinksihlkw,1994,0,,176,0
Nass Gitwinksihlkw,1994,0,,177,0
Nass Gitwinksihlkw,1994,0,,178,0
Nass Gitwinksihlkw,1994,0,,179,0
Nass Gitwinksihlkw,1994,0,,180,0
Nass Gitwinksihlkw,1994,0,,181,0
Nass Gitwinksihlkw,1994,0,,182,0
Nass Gitwinksihlkw,1994,0,,183,0
Nass Gitwinksihlkw,1994,0,,184,0
Nass Gitwinksihlkw,1994,0,,185,0
Nass Gitwinksihlkw,1994,0,,186,0
Nass Gitwinksihlkw,1994,0,,187,0
Nass Gitwinksihlkw,1994,1,,188,1
Nass Gitwinksihlkw,1994,0,,189,1
Nass Gitwinksihlkw,1994,1,,190,2
Nass Gitwinksihlkw,1994,0,,191,2
Nass Gitwinksihlkw,1994,0,,192,2
Nass Gitwinksihlkw,1994,0,,193,2
Nass Gitwinksihlkw,1994,0,,194,2
Nass Gitwinksihlkw,1994,0,,195,2
Nass Gitwinksihlkw,1994,1,,196,3
Nass Gitwinksihlkw,1994,1,,197,4
Nass Gitwinksihlkw,1994,0,,198,4
Nass Gitwinksihlkw,1994,26,,199,30
Nass Gitwinksihlkw,1994,24,,200,54
Nass Gitwinksihlkw,1994,47,,201,101
Nass Gitwinksihlkw,1994,35,,202,136
Nass Gitwinksihlkw,1994,24,,203,160
Nass Gitwinksihlkw,1994,118,,204,278
Nass Gitwinksihlkw,1994,81,,205,359
Nass Gitwinksihlkw,1994,32,,206,391
Nass Gitwinksihlkw,1994,37,,207,428
Nass Gitwinksihlkw,1994,94,,208,522
Nass Gitwinksihlkw,1994,59,,209,581
Nass Gitwinksihlkw,1994,115,,210,696
Nass Gitwinksihlkw,1994,81,,211,777
Nass Gitwinksihlkw,1994,101,,212,878
Nass Gitwinksihlkw,1994,106,,213,984
Nass Gitwinksihlkw,1994,78,,214,1062
Nass Gitwinksihlkw,1994,47,,215,1109
Nass Gitwinksihlkw,1994,29,,216,1138
Nass Gitwinksihlkw,1994,25,,217,1163
Nass Gitwinksihlkw,1994,107,,218,1270
Nass Gitwinksihlkw,1994,253,,219,1523
Nass Gitwinksihlkw,1994,65,,220,1588
Nass Gitwinksihlkw,1994,56,,221,1644
Nass Gitwinksihlkw,1994,454,,222,2098
Nass Gitwinksihlkw,1994,682,,223,2780
Nass Gitwinksihlkw,1994,605,,224,3385
Nass Gitwinksihlkw,1994,574,,225,3959
Nass Gitwinksihlkw,1994,410,,226,4369
Nass Gitwinksihlkw,1994,657,,227,5026
Nass Gitwinksihlkw,1994,679,,228,5705
Nass Gitwinksihlkw,1994,606,,229,6311
Nass Gitwinksihlkw,1994,338,,230,6649
Nass Gitwinksihlkw,1994,282,,231,6931
Nass Gitwinksihlkw,1994,212,,232,7143
Nass Gitwinksihlkw,1994,330,,233,7473
Nass Gitwinksihlkw,1994,200,,234,7673
Nass Gitwinksihlkw,1994,181,,235,7854
Nass Gitwinksihlkw,1994,258,,236,8112
Nass Gitwinksihlkw,1994,330,,237,8442
Nass Gitwinksihlkw,1994,373,,238,8815
Nass Gitwinksihlkw,1994,427,,239,9242
Nass Gitwinksihlkw,1994,199,,240,9441
Nass Gitwinksihlkw,1994,141,,241,9582
Nass Gitwinksihlkw,1994,100,,242,9682
Nass Gitwinksihlkw,1994,84,,243,9766
Nass Gitwinksihlkw,1994,40,,244,9806
Nass Gitwinksihlkw,1994,59,,245,9865
Nass Gitwinksihlkw,1994,44,,246,9909
Nass Gitwinksihlkw,1994,52,,247,9961
Nass Gitwinksihlkw,1994,31,,248,9992
Nass Gitwinksihlkw,1994,26,,249,10018
Nass Gitwinksihlkw,1994,26,,250,10044
Nass Gitwinksihlkw,1994,0,,251,10044
Nass Gitwinksihlkw,1994,0,,252,10044
Nass Gitwinksihlkw,1994,0,,253,10044
Nass Gitwinksihlkw,1994,0,,254,10044
Nass Gitwinksihlkw,1994,0,,255,10044
Nass Gitwinksihlkw,1994,0,,256,10044
Nass Gitwinksihlkw,1994,0,,257,10044
Nass Gitwinksihlkw,1994,0,,258,10044
Nass Gitwinksihlkw,1994,0,,259,10044
Nass Gitwinksihlkw,1994,0,,260,10044
Nass Gitwinksihlkw,1994,0,,261,10044
Nass Gitwinksihlkw,1994,0,,262,10044
Nass Gitwinksihlkw,1994,0,,263,10044
Nass Gitwinksihlkw,1994,0,,264,10044
Nass Gitwinksihlkw,1994,0,,265,10044
Nass Gitwinksihlkw,1994,0,,266,10044
Nass Gitwinksihlkw,1994,0,,267,10044
Nass Gitwinksihlkw,1994,0,,268,10044
Nass Gitwinksihlkw,1994,0,,269,10044
Nass Gitwinksihlkw,1994,0,,270,10044
Nass Gitwinksihlkw,1994,0,,271,10044
Nass Gitwinksihlkw,1994,0,,272,10044
Nass Gitwinksihlkw,1994,0,,273,10044
Nass Gitwinksihlkw,1994,0,,274,10044
Nass Gitwinksihlkw,1994,0,,275,10044
Nass Gitwinksihlkw,1994,0,,276,10044
Nass Gitwinksihlkw,1994,0,,277,10044
Nass Gitwinksihlkw,1994,0,,278,10044
Nass Gitwinksihlkw,1994,0,,279,10044
Nass Gitwinksihlkw,1994,0,,280,10044
Nass Gitwinksihlkw,1994,0,,281,10044
Nass Gitwinksihlkw,1994,0,,282,10044
Nass Gitwinksihlkw,1994,0,,283,10044
Nass Gitwinksihlkw,1994,0,,284,10044
Nass Gitwinksihlkw,1994,0,,285,10044
Nass Gitwinksihlkw,1994,0,,286,10044
Nass Gitwinksihlkw,1996,0,,152,0
Nass Gitwinksihlkw,1996,0,,153,0
Nass Gitwinksihlkw,1996,0,,154,0
Nass Gitwinksihlkw,1996,0,,155,0
Nass Gitwinksihlkw,1996,0,,156,0
Nass Gitwinksihlkw,1996,0,,157,0
Nass Gitwinksihlkw,1996,0,,158,0
Nass Gitwinksihlkw,1996,0,,159,0
Nass Gitwinksihlkw,1996,0,,160,0
Nass Gitwinksihlkw,1996,0,,161,0
Nass Gitwinksihlkw,1996,0,,162,0
Nass Gitwinksihlkw,1996,0,,163,0
Nass Gitwinksihlkw,1996,0,,164,0
Nass Gitwinksihlkw,1996,0,,165,0
Nass Gitwinksihlkw,1996,0,,166,0
Nass Gitwinksihlkw,1996,0,,167,0
Nass Gitwinksihlkw,1996,0,,168,0
Nass Gitwinksihlkw,1996,0,,169,0
Nass Gitwinksihlkw,1996,0,,170,0
Nass Gitwinksihlkw,1996,0,,171,0
Nass Gitwinksihlkw,1996,0,,172,0
Nass Gitwinksihlkw,1996,0,,173,0
Nass Gitwinksihlkw,1996,0,,174,0
Nass Gitwinksihlkw,1996,0,,175,0
Nass Gitwinksihlkw,1996,0,,176,0
Nass Gitwinksihlkw,1996,0,,177,0
Nass Gitwinksihlkw,1996,0,,178,0
Nass Gitwinksihlkw,1996,0,,179,0
Nass Gitwinksihlkw,1996,0,,180,0
Nass Gitwinksihlkw,1996,0,,181,0
Nass Gitwinksihlkw,1996,0,,182,0
Nass Gitwinksihlkw,1996,0,,183,0
Nass Gitwinksihlkw,1996,0,,184,0
Nass Gitwinksihlkw,1996,0,,185,0
Nass Gitwinksihlkw,1996,0,,186,0
Nass Gitwinksihlkw,1996,0,,187,0
Nass Gitwinksihlkw,1996,0,,188,0
Nass Gitwinksihlkw,1996,1,,189,1
Nass Gitwinksihlkw,1996,2,,190,3
Nass Gitwinksihlkw,1996,1,,191,4
Nass Gitwinksihlkw,1996,1,,192,5
Nass Gitwinksihlkw,1996,0,,193,5
Nass Gitwinksihlkw,1996,0,,194,5
Nass Gitwinksihlkw,1996,1,,195,6
Nass Gitwinksihlkw,1996,6,,196,12
Nass Gitwinksihlkw,1996,5,,197,17
Nass Gitwinksihlkw,1996,5,,198,22
Nass Gitwinksihlkw,1996,14,,199,36
Nass Gitwinksihlkw,1996,17,,200,53
Nass Gitwinksihlkw,1996,17,,201,70
Nass Gitwinksihlkw,1996,2,,202,72
Nass Gitwinksihlkw,1996,4,,203,76
Nass Gitwinksihlkw,1996,20,,204,96
Nass Gitwinksihlkw,1996,35,,205,131
Nass Gitwinksihlkw,1996,42,,206,173
Nass Gitwinksihlkw,1996,29,,207,202
Nass Gitwinksihlkw,1996,46,,208,248
Nass Gitwinksihlkw,1996,71,,209,319
Nass Gitwinksihlkw,1996,101,,210,420
Nass Gitwinksihlkw,1996,110,,211,530
Nass Gitwinksihlkw,1996,30,,212,560
Nass Gitwinksihlkw,1996,102,,213,662
Nass Gitwinksihlkw,1996,210,,214,872
Nass Gitwinksihlkw,1996,132,,215,1004
Nass Gitwinksihlkw,1996,101,,216,1105
Nass Gitwinksihlkw,1996,250,,217,1355
Nass Gitwinksihlkw,1996,335,,218,1690
Nass Gitwinksihlkw,1996,292,,219,1982
Nass Gitwinksihlkw,1996,346,,220,2328
Nass Gitwinksihlkw,1996,319,,221,2647
Nass Gitwinksihlkw,1996,228,,222,2875
Nass Gitwinksihlkw,1996,24,,223,2899
Nass Gitwinksihlkw,1996,134,,224,3033
Nass Gitwinksihlkw,1996,128,,225,3161
Nass Gitwinksihlkw,1996,269,,226,3430
Nass Gitwinksihlkw,1996,388,,227,3818
Nass Gitwinksihlkw,1996,304,,228,4122
Nass Gitwinksihlkw,1996,280,,229,4402
Nass Gitwinksihlkw,1996,163,,230,4565
Nass Gitwinksihlkw,1996,45,,231,4610
Nass Gitwinksihlkw,1996,175,,232,4785
Nass Gitwinksihlkw,1996,332,,233,5117
Nass Gitwinksihlkw,1996,497,,234,5614
Nass Gitwinksihlkw,1996,377,,235,5991
Nass Gitwinksihlkw,1996,103,,236,6094
Nass Gitwinksihlkw,1996,82,,237,6176
Nass Gitwinksihlkw,1996,660,,238,6836
Nass Gitwinksihlkw,1996,603,,239,7439
Nass Gitwinksihlkw,1996,828,,240,8267
Nass Gitwinksihlkw,1996,753,,241,9020
Nass Gitwinksihlkw,1996,466,,242,9486
Nass Gitwinksihlkw,1996,390,,243,9876
Nass Gitwinksihlkw,1996,225,,244,10101
Nass Gitwinksihlkw,1996,150,,245,10251
Nass Gitwinksihlkw,1996,380,,246,10631
Nass Gitwinksihlkw,1996,453,,247,11084
Nass Gitwinksihlkw,1996,786,,248,11870
Nass Gitwinksihlkw,1996,461,,249,12331
Nass Gitwinksihlkw,1996,163,,250,12494
Nass Gitwinksihlkw,1996,157,,251,12651
Nass Gitwinksihlkw,1996,175,,252,12826
Nass Gitwinksihlkw,1996,68,,253,12894
Nass Gitwinksihlkw,1996,45,,254,12939
Nass Gitwinksihlkw,1996,27,,255,12966
Nass Gitwinksihlkw,1996,19,,256,12985
Nass Gitwinksihlkw,1996,17,,257,13002
Nass Gitwinksihlkw,1996,20,,258,13022
Nass Gitwinksihlkw,1996,26,,259,13048
Nass Gitwinksihlkw,1996,25,,260,13073
Nass Gitwinksihlkw,1996,4,,261,13077
Nass Gitwinksihlkw,1996,6,,262,13083
Nass Gitwinksihlkw,1996,4,,263,13087
Nass Gitwinksihlkw,1996,10,,264,13097
Nass Gitwinksihlkw,1996,15,,265,13112
Nass Gitwinksihlkw,1996,5,,266,13117
Nass Gitwinksihlkw,1996,0,,267,13117
Nass Gitwinksihlkw,1996,0,,268,13117
Nass Gitwinksihlkw,1996,0,,269,13117
Nass Gitwinksihlkw,1996,0,,270,13117
Nass Gitwinksihlkw,1996,0,,271,13117
Nass Gitwinksihlkw,1996,0,,272,13117
Nass Gitwinksihlkw,1996,0,,273,13117
Nass Gitwinksihlkw,1996,0,,274,13117
Nass Gitwinksihlkw,1996,0,,275,13117
Nass Gitwinksihlkw,1996,0,,276,13117
Nass Gitwinksihlkw,1996,0,,277,13117
Nass Gitwinksihlkw,1996,0,,278,13117
Nass Gitwinksihlkw,1996,0,,279,13117
Nass Gitwinksihlkw,1996,0,,280,13117
Nass Gitwinksihlkw,1996,0,,281,13117
Nass Gitwinksihlkw,1996,0,,282,13117
Nass Gitwinksihlkw,1996,0,,283,13117
Nass Gitwinksihlkw,1996,0,,284,13117
Nass Gitwinksihlkw,1996,0,,285,13117
Nass Gitwinksihlkw,1996,0,,286,13117
Nass Gitwinksihlkw,1996,0,,287,13117
Nass Gitwinksihlkw,1998,0,,151,0
Nass Gitwinksihlkw,1998,0,,152,0
Nass Gitwinksihlkw,1998,0,,153,0
Nass Gitwinksihlkw,1998,0,,154,0
Nass Gitwinksihlkw,1998,0,,155,0
Nass Gitwinksihlkw,1998,0,,156,0
Nass Gitwinksihlkw,1998,0,,157,0
Nass Gitwinksihlkw,1998,0,,158,0
Nass Gitwinksihlkw,1998,0,,159,0
Nass Gitwinksihlkw,1998,0,,160,0
Nass Gitwinksihlkw,1998,0,,161,0
Nass Gitwinksihlkw,1998,0,,162,0
Nass Gitwinksihlkw,1998,0,,163,0
Nass Gitwinksihlkw,1998,0,,164,0
Nass Gitwinksihlkw,1998,0,,165,0
Nass Gitwinksihlkw,1998,0,,166,0
Nass Gitwinksihlkw,1998,0,,167,0
Nass Gitwinksihlkw,1998,0,,168,0
Nass Gitwinksihlkw,1998,0,,169,0
Nass Gitwinksihlkw,1998,0,,170,0
Nass Gitwinksihlkw,1998,0,,171,0
Nass Gitwinksihlkw,1998,0,,172,0
Nass Gitwinksihlkw,1998,0,,173,0
Nass Gitwinksihlkw,1998,0,,174,0
Nass Gitwinksihlkw,1998,0,,175,0
Nass Gitwinksihlkw,1998,0,,176,0
Nass Gitwinksihlkw,1998,0,,177,0
Nass Gitwinksihlkw,1998,0,,178,0
Nass Gitwinksihlkw,1998,0,,179,0
Nass Gitwinksihlkw,1998,0,,180,0
Nass Gitwinksihlkw,1998,0,,181,0
Nass Gitwinksihlkw,1998,0,,182,0
Nass Gitwinksihlkw,1998,0,,183,0
Nass Gitwinksihlkw,1998,1,,184,1
Nass Gitwinksihlkw,1998,0,,185,1
Nass Gitwinksihlkw,1998,0,,186,1
Nass Gitwinksihlkw,1998,0,,187,1
Nass Gitwinksihlkw,1998,1,,188,2
Nass Gitwinksihlkw,1998,1,,189,3
Nass Gitwinksihlkw,1998,0,,190,3
Nass Gitwinksihlkw,1998,2,,191,5
Nass Gitwinksihlkw,1998,4,,192,9
Nass Gitwinksihlkw,1998,4,,193,13
Nass Gitwinksihlkw,1998,3,,194,16
Nass Gitwinksihlkw,1998,12,,195,28
Nass Gitwinksihlkw,1998,10,,196,38
Nass Gitwinksihlkw,1998,12,,197,50
Nass Gitwinksihlkw,1998,14,,198,64
Nass Gitwinksihlkw,1998,15,,199,79
Nass Gitwinksihlkw,1998,29,,200,108
Nass Gitwinksihlkw,1998,28,,201,136
Nass Gitwinksihlkw,1998,34,,202,170
Nass Gitwinksihlkw,1998,27,,203,197
Nass Gitwinksihlkw,1998,51,,204,248
Nass Gitwinksihlkw,1998,67,,205,315
Nass Gitwinksihlkw,1998,166,,206,481
Nass Gitwinksihlkw,1998,102,,207,583
Nass Gitwinksihlkw,1998,65,,208,648
Nass Gitwinksihlkw,1998,136,,209,784
Nass Gitwinksihlkw,1998,140,,210,924
Nass Gitwinksihlkw,1998,213,,211,1137
Nass Gitwinksihlkw,1998,360,,212,1497
Nass Gitwinksihlkw,1998,472,,213,1969
Nass Gitwinksihlkw,1998,266,,214,2235
Nass Gitwinksihlkw,1998,398,,215,2633
Nass Gitwinksihlkw,1998,147,,216,2780
Nass Gitwinksihlkw,1998,310,,217,3090
Nass Gitwinksihlkw,1998,224,,218,3314
Nass Gitwinksihlkw,1998,250,,219,3564
Nass Gitwinksihlkw,1998,86,,220,3650
Nass Gitwinksihlkw,1998,10,,221,3660
Nass Gitwinksihlkw,1998,11,,222,3671
Nass Gitwinksihlkw,1998,78,,223,3749
Nass Gitwinksihlkw,1998,91,,224,3840
Nass Gitwinksihlkw,1998,84,,225,3924
Nass Gitwinksihlkw,1998,11,,226,3935
Nass Gitwinksihlkw,1998,125,,227,4060
Nass Gitwinksihlkw,1998,564,,228,4624
Nass Gitwinksihlkw,1998,285,,229,4909
Nass Gitwinksihlkw,1998,467,,230,5376
Nass Gitwinksihlkw,1998,353,,231,5729
Nass Gitwinksihlkw,1998,336,,232,6065
Nass Gitwinksihlkw,1998,229,,233,6294
Nass Gitwinksihlkw,1998,219,,234,6513
Nass Gitwinksihlkw,1998,117,,235,6630
Nass Gitwinksihlkw,1998,88,,236,6718
Nass Gitwinksihlkw,1998,65,,237,6783
Nass Gitwinksihlkw,1998,56,,238,6839
Nass Gitwinksihlkw,1998,94,,239,6933
Nass Gitwinksihlkw,1998,37,,240,6970
Nass Gitwinksihlkw,1998,11,,241,6981
Nass Gitwinksihlkw,1998,5,,242,6986
Nass Gitwinksihlkw,1998,52,,243,7038
Nass Gitwinksihlkw,1998,19,,244,7057
Nass Gitwinksihlkw,1998,21,,245,7078
Nass Gitwinksihlkw,1998,35,,246,7113
Nass Gitwinksihlkw,1998,57,,247,7170
Nass Gitwinksihlkw,1998,5,,248,7175
Nass Gitwinksihlkw,1998,8,,249,7183
Nass Gitwinksihlkw,1998,2,,250,7185
Nass Gitwinksihlkw,1998,8,,251,7193
Nass Gitwinksihlkw,1998,15,,252,7208
Nass Gitwinksihlkw,1998,14,,253,7222
Nass Gitwinksihlkw,1998,0,,254,7222
Nass Gitwinksihlkw,1998,2,,255,7224
Nass Gitwinksihlkw,1998,1,,256,7225
Nass Gitwinksihlkw,1998,2,,257,7227
Nass Gitwinksihlkw,1998,4,,258,7231
Nass Gitwinksihlkw,1998,3,,259,7234
Nass Gitwinksihlkw,1998,0,,260,7234
Nass Gitwinksihlkw,1998,0,,261,7234
Nass Gitwinksihlkw,1998,0,,262,7234
Nass Gitwinksihlkw,1998,0,,263,7234
Nass Gitwinksihlkw,1998,0,,264,7234
Nass Gitwinksihlkw,1998,0,,265,7234
Nass Gitwinksihlkw,1998,0,,266,7234
Nass Gitwinksihlkw,1998,0,,267,7234
Nass Gitwinksihlkw,1998,0,,268,7234
Nass Gitwinksihlkw,1998,0,,269,7234
Nass Gitwinksihlkw,1998,0,,270,7234
Nass Gitwinksihlkw,1998,0,,271,7234
Nass Gitwinksihlkw,1998,0,,272,7234
Nass Gitwinksihlkw,1998,0,,273,7234
Nass Gitwinksihlkw,1998,0,,274,7234
Nass Gitwinksihlkw,1998,0,,275,7234
Nass Gitwinksihlkw,1998,0,,276,7234
Nass Gitwinksihlkw,1998,0,,277,7234
Nass Gitwinksihlkw,1998,0,,278,7234
Nass Gitwinksihlkw,1998,0,,279,7234
Nass Gitwinksihlkw,1998,0,,280,7234
Nass Gitwinksihlkw,1998,0,,281,7234
Nass Gitwinksihlkw,1998,0,,282,7234
Nass Gitwinksihlkw,1998,0,,283,7234
Nass Gitwinksihlkw,1998,0,,284,7234
Nass Gitwinksihlkw,1998,0,,285,7234
Nass Gitwinksihlkw,1998,0,,286,7234
Nass Gitwinksihlkw,2000,0,,152,0
Nass Gitwinksihlkw,2000,0,,153,0
Nass Gitwinksihlkw,2000,0,,154,0
Nass Gitwinksihlkw,2000,0,,155,0
Nass Gitwinksihlkw,2000,0,,156,0
Nass Gitwinksihlkw,2000,0,,157,0
Nass Gitwinksihlkw,2000,0,,158,0
Nass Gitwinksihlkw,2000,0,,159,0
Nass Gitwinksihlkw,2000,0,,160,0
Nass Gitwinksihlkw,2000,0,,161,0
Nass Gitwinksihlkw,2000,0,,162,0
Nass Gitwinksihlkw,2000,0,,163,0
Nass Gitwinksihlkw,2000,0,,164,0
Nass Gitwinksihlkw,2000,0,,165,0
Nass Gitwinksihlkw,2000,0,,166,0
Nass Gitwinksihlkw,2000,0,,167,0
Nass Gitwinksihlkw,2000,0,,168,0
Nass Gitwinksihlkw,2000,0,,169,0
Nass Gitwinksihlkw,2000,0,,170,0
Nass Gitwinksihlkw,2000,0,,171,0
Nass Gitwinksihlkw,2000,0,,172,0
Nass Gitwinksihlkw,2000,0,,173,0
Nass Gitwinksihlkw,2000,0,,174,0
Nass Gitwinksihlkw,2000,0,,175,0
Nass Gitwinksihlkw,2000,0,,176,0
Nass Gitwinksihlkw,2000,0,,177,0
Nass Gitwinksihlkw,2000,0,,178,0
Nass Gitwinksihlkw,2000,0,,179,0
Nass Gitwinksihlkw,2000,0,,180,0
Nass Gitwinksihlkw,2000,0,,181,0
Nass Gitwinksihlkw,2000,0,,182,0
Nass Gitwinksihlkw,2000,0,,183,0
Nass Gitwinksihlkw,2000,0,,184,0
Nass Gitwinksihlkw,2000,0,,185,0
Nass Gitwinksihlkw,2000,0,,186,0
Nass Gitwinksihlkw,2000,0,,187,0
Nass Gitwinksihlkw,2000,0,,188,0
Nass Gitwinksihlkw,2000,0,,189,0
Nass Gitwinksihlkw,2000,0,,190,0
Nass Gitwinksihlkw,2000,0,,191,0
Nass Gitwinksihlkw,2000,0,,192,0
Nass Gitwinksihlkw,2000,0,,193,0
Nass Gitwinksihlkw,2000,3,,194,3
Nass Gitwinksihlkw,2000,3,,195,6
Nass Gitwinksihlkw,2000,6,,196,12
Nass Gitwinksihlkw,2000,3,,197,15
Nass Gitwinksihlkw,2000,4,,198,19
Nass Gitwinksihlkw,2000,5,,199,24
Nass Gitwinksihlkw,2000,8,,200,32
Nass Gitwinksihlkw,2000,16,,201,48
Nass Gitwinksihlkw,2000,5,,202,53
Nass Gitwinksihlkw,2000,1,,203,54
Nass Gitwinksihlkw,2000,0,,204,54
Nass Gitwinksihlkw,2000,29,,205,83
Nass Gitwinksihlkw,2000,22,,206,105
Nass Gitwinksihlkw,2000,21,,207,126
Nass Gitwinksihlkw,2000,15,,208,141
Nass Gitwinksihlkw,2000,5,,209,146
Nass Gitwinksihlkw,2000,7,,210,153
Nass Gitwinksihlkw,2000,0,,211,153
Nass Gitwinksihlkw,2000,9,,212,162
Nass Gitwinksihlkw,2000,53,,213,215
Nass Gitwinksihlkw,2000,8,,214,223
Nass Gitwinksihlkw,2000,36,,215,259
Nass Gitwinksihlkw,2000,331,,216,590
Nass Gitwinksihlkw,2000,503,,217,1093
Nass Gitwinksihlkw,2000,452,,218,1545
Nass Gitwinksihlkw,2000,311,,219,1856
Nass Gitwinksihlkw,2000,484,,220,2340
Nass Gitwinksihlkw,2000,421,,221,2761
Nass Gitwinksihlkw,2000,506,,222,3267
Nass Gitwinksihlkw,2000,393,,223,3660
Nass Gitwinksihlkw,2000,500,,224,4160
Nass Gitwinksihlkw,2000,358,,225,4518
Nass Gitwinksihlkw,2000,297,,226,4815
Nass Gitwinksihlkw,2000,307,,227,5122
Nass Gitwinksihlkw,2000,174,,228,5296
Nass Gitwinksihlkw,2000,103,,229,5399
Nass Gitwinksihlkw,2000,74,,230,5473
Nass Gitwinksihlkw,2000,61,,231,5534
Nass Gitwinksihlkw,2000,104,,232,5638
Nass Gitwinksihlkw,2000,89,,233,5727
Nass Gitwinksihlkw,2000,58,,234,5785
Nass Gitwinksihlkw,2000,7,,235,5792
Nass Gitwinksihlkw,2000,0,,236,5792
Nass Gitwinksihlkw,2000,11,,237,5803
Nass Gitwinksihlkw,2000,16,,238,5819
Nass Gitwinksihlkw,2000,8,,239,5827
Nass Gitwinksihlkw,2000,50,,240,5877
Nass Gitwinksihlkw,2000,59,,241,5936
Nass Gitwinksihlkw,2000,73,,242,6009
Nass Gitwinksihlkw,2000,107,,243,6116
Nass Gitwinksihlkw,2000,109,,244,6225
Nass Gitwinksihlkw,2000,90,,245,6315
Nass Gitwinksihlkw,2000,54,,246,6369
Nass Gitwinksihlkw,2000,94,,247,6463
Nass Gitwinksihlkw,2000,42,,248,6505
Nass Gitwinksihlkw,2000,30,,249,6535
Nass Gitwinksihlkw,2000,8,,250,6543
Nass Gitwinksihlkw,2000,4,,251,6547
Nass Gitwinksihlkw,2000,11,,252,6558
Nass Gitwinksihlkw,2000,3,,253,6561
Nass Gitwinksihlkw,2000,8,,254,6569
Nass Gitwinksihlkw,2000,10,,255,6579
Nass Gitwinksihlkw,2000,13,,256,6592
Nass Gitwinksihlkw,2000,8,,257,6600
Nass Gitwinksihlkw,2000,4,,258,6604
Nass Gitwinksihlkw,2000,3,,259,6607
Nass Gitwinksihlkw,2000,10,,260,6617
Nass Gitwinksihlkw,2000,1,,261,6618
Nass Gitwinksihlkw,2000,0,,262,6618
Nass Gitwinksihlkw,2000,0,,263,6618
Nass Gitwinksihlkw,2000,0,,264,6618
Nass Gitwinksihlkw,2000,0,,265,6618
Nass Gitwinksihlkw,2000,0,,266,6618
Nass Gitwinksihlkw,2000,0,,267,6618
Nass Gitwinksihlkw,2000,0,,268,6618
Nass Gitwinksihlkw,2000,0,,269,6618
Nass Gitwinksihlkw,2000,0,,270,6618
Nass Gitwinksihlkw,2000,0,,271,6618
Nass Gitwinksihlkw,2000,0,,272,6618
Nass Gitwinksihlkw,2000,0,,273,6618
Nass Gitwinksihlkw,2000,0,,274,6618
Nass Gitwinksihlkw,2000,0,,275,6618
Nass Gitwinksihlkw,2000,0,,276,6618
Nass Gitwinksihlkw,2000,0,,277,6618
Nass Gitwinksihlkw,2000,0,,278,6618
Nass Gitwinksihlkw,2000,0,,279,6618
Nass Gitwinksihlkw,2000,0,,280,6618
Nass Gitwinksihlkw,2000,0,,281,6618
Nass Gitwinksihlkw,2000,0,,282,6618
Nass Gitwinksihlkw,2000,0,,283,6618
Nass Gitwinksihlkw,2000,0,,284,6618
Nass Gitwinksihlkw,2000,0,,285,6618
Nass Gitwinksihlkw,2000,0,,286,6618
Nass Gitwinksihlkw,2000,0,,287,6618
Nass Gitwinksihlkw,2002,0,,151,0
Nass Gitwinksihlkw,2002,0,,152,0
Nass Gitwinksihlkw,2002,0,,153,0
Nass Gitwinksihlkw,2002,0,,154,0
Nass Gitwinksihlkw,2002,0,,155,0
Nass Gitwinksihlkw,2002,0,,156,0
Nass Gitwinksihlkw,2002,0,,157,0
Nass Gitwinksihlkw,2002,0,,158,0
Nass Gitwinksihlkw,2002,0,,159,0
Nass Gitwinksihlkw,2002,0,,160,0
Nass Gitwinksihlkw,2002,0,,161,0
Nass Gitwinksihlkw,2002,0,,162,0
Nass Gitwinksihlkw,2002,0,,163,0
Nass Gitwinksihlkw,2002,0,,164,0
Nass Gitwinksihlkw,2002,0,,165,0
Nass Gitwinksihlkw,2002,0,,166,0
Nass Gitwinksihlkw,2002,0,,167,0
Nass Gitwinksihlkw,2002,0,,168,0
Nass Gitwinksihlkw,2002,0,,169,0
Nass Gitwinksihlkw,2002,0,,170,0
Nass Gitwinksihlkw,2002,0,,171,0
Nass Gitwinksihlkw,2002,0,,172,0
Nass Gitwinksihlkw,2002,0,,173,0
Nass Gitwinksihlkw,2002,0,,174,0
Nass Gitwinksihlkw,2002,0,,175,0
Nass Gitwinksihlkw,2002,0,,176,0
Nass Gitwinksihlkw,2002,0,,177,0
Nass Gitwinksihlkw,2002,0,,178,0
Nass Gitwinksihlkw,2002,0,,179,0
Nass Gitwinksihlkw,2002,0,,180,0
Nass Gitwinksihlkw,2002,0,,181,0
Nass Gitwinksihlkw,2002,0,,182,0
Nass Gitwinksihlkw,2002,0,,183,0
Nass Gitwinksihlkw,2002,0,,184,0
Nass Gitwinksihlkw,2002,0,,185,0
Nass Gitwinksihlkw,2002,0,,186,0
Nass Gitwinksihlkw,2002,0,,187,0
Nass Gitwinksihlkw,2002,0,,188,0
Nass Gitwinksihlkw,2002,0,,189,0
Nass Gitwinksihlkw,2002,3,,190,3
Nass Gitwinksihlkw,2002,0,,191,3
Nass Gitwinksihlkw,2002,0,,192,3
Nass Gitwinksihlkw,2002,1,,193,4
Nass Gitwinksihlkw,2002,3,,194,7
Nass Gitwinksihlkw,2002,6,,195,13
Nass Gitwinksihlkw,2002,12,,196,25
Nass Gitwinksihlkw,2002,9,,197,34
Nass Gitwinksihlkw,2002,6,,198,40
Nass Gitwinksihlkw,2002,1,,199,41
Nass Gitwinksihlkw,2002,4,,200,45
Nass Gitwinksihlkw,2002,10,,201,55
Nass Gitwinksihlkw,2002,20,,202,75
Nass Gitwinksihlkw,2002,24,,203,99
Nass Gitwinksihlkw,2002,15,,204,114
Nass Gitwinksihlkw,2002,24,,205,138
Nass Gitwinksihlkw,2002,24,,206,162
Nass Gitwinksihlkw,2002,27,,207,189
Nass Gitwinksihlkw,2002,84,,208,273
Nass Gitwinksihlkw,2002,97,,209,370
Nass Gitwinksihlkw,2002,110,,210,480
Nass Gitwinksihlkw,2002,158,,211,638
Nass Gitwinksihlkw,2002,252,,212,890
Nass Gitwinksihlkw,2002,131,,213,1021
Nass Gitwinksihlkw,2002,151,,214,1172
Nass Gitwinksihlkw,2002,156,,215,1328
Nass Gitwinksihlkw,2002,303,,216,1631
Nass Gitwinksihlkw,2002,266,,217,1897
Nass Gitwinksihlkw,2002,232,,218,2129
Nass Gitwinksihlkw,2002,212,,219,2341
Nass Gitwinksihlkw,2002,229,,220,2570
Nass Gitwinksihlkw,2002,79,,221,2649
Nass Gitwinksihlkw,2002,34,,222,2683
Nass Gitwinksihlkw,2002,237,,223,2920
Nass Gitwinksihlkw,2002,370,,224,3290
Nass Gitwinksihlkw,2002,262,,225,3552
Nass Gitwinksihlkw,2002,121,,226,3673
Nass Gitwinksihlkw,2002,240,,227,3913
Nass Gitwinksihlkw,2002,547,,228,4460
Nass Gitwinksihlkw,2002,608,,229,5068
Nass Gitwinksihlkw,2002,326,,230,5394
Nass Gitwinksihlkw,2002,223,,231,5617
Nass Gitwinksihlkw,2002,139,,232,5756
Nass Gitwinksihlkw,2002,139,,233,5895
Nass Gitwinksihlkw,2002,92,,234,5987
Nass Gitwinksihlkw,2002,35,,235,6022
Nass Gitwinksihlkw,2002,11,,236,6033
Nass Gitwinksihlkw,2002,30,,237,6063
Nass Gitwinksihlkw,2002,69,,238,6132
Nass Gitwinksihlkw,2002,44,,239,6176
Nass Gitwinksihlkw,2002,12,,240,6188
Nass Gitwinksihlkw,2002,2,,241,6190
Nass Gitwinksihlkw,2002,77,,242,6267
Nass Gitwinksihlkw,2002,227,,243,6494
Nass Gitwinksihlkw,2002,273,,244,6767
Nass Gitwinksihlkw,2002,190,,245,6957
Nass Gitwinksihlkw,2002,334,,246,7291
Nass Gitwinksihlkw,2002,661,,247,7952
Nass Gitwinksihlkw,2002,377,,248,8329
Nass Gitwinksihlkw,2002,275,,249,8604
Nass Gitwinksihlkw,2002,35,,250,8639
Nass Gitwinksihlkw,2002,31,,251,8670
Nass Gitwinksihlkw,2002,35,,252,8705
Nass Gitwinksihlkw,2002,0,,253,8705
Nass Gitwinksihlkw,2002,0,,254,8705
Nass Gitwinksihlkw,2002,0,,255,8705
Nass Gitwinksihlkw,2002,0,,256,8705
Nass Gitwinksihlkw,2002,0,,257,8705
Nass Gitwinksihlkw,2002,0,,258,8705
Nass Gitwinksihlkw,2002,0,,259,8705
Nass Gitwinksihlkw,2002,0,,260,8705
Nass Gitwinksihlkw,2002,0,,261,8705
Nass Gitwinksihlkw,2002,0,,262,8705
Nass Gitwinksihlkw,2002,0,,263,8705
Nass Gitwinksihlkw,2002,0,,264,8705
Nass Gitwinksihlkw,2002,0,,265,8705
Nass Gitwinksihlkw,2002,0,,266,8705
Nass Gitwinksihlkw,2002,0,,267,8705
Nass Gitwinksihlkw,2002,0,,268,8705
Nass Gitwinksihlkw,2002,0,,269,8705
Nass Gitwinksihlkw,2002,0,,270,8705
Nass Gitwinksihlkw,2002,0,,271,8705
Nass Gitwinksihlkw,2002,0,,272,8705
Nass Gitwinksihlkw,2002,0,,273,8705
Nass Gitwinksihlkw,2002,0,,274,8705
Nass Gitwinksihlkw,2002,0,,275,8705
Nass Gitwinksihlkw,2002,0,,276,8705
Nass Gitwinksihlkw,2002,0,,277,8705
Nass Gitwinksihlkw,2002,0,,278,8705
Nass Gitwinksihlkw,2002,0,,279,8705
Nass Gitwinksihlkw,2002,0,,280,8705
Nass Gitwinksihlkw,2002,0,,281,8705
Nass Gitwinksihlkw,2002,0,,282,8705
Nass Gitwinksihlkw,2002,0,,283,8705
Nass Gitwinksihlkw,2002,0,,284,8705
Nass Gitwinksihlkw,2002,0,,285,8705
Nass Gitwinksihlkw,2002,0,,286,8705
Nass Gitwinksihlkw,2004,0,,152,0
Nass Gitwinksihlkw,2004,0,,153,0
Nass Gitwinksihlkw,2004,0,,154,0
Nass Gitwinksihlkw,2004,0,,155,0
Nass Gitwinksihlkw,2004,0,,156,0
Nass Gitwinksihlkw,2004,0,,157,0
Nass Gitwinksihlkw,2004,0,,158,0
Nass Gitwinksihlkw,2004,0,,159,0
Nass Gitwinksihlkw,2004,0,,160,0
Nass Gitwinksihlkw,2004,0,,161,0
Nass Gitwinksihlkw,2004,0,,162,0
Nass Gitwinksihlkw,2004,0,,163,0
Nass Gitwinksihlkw,2004,0,,164,0
Nass Gitwinksihlkw,2004,0,,165,0
Nass Gitwinksihlkw,2004,0,,166,0
Nass Gitwinksihlkw,2004,0,,167,0
Nass Gitwinksihlkw,2004,0,,168,0
Nass Gitwinksihlkw,2004,0,,169,0
Nass Gitwinksihlkw,2004,0,,170,0
Nass Gitwinksihlkw,2004,0,,171,0
Nass Gitwinksihlkw,2004,0,,172,0
Nass Gitwinksihlkw,2004,0,,173,0
Nass Gitwinksihlkw,2004,0,,174,0
Nass Gitwinksihlkw,2004,0,,175,0
Nass Gitwinksihlkw,2004,0,,176,0
Nass Gitwinksihlkw,2004,0,,177,0
Nass Gitwinksihlkw,2004,0,,178,0
Nass Gitwinksihlkw,2004,0,,179,0
Nass Gitwinksihlkw,2004,0,,180,0
Nass Gitwinksihlkw,2004,0,,181,0
Nass Gitwinksihlkw,2004,0,,182,0
Nass Gitwinksihlkw,2004,1,,183,1
Nass Gitwinksihlkw,2004,0,,184,1
Nass Gitwinksihlkw,2004,0,,185,1
Nass Gitwinksihlkw,2004,3,,186,4
Nass Gitwinksihlkw,2004,4,,187,8
Nass Gitwinksihlkw,2004,0,,188,8
Nass Gitwinksihlkw,2004,0,,189,8
Nass Gitwinksihlkw,2004,0,,190,8
Nass Gitwinksihlkw,2004,0,,191,8
Nass Gitwinksihlkw,2004,9,,192,17
Nass Gitwinksihlkw,2004,13,,193,30
Nass Gitwinksihlkw,2004,13,,194,43
Nass Gitwinksihlkw,2004,23,,195,66
Nass Gitwinksihlkw,2004,22,,196,88
Nass Gitwinksihlkw,2004,43,,197,131
Nass Gitwinksihlkw,2004,30,,198,161
Nass Gitwinksihlkw,2004,31,,199,192
Nass Gitwinksihlkw,2004,78,,200,270
Nass Gitwinksihlkw,2004,99,,201,369
Nass Gitwinksihlkw,2004,153,,202,522
Nass Gitwinksihlkw,2004,38,,203,560
Nass Gitwinksihlkw,2004,82,,204,642
Nass Gitwinksihlkw,2004,115,,205,757
Nass Gitwinksihlkw,2004,437,,206,1194
Nass Gitwinksihlkw,2004,486,,207,1680
Nass Gitwinksihlkw,2004,264,,208,1944
Nass Gitwinksihlkw,2004,1328,,209,3272
Nass Gitwinksihlkw,2004,334,,210,3606
Nass Gitwinksihlkw,2004,334,,211,3940
Nass Gitwinksihlkw,2004,429,,212,4369
Nass Gitwinksihlkw,2004,717,,213,5086
Nass Gitwinksihlkw,2004,966,,214,6052
Nass Gitwinksihlkw,2004,779,,215,6831
Nass Gitwinksihlkw,2004,292,,216,7123
Nass Gitwinksihlkw,2004,537,,217,7660
Nass Gitwinksihlkw,2004,438,,218,8098
Nass Gitwinksihlkw,2004,836,,219,8934
Nass Gitwinksihlkw,2004,185,,220,9119
Nass Gitwinksihlkw,2004,739,,221,9858
Nass Gitwinksihlkw,2004,1171,,222,11029
Nass Gitwinksihlkw,2004,967,,223,11996
Nass Gitwinksihlkw,2004,472,,224,12468
Nass Gitwinksihlkw,2004,288,,225,12756
Nass Gitwinksihlkw,2004,578,,226,13334
Nass Gitwinksihlkw,2004,403,,227,13737
Nass Gitwinksihlkw,2004,235,,228,13972
Nass Gitwinksihlkw,2004,138,,229,14110
Nass Gitwinksihlkw,2004,204,,230,14314
Nass Gitwinksihlkw,2004,203,,231,14517
Nass Gitwinksihlkw,2004,124,,232,14641
Nass Gitwinksihlkw,2004,195,,233,14836
Nass Gitwinksihlkw,2004,305,,234,15141
Nass Gitwinksihlkw,2004,469,,235,15610
Nass Gitwinksihlkw,2004,183,,236,15793
Nass Gitwinksihlkw,2004,173,,237,15966
Nass Gitwinksihlkw,2004,78,,238,16044
Nass Gitwinksihlkw,2004,67,,239,16111
Nass Gitwinksihlkw,2004,62,,240,16173
Nass Gitwinksihlkw,2004,43,,241,16216
Nass Gitwinksihlkw,2004,24,,242,16240
Nass Gitwinksihlkw,2004,30,,243,16270
Nass Gitwinksihlkw,2004,53,,244,16323
Nass Gitwinksihlkw,2004,17,,245,16340
Nass Gitwinksihlkw,2004,21,,246,16361
Nass Gitwinksihlkw,2004,10,,247,16371
Nass Gitwinksihlkw,2004,3,,248,16374
Nass Gitwinksihlkw,2004,2,,249,16376
Nass Gitwinksihlkw,2004,9,,250,16385
Nass Gitwinksihlkw,2004,14,,251,16399
Nass Gitwinksihlkw,2004,11,,252,16410
Nass Gitwinksihlkw,2004,4,,253,16414
Nass Gitwinksihlkw,2004,1,,254,16415
Nass Gitwinksihlkw,2004,0,,255,16415
Nass Gitwinksihlkw,2004,0,,256,16415
Nass Gitwinksihlkw,2004,0,,257,16415
Nass Gitwinksihlkw,2004,0,,258,16415
Nass Gitwinksihlkw,2004,0,,259,16415
Nass Gitwinksihlkw,2004,0,,260,16415
Nass Gitwinksihlkw,2004,0,,261,16415
Nass Gitwinksihlkw,2004,0,,262,16415
Nass Gitwinksihlkw,2004,0,,263,16415
Nass Gitwinksihlkw,2004,0,,264,16415
Nass Gitwinksihlkw,2004,0,,265,16415
Nass Gitwinksihlkw,2004,0,,266,16415
Nass Gitwinksihlkw,2004,0,,267,16415
Nass Gitwinksihlkw,2004,0,,268,16415
Nass Gitwinksihlkw,2004,0,,269,16415
Nass Gitwinksihlkw,2004,0,,270,16415
Nass Gitwinksihlkw,2004,0,,271,16415
Nass Gitwinksihlkw,2004,0,,272,16415
Nass Gitwinksihlkw,2004,0,,273,16415
Nass Gitwinksihlkw,2004,0,,274,16415
Nass Gitwinksihlkw,2004,0,,275,16415
Nass Gitwinksihlkw,2004,0,,276,16415
Nass Gitwinksihlkw,2004,0,,277,16415
Nass Gitwinksihlkw,2004,0,,278,16415
Nass Gitwinksihlkw,2004,0,,279,16415
Nass Gitwinksihlkw,2004,0,,280,16415
Nass Gitwinksihlkw,2004,0,,281,16415
Nass Gitwinksihlkw,2004,0,,282,16415
Nass Gitwinksihlkw,2004,0,,283,16415
Nass Gitwinksihlkw,2004,0,,284,16415
Nass Gitwinksihlkw,2004,0,,285,16415
Nass Gitwinksihlkw,2004,0,,286,16415
Nass Gitwinksihlkw,2004,0,,287,16415
Nass Gitwinksihlkw,2006,0,,151,0
Nass Gitwinksihlkw,2006,0,,152,0
Nass Gitwinksihlkw,2006,0,,153,0
Nass Gitwinksihlkw,2006,0,,154,0
Nass Gitwinksihlkw,2006,0,,155,0
Nass Gitwinksihlkw,2006,0,,156,0
Nass Gitwinksihlkw,2006,0,,157,0
Nass Gitwinksihlkw,2006,0,,158,0
Nass Gitwinksihlkw,2006,0,,159,0
Nass Gitwinksihlkw,2006,0,,160,0
Nass Gitwinksihlkw,2006,0,,161,0
Nass Gitwinksihlkw,2006,0,,162,0
Nass Gitwinksihlkw,2006,0,,163,0
Nass Gitwinksihlkw,2006,0,,164,0
Nass Gitwinksihlkw,2006,0,,165,0
Nass Gitwinksihlkw,2006,0,,166,0
Nass Gitwinksihlkw,2006,0,,167,0
Nass Gitwinksihlkw,2006,0,,168,0
Nass Gitwinksihlkw,2006,0,,169,0
Nass Gitwinksihlkw,2006,0,,170,0
Nass Gitwinksihlkw,2006,0,,171,0
Nass Gitwinksihlkw,2006,0,,172,0
Nass Gitwinksihlkw,2006,0,,173,0
Nass Gitwinksihlkw,2006,0,,174,0
Nass Gitwinksihlkw,2006,0,,175,0
Nass Gitwinksihlkw,2006,0,,176,0
Nass Gitwinksihlkw,2006,0,,177,0
Nass Gitwinksihlkw,2006,0,,178,0
Nass Gitwinksihlkw,2006,0,,179,0
Nass Gitwinksihlkw,2006,0,,180,0
Nass Gitwinksihlkw,2006,0,,181,0
Nass Gitwinksihlkw,2006,0,,182,0
Nass Gitwinksihlkw,2006,0,,183,0
Nass Gitwinksihlkw,2006,0,,184,0
Nass Gitwinksihlkw,2006,1,,185,1
Nass Gitwinksihlkw,2006,1,,186,2
Nass Gitwinksihlkw,2006,0,,187,2
Nass Gitwinksihlkw,2006,1,,188,3
Nass Gitwinksihlkw,2006,1,,189,4
Nass Gitwinksihlkw,2006,0,,190,4
Nass Gitwinksihlkw,2006,0,,191,4
Nass Gitwinksihlkw,2006,1,,192,5
Nass Gitwinksihlkw,2006,3,,193,8
Nass Gitwinksihlkw,2006,3,,194,11
Nass Gitwinksihlkw,2006,1,,195,12
Nass Gitwinksihlkw,2006,2,,196,14
Nass Gitwinksihlkw,2006,4,,197,18
Nass Gitwinksihlkw,2006,7,,198,25
Nass Gitwinksihlkw,2006,15,,199,40
Nass Gitwinksihlkw,2006,29,,200,69
Nass Gitwinksihlkw,2006,19,,201,88
Nass Gitwinksihlkw,2006,26,,202,114
Nass Gitwinksihlkw,2006,13,,203,127
Nass Gitwinksihlkw,2006,1,,204,128
Nass Gitwinksihlkw,2006,5,,205,133
Nass Gitwinksihlkw,2006,31,,206,164
Nass Gitwinksihlkw,2006,25,,207,189
Nass Gitwinksihlkw,2006,13,,208,202
Nass Gitwinksihlkw,2006,63,,209,265
Nass Gitwinksihlkw,2006,107,,210,372
Nass Gitwinksihlkw,2006,112,,211,484
Nass Gitwinksihlkw,2006,98,,212,582
Nass Gitwinksihlkw,2006,75,,213,657
Nass Gitwinksihlkw,2006,88,,214,745
Nass Gitwinksihlkw,2006,75,,215,820
Nass Gitwinksihlkw,2006,115,,216,935
Nass Gitwinksihlkw,2006,101,,217,1036
Nass Gitwinksihlkw,2006,85,,218,1121
Nass Gitwinksihlkw,2006,76,,219,1197
Nass Gitwinksihlkw,2006,74,,220,1271
Nass Gitwinksihlkw,2006,30,,221,1301
Nass Gitwinksihlkw,2006,30,,222,1331
Nass Gitwinksihlkw,2006,27,,223,1358
Nass Gitwinksihlkw,2006,34,,224,1392
Nass Gitwinksihlkw,2006,45,,225,1437
Nass Gitwinksihlkw,2006,30,,226,1467
Nass Gitwinksihlkw,2006,25,,227,1492
Nass Gitwinksihlkw,2006,44,,228,1536
Nass Gitwinksihlkw,2006,58,,229,1594
Nass Gitwinksihlkw,2006,63,,230,1657
Nass Gitwinksihlkw,2006,61,,231,1718
Nass Gitwinksihlkw,2006,48,,232,1766
Nass Gitwinksihlkw,2006,37,,233,1803
Nass Gitwinksihlkw,2006,18,,234,1821
Nass Gitwinksihlkw,2006,13,,235,1834
Nass Gitwinksihlkw,2006,5,,236,1839
Nass Gitwinksihlkw,2006,8,,237,1847
Nass Gitwinksihlkw,2006,30,,238,1877
Nass Gitwinksihlkw,2006,12,,239,1889
Nass Gitwinksihlkw,2006,8,,240,1897
Nass Gitwinksihlkw,2006,15,,241,1912
Nass Gitwinksihlkw,2006,7,,242,1919
Nass Gitwinksihlkw,2006,6,,243,1925
Nass Gitwinksihlkw,2006,14,,244,1939
Nass Gitwinksihlkw,2006,10,,245,1949
Nass Gitwinksihlkw,2006,12,,246,1961
Nass Gitwinksihlkw,2006,0,,247,1961
Nass Gitwinksihlkw,2006,0,,248,1961
Nass Gitwinksihlkw,2006,0,,249,1961
Nass Gitwinksihlkw,2006,0,,250,1961
Nass Gitwinksihlkw,2006,0,,251,1961
Nass Gitwinksihlkw,2006,0,,252,1961
Nass Gitwinksihlkw,2006,0,,253,1961
Nass Gitwinksihlkw,2006,0,,254,1961
Nass Gitwinksihlkw,2006,0,,255,1961
Nass Gitwinksihlkw,2006,0,,256,1961
Nass Gitwinksihlkw,2006,0,,257,1961
Nass Gitwinksihlkw,2006,0,,258,1961
Nass Gitwinksihlkw,2006,0,,259,1961
Nass Gitwinksihlkw,2006,0,,260,1961
Nass Gitwinksihlkw,2006,0,,261,1961
Nass Gitwinksihlkw,2006,0,,262,1961
Nass Gitwinksihlkw,2006,0,,263,1961
Nass Gitwinksihlkw,2006,0,,264,1961
Nass Gitwinksihlkw,2006,0,,265,1961
Nass Gitwinksihlkw,2006,0,,266,1961
Nass Gitwinksihlkw,2006,0,,267,1961
Nass Gitwinksihlkw,2006,0,,268,1961
Nass Gitwinksihlkw,2006,0,,269,1961
Nass Gitwinksihlkw,2006,0,,270,1961
Nass Gitwinksihlkw,2006,0,,271,1961
Nass Gitwinksihlkw,2006,0,,272,1961
Nass Gitwinksihlkw,2006,0,,273,1961
Nass Gitwinksihlkw,2006,0,,274,1961
Nass Gitwinksihlkw,2006,0,,275,1961
Nass Gitwinksihlkw,2006,0,,276,1961
Nass Gitwinksihlkw,2006,0,,277,1961
Nass Gitwinksihlkw,2006,0,,278,1961
Nass Gitwinksihlkw,2006,0,,279,1961
Nass Gitwinksihlkw,2006,0,,280,1961
Nass Gitwinksihlkw,2006,0,,281,1961
Nass Gitwinksihlkw,2006,0,,282,1961
Nass Gitwinksihlkw,2006,0,,283,1961
Nass Gitwinksihlkw,2006,0,,284,1961
Nass Gitwinksihlkw,2006,0,,285,1961
Nass Gitwinksihlkw,2006,0,,286,1961
Nass Gitwinksihlkw,2008,0,,152,0
Nass Gitwinksihlkw,2008,0,,153,0
Nass Gitwinksihlkw,2008,0,,154,0
Nass Gitwinksihlkw,2008,0,,155,0
Nass Gitwinksihlkw,2008,0,,156,0
Nass Gitwinksihlkw,2008,0,,157,0
Nass Gitwinksihlkw,2008,0,,158,0
Nass Gitwinksihlkw,2008,0,,159,0
Nass Gitwinksihlkw,2008,0,,160,0
Nass Gitwinksihlkw,2008,0,,161,0
Nass Gitwinksihlkw,2008,0,,162,0
Nass Gitwinksihlkw,2008,0,,163,0
Nass Gitwinksihlkw,2008,0,,164,0
Nass Gitwinksihlkw,2008,0,,165,0
Nass Gitwinksihlkw,2008,0,,166,0
Nass Gitwinksihlkw,2008,0,,167,0
Nass Gitwinksihlkw,2008,0,,168,0
Nass Gitwinksihlkw,2008,0,,169,0
Nass Gitwinksihlkw,2008,0,,170,0
Nass Gitwinksihlkw,2008,0,,171,0
Nass Gitwinksihlkw,2008,0,,172,0
Nass Gitwinksihlkw,2008,0,,173,0
Nass Gitwinksihlkw,2008,0,,174,0
Nass Gitwinksihlkw,2008,0,,175,0
Nass Gitwinksihlkw,2008,0,,176,0
Nass Gitwinksihlkw,2008,0,,177,0
Nass Gitwinksihlkw,2008,0,,178,0
Nass Gitwinksihlkw,2008,0,,179,0
Nass Gitwinksihlkw,2008,0,,180,0
Nass Gitwinksihlkw,2008,0,,181,0
Nass Gitwinksihlkw,2008,0,,182,0
Nass Gitwinksihlkw,2008,0,,183,0
Nass Gitwinksihlkw,2008,0,,184,0
Nass Gitwinksihlkw,2008,0,,185,0
Nass Gitwinksihlkw,2008,0,,186,0
Nass Gitwinksihlkw,2008,0,,187,0
Nass Gitwinksihlkw,2008,0,,188,0
Nass Gitwinksihlkw,2008,0,,189,0
Nass Gitwinksihlkw,2008,0,,190,0
Nass Gitwinksihlkw,2008,0,,191,0
Nass Gitwinksihlkw,2008,0,,192,0
Nass Gitwinksihlkw,2008,1,,193,1
Nass Gitwinksihlkw,2008,1,,194,2
Nass Gitwinksihlkw,2008,1,,195,3
Nass Gitwinksihlkw,2008,5,,196,8
Nass Gitwinksihlkw,2008,6,,197,14
Nass Gitwinksihlkw,2008,5,,198,19
Nass Gitwinksihlkw,2008,6,,199,25
Nass Gitwinksihlkw,2008,9,,200,34
Nass Gitwinksihlkw,2008,4,,201,38
Nass Gitwinksihlkw,2008,7,,202,45
Nass Gitwinksihlkw,2008,5,,203,50
Nass Gitwinksihlkw,2008,3,,204,53
Nass Gitwinksihlkw,2008,7,,205,60
Nass Gitwinksihlkw,2008,6,,206,66
Nass Gitwinksihlkw,2008,20,,207,86
Nass Gitwinksihlkw,2008,18,,208,104
Nass Gitwinksihlkw,2008,20,,209,124
Nass Gitwinksihlkw,2008,18,,210,142
Nass Gitwinksihlkw,2008,20,,211,162
Nass Gitwinksihlkw,2008,37,,212,199
Nass Gitwinksihlkw,2008,13,,213,212
Nass Gitwinksihlkw,2008,31,,214,243
Nass Gitwinksihlkw,2008,50,,215,293
Nass Gitwinksihlkw,2008,27,,216,320
Nass Gitwinksihlkw,2008,30,,217,350
Nass Gitwinksihlkw,2008,44,,218,394
Nass Gitwinksihlkw,2008,52,,219,446
Nass Gitwinksihlkw,2008,34,,220,480
Nass Gitwinksihlkw,2008,36,,221,516
Nass Gitwinksihlkw,2008,48,,222,564
Nass Gitwinksihlkw,2008,63,,223,627
Nass Gitwinksihlkw,2008,75,,224,702
Nass Gitwinksihlkw,2008,64,,225,766
Nass Gitwinksihlkw,2008,32,,226,798
Nass Gitwinksihlkw,2008,12,,227,810
Nass Gitwinksihlkw,2008,6,,228,816
Nass Gitwinksihlkw,2008,22,,229,838
Nass Gitwinksihlkw,2008,24,,230,862
Nass Gitwinksihlkw,2008,48,,231,910
Nass Gitwinksihlkw,2008,28,,232,938
Nass Gitwinksihlkw,2008,20,,233,958
Nass Gitwinksihlkw,2008,31,,234,989
Nass Gitwinksihlkw,2008,65,,235,1054
Nass Gitwinksihlkw,2008,36,,236,1090
Nass Gitwinksihlkw,2008,23,,237,1113
Nass Gitwinksihlkw,2008,1,,238,1114
Nass Gitwinksihlkw,2008,0,,239,1114
Nass Gitwinksihlkw,2008,9,,240,1123
Nass Gitwinksihlkw,2008,53,,241,1176
Nass Gitwinksihlkw,2008,33,,242,1209
Nass Gitwinksihlkw,2008,32,,243,1241
Nass Gitwinksihlkw,2008,39,,244,1280
Nass Gitwinksihlkw,2008,30,,245,1310
Nass Gitwinksihlkw,2008,10,,246,1320
Nass Gitwinksihlkw,2008,8,,247,1328
Nass Gitwinksihlkw,2008,11,,248,1339
Nass Gitwinksihlkw,2008,6,,249,1345
Nass Gitwinksihlkw,2008,12,,250,1357
Nass Gitwinksihlkw,2008,0,,251,1357
Nass Gitwinksihlkw,2008,0,,252,1357
Nass Gitwinksihlkw,2008,0,,253,1357
Nass Gitwinksihlkw,2008,0,,254,1357
Nass Gitwinksihlkw,2008,0,,255,1357
Nass Gitwinksihlkw,2008,0,,256,1357
Nass Gitwinksihlkw,2008,0,,257,1357
Nass Gitwinksihlkw,2008,0,,258,1357
Nass Gitwinksihlkw,2008,0,,259,1357
Nass Gitwinksihlkw,2008,0,,260,1357
Nass Gitwinksihlkw,2008,0,,261,1357
Nass Gitwinksihlkw,2008,0,,262,1357
Nass Gitwinksihlkw,2008,0,,263,1357
Nass Gitwinksihlkw,2008,0,,264,1357
Nass Gitwinksihlkw,2008,0,,265,1357
Nass Gitwinksihlkw,2008,0,,266,1357
Nass Gitwinksihlkw,2008,0,,267,1357
Nass Gitwinksihlkw,2008,0,,268,1357
Nass Gitwinksihlkw,2008,0,,269,1357
Nass Gitwinksihlkw,2008,0,,270,1357
Nass Gitwinksihlkw,2008,0,,271,1357
Nass Gitwinksihlkw,2008,0,,272,1357
Nass Gitwinksihlkw,2008,0,,273,1357
Nass Gitwinksihlkw,2008,0,,274,1357
Nass Gitwinksihlkw,2008,0,,275,1357
Nass Gitwinksihlkw,2008,0,,276,1357
Nass Gitwinksihlkw,2008,0,,277,1357
Nass Gitwinksihlkw,2008,0,,278,1357
Nass Gitwinksihlkw,2008,0,,279,1357
Nass Gitwinksihlkw,2008,0,,280,1357
Nass Gitwinksihlkw,2008,0,,281,1357
Nass Gitwinksihlkw,2008,0,,282,1357
Nass Gitwinksihlkw,2008,0,,283,1357
Nass Gitwinksihlkw,2008,0,,284,1357
Nass Gitwinksihlkw,2008,0,,285,1357
Nass Gitwinksihlkw,2008,0,,286,1357
Nass Gitwinksihlkw,2008,0,,287,1357
Nass Gitwinksihlkw,2010,0,,151,0
Nass Gitwinksihlkw,2010,0,,152,0
Nass Gitwinksihlkw,2010,0,,153,0
Nass Gitwinksihlkw,2010,0,,154,0
Nass Gitwinksihlkw,2010,0,,155,0
Nass Gitwinksihlkw,2010,0,,156,0
Nass Gitwinksihlkw,2010,0,,157,0
Nass Gitwinksihlkw,2010,0,,158,0
Nass Gitwinksihlkw,2010,0,,159,0
Nass Gitwinksihlkw,2010,0,,160,0
Nass Gitwinksihlkw,2010,0,,161,0
Nass Gitwinksihlkw,2010,0,,162,0
Nass Gitwinksihlkw,2010,0,,163,0
Nass Gitwinksihlkw,2010,0,,164,0
Nass Gitwinksihlkw,2010,0,,165,0
Nass Gitwinksihlkw,2010,0,,166,0
Nass Gitwinksihlkw,2010,0,,167,0
Nass Gitwinksihlkw,2010,0,,168,0
Nass Gitwinksihlkw,2010,0,,169,0
Nass Gitwinksihlkw,2010,0,,170,0
Nass Gitwinksihlkw,2010,0,,171,0
Nass Gitwinksihlkw,2010,0,,172,0
Nass Gitwinksihlkw,2010,0,,173,0
Nass Gitwinksihlkw,2010,0,,174,0
Nass Gitwinksihlkw,2010,0,,175,0
Nass Gitwinksihlkw,2010,0,,176,0
Nass Gitwinksihlkw,2010,0,,177,0
Nass Gitwinksihlkw,2010,0,,178,0
Nass Gitwinksihlkw,2010,0,,179,0
Nass Gitwinksihlkw,2010,0,,180,0
Nass Gitwinksihlkw,2010,0,,181,0
Nass Gitwinksihlkw,2010,0,,182,0
Nass Gitwinksihlkw,2010,0,,183,0
Nass Gitwinksihlkw,2010,1,,184,1
Nass Gitwinksihlkw,2010,0,,185,1
Nass Gitwinksihlkw,2010,0,,186,1
Nass Gitwinksihlkw,2010,0,,187,1
Nass Gitwinksihlkw,2010,1,,188,2
Nass Gitwinksihlkw,2010,0,,189,2
Nass Gitwinksihlkw,2010,1,,190,3
Nass Gitwinksihlkw,2010,1,,191,4
Nass Gitwinksihlkw,2010,2,,192,6
Nass Gitwinksihlkw,2010,0,,193,6
Nass Gitwinksihlkw,2010,1,,194,7
Nass Gitwinksihlkw,2010,1,,195,8
Nass Gitwinksihlkw,2010,2,,196,10
Nass Gitwinksihlkw,2010,3,,197,13
Nass Gitwinksihlkw,2010,1,,198,14
Nass Gitwinksihlkw,2010,2,,199,16
Nass Gitwinksihlkw,2010,6,,200,22
Nass Gitwinksihlkw,2010,6,,201,28
Nass Gitwinksihlkw,2010,8,,202,36
Nass Gitwinksihlkw,2010,1,,203,37
Nass Gitwinksihlkw,2010,8,,204,45
Nass Gitwinksihlkw,2010,3,,205,48
Nass Gitwinksihlkw,2010,6,,206,54
Nass Gitwinksihlkw,2010,8,,207,62
Nass Gitwinksihlkw,2010,34,,208,96
Nass Gitwinksihlkw,2010,9,,209,105
Nass Gitwinksihlkw,2010,22,,210,127
Nass Gitwinksihlkw,2010,31,,211,158
Nass Gitwinksihlkw,2010,25,,212,183
Nass Gitwinksihlkw,2010,40,,213,223
Nass Gitwinksihlkw,2010,42,,214,265
Nass Gitwinksihlkw,2010,49,,215,314
Nass Gitwinksihlkw,2010,34,,216,348
Nass Gitwinksihlkw,2010,43,,217,391
Nass Gitwinksihlkw,2010,56,,218,447
Nass Gitwinksihlkw,2010,49,,219,496
Nass Gitwinksihlkw,2010,65,,220,561
Nass Gitwinksihlkw,2010,190,,221,751
Nass Gitwinksihlkw,2010,172,,222,923
Nass Gitwinksihlkw,2010,115,,223,1038
Nass Gitwinksihlkw,2010,64,,224,1102
Nass Gitwinksihlkw,2010,71,,225,1173
Nass Gitwinksihlkw,2010,49,,226,1222
Nass Gitwinksihlkw,2010,57,,227,1279
Nass Gitwinksihlkw,2010,20,,228,1299
Nass Gitwinksihlkw,2010,38,,229,1337
Nass Gitwinksihlkw,2010,19,,230,1356
Nass Gitwinksihlkw,2010,36,,231,1392
Nass Gitwinksihlkw,2010,59,,232,1451
Nass Gitwinksihlkw,2010,49,,233,1500
Nass Gitwinksihlkw,2010,29,,234,1529
Nass Gitwinksihlkw,2010,15,,235,1544
Nass Gitwinksihlkw,2010,16,,236,1560
Nass Gitwinksihlkw,2010,12,,237,1572
Nass Gitwinksihlkw,2010,18,,238,1590
Nass Gitwinksihlkw,2010,29,,239,1619
Nass Gitwinksihlkw,2010,19,,240,1638
Nass Gitwinksihlkw,2010,12,,241,1650
Nass Gitwinksihlkw,2010,2,,242,1652
Nass Gitwinksihlkw,2010,6,,243,1658
Nass Gitwinksihlkw,2010,8,,244,1666
Nass Gitwinksihlkw,2010,6,,245,1672
Nass Gitwinksihlkw,2010,9,,246,1681
Nass Gitwinksihlkw,2010,1,,247,1682
Nass Gitwinksihlkw,2010,5,,248,1687
Nass Gitwinksihlkw,2010,8,,249,1695
Nass Gitwinksihlkw,2010,14,,250,1709
Nass Gitwinksihlkw,2010,32,,251,1741
Nass Gitwinksihlkw,2010,18,,252,1759
Nass Gitwinksihlkw,2010,15,,253,1774
Nass Gitwinksihlkw,2010,3,,254,1777
Nass Gitwinksihlkw,2010,4,,255,1781
Nass Gitwinksihlkw,2010,2,,256,1783
Nass Gitwinksihlkw,2010,4,,257,1787
Nass Gitwinksihlkw,2010,1,,258,1788
Nass Gitwinksihlkw,2010,1,,259,1789
Nass Gitwinksihlkw,2010,0,,260,1789
Nass Gitwinksihlkw,2010,0,,261,1789
Nass Gitwinksihlkw,2010,0,,262,1789
Nass Gitwinksihlkw,2010,0,,263,1789
Nass Gitwinksihlkw,2010,0,,264,1789
Nass Gitwinksihlkw,2010,0,,265,1789
Nass Gitwinksihlkw,2010,0,,266,1789
Nass Gitwinksihlkw,2010,0,,267,1789
Nass Gitwinksihlkw,2010,0,,268,1789
Nass Gitwinksihlkw,2010,0,,269,1789
Nass Gitwinksihlkw,2010,0,,270,1789
Nass Gitwinksihlkw,2010,0,,271,1789
Nass Gitwinksihlkw,2010,0,,272,1789
Nass Gitwinksihlkw,2010,0,,273,1789
Nass Gitwinksihlkw,2010,0,,274,1789
Nass Gitwinksihlkw,2010,0,,275,1789
Nass Gitwinksihlkw,2010,0,,276,1789
Nass Gitwinksihlkw,2010,0,,277,1789
Nass Gitwinksihlkw,2010,0,,278,1789
Nass Gitwinksihlkw,2010,0,,279,1789
Nass Gitwinksihlkw,2010,0,,280,1789
Nass Gitwinksihlkw,2010,0,,281,1789
Nass Gitwinksihlkw,2010,0,,282,1789
Nass Gitwinksihlkw,2010,0,,283,1789
Nass Gitwinksihlkw,2010,0,,284,1789
Nass Gitwinksihlkw,2010,0,,285,1789
Nass Gitwinksihlkw,2010,0,,286,1789
Nass Gitwinksihlkw,2012,0,,152,0
Nass Gitwinksihlkw,2012,0,,153,0
Nass Gitwinksihlkw,2012,0,,154,0
Nass Gitwinksihlkw,2012,0,,155,0
Nass Gitwinksihlkw,2012,0,,156,0
Nass Gitwinksihlkw,2012,0,,157,0
Nass Gitwinksihlkw,2012,0,,158,0
Nass Gitwinksihlkw,2012,0,,159,0
Nass Gitwinksihlkw,2012,0,,160,0
Nass Gitwinksihlkw,2012,0,,161,0
Nass Gitwinksihlkw,2012,0,,162,0
Nass Gitwinksihlkw,2012,0,,163,0
Nass Gitwinksihlkw,2012,0,,164,0
Nass Gitwinksihlkw,2012,0,,165,0
Nass Gitwinksihlkw,2012,0,,166,0
Nass Gitwinksihlkw,2012,0,,167,0
Nass Gitwinksihlkw,2012,0,,168,0
Nass Gitwinksihlkw,2012,0,,169,0
Nass Gitwinksihlkw,2012,0,,170,0
Nass Gitwinksihlkw,2012,0,,171,0
Nass Gitwinksihlkw,2012,0,,172,0
Nass Gitwinksihlkw,2012,0,,173,0
Nass Gitwinksihlkw,2012,0,,174,0
Nass Gitwinksihlkw,2012,0,,175,0
Nass Gitwinksihlkw,2012,0,,176,0
Nass Gitwinksihlkw,2012,0,,177,0
Nass Gitwinksihlkw,2012,0,,178,0
Nass Gitwinksihlkw,2012,0,,179,0
Nass Gitwinksihlkw,2012,0,,180,0
Nass Gitwinksihlkw,2012,0,,181,0
Nass Gitwinksihlkw,2012,0,,182,0
Nass Gitwinksihlkw,2012,0,,183,0
Nass Gitwinksihlkw,2012,0,,184,0
Nass Gitwinksihlkw,2012,0,,185,0
Nass Gitwinksihlkw,2012,0,,186,0
Nass Gitwinksihlkw,2012,0,,187,0
Nass Gitwinksihlkw,2012,0,,188,0
Nass Gitwinksihlkw,2012,0,,189,0
Nass Gitwinksihlkw,2012,0,,190,0
Nass Gitwinksihlkw,2012,0,,191,0
Nass Gitwinksihlkw,2012,0,,192,0
Nass Gitwinksihlkw,2012,0,,193,0
Nass Gitwinksihlkw,2012,0,,194,0
Nass Gitwinksihlkw,2012,0,,195,0
Nass Gitwinksihlkw,2012,0,,196,0
Nass Gitwinksihlkw,2012,0,,197,0
Nass Gitwinksihlkw,2012,0,,198,0
Nass Gitwinksihlkw,2012,0,,199,0
Nass Gitwinksihlkw,2012,0,,200,0
Nass Gitwinksihlkw,2012,0,,201,0
Nass Gitwinksihlkw,2012,0,,202,0
Nass Gitwinksihlkw,2012,1,,203,1
Nass Gitwinksihlkw,2012,0,,204,1
Nass Gitwinksihlkw,2012,3,,205,4
Nass Gitwinksihlkw,2012,1,,206,5
Nass Gitwinksihlkw,2012,9,,207,14
Nass Gitwinksihlkw,2012,13,,208,27
Nass Gitwinksihlkw,2012,10,,209,37
Nass Gitwinksihlkw,2012,7,,210,44
Nass Gitwinksihlkw,2012,10,,211,54
Nass Gitwinksihlkw,2012,32,,212,86
Nass Gitwinksihlkw,2012,37,,213,123
Nass Gitwinksihlkw,2012,112,,214,235
Nass Gitwinksihlkw,2012,103,,215,338
Nass Gitwinksihlkw,2012,91,,216,429
Nass Gitwinksihlkw,2012,72,,217,501
Nass Gitwinksihlkw,2012,71,,218,572
Nass Gitwinksihlkw,2012,166,,219,738
Nass Gitwinksihlkw,2012,134,,220,872
Nass Gitwinksihlkw,2012,170,,221,1042
Nass Gitwinksihlkw,2012,136,,222,1178
Nass Gitwinksihlkw,2012,69,,223,1247
Nass Gitwinksihlkw,2012,222,,224,1469
Nass Gitwinksihlkw,2012,210,,225,1679
Nass Gitwinksihlkw,2012,119,,226,1798
Nass Gitwinksihlkw,2012,210,,227,2008
Nass Gitwinksihlkw,2012,223,,228,2231
Nass Gitwinksihlkw,2012,249,,229,2480
Nass Gitwinksihlkw,2012,143,,230,2623
Nass Gitwinksihlkw,2012,112,,231,2735
Nass Gitwinksihlkw,2012,111,,232,2846
Nass Gitwinksihlkw,2012,45,,233,2891
Nass Gitwinksihlkw,2012,70,,234,2961
Nass Gitwinksihlkw,2012,122,,235,3083
Nass Gitwinksihlkw,2012,137,,236,3220
Nass Gitwinksihlkw,2012,92,,237,3312
Nass Gitwinksihlkw,2012,44,,238,3356
Nass Gitwinksihlkw,2012,58,,239,3414
Nass Gitwinksihlkw,2012,120,,240,3534
Nass Gitwinksihlkw,2012,57,,241,3591
Nass Gitwinksihlkw,2012,75,,242,3666
Nass Gitwinksihlkw,2012,56,,243,3722
Nass Gitwinksihlkw,2012,47,,244,3769
Nass Gitwinksihlkw,2012,58,,245,3827
Nass Gitwinksihlkw,2012,51,,246,3878
Nass Gitwinksihlkw,2012,37,,247,3915
Nass Gitwinksihlkw,2012,27,,248,3942
Nass Gitwinksihlkw,2012,46,,249,3988
Nass Gitwinksihlkw,2012,57,,250,4045
Nass Gitwinksihlkw,2012,26,,251,4071
Nass Gitwinksihlkw,2012,39,,252,4110
Nass Gitwinksihlkw,2012,16,,253,4126
Nass Gitwinksihlkw,2012,9,,254,4135
Nass Gitwinksihlkw,2012,11,,255,4146
Nass Gitwinksihlkw,2012,20,,256,4166
Nass Gitwinksihlkw,2012,1,,257,4167
Nass Gitwinksihlkw,2012,5,,258,4172
Nass Gitwinksihlkw,2012,5,,259,4177
Nass Gitwinksihlkw,2012,0,,260,4177
Nass Gitwinksihlkw,2012,0,,261,4177
Nass Gitwinksihlkw,2012,0,,262,4177
Nass Gitwinksihlkw,2012,0,,263,4177
Nass Gitwinksihlkw,2012,0,,264,4177
Nass Gitwinksihlkw,2012,0,,265,4177
Nass Gitwinksihlkw,2012,0,,266,4177
Nass Gitwinksihlkw,2012,0,,267,4177
Nass Gitwinksihlkw,2012,0,,268,4177
Nass Gitwinksihlkw,2012,0,,269,4177
Nass Gitwinksihlkw,2012,0,,270,4177
Nass Gitwinksihlkw,2012,0,,271,4177
Nass Gitwinksihlkw,2012,0,,272,4177
Nass Gitwinksihlkw,2012,0,,273,4177
Nass Gitwinksihlkw,2012,0,,274,4177
Nass Gitwinksihlkw,2012,0,,275,4177
Nass Gitwinksihlkw,2012,0,,276,4177
Nass Gitwinksihlkw,2012,0,,277,4177
Nass Gitwinksihlkw,2012,0,,278,4177
Nass Gitwinksihlkw,2012,0,,279,4177
Nass Gitwinksihlkw,2012,0,,280,4177
Nass Gitwinksihlkw,2012,0,,281,4177
Nass Gitwinksihlkw,2012,0,,282,4177
Nass Gitwinksihlkw,2012,0,,283,4177
Nass Gitwinksihlkw,2012,0,,284,4177
Nass Gitwinksihlkw,2012,0,,285,4177
Nass Gitwinksihlkw,2012,0,,286,4177
Nass Gitwinksihlkw,2012,0,,287,4177
Nass Gitwinksihlkw,2014,0,,151,0
Nass Gitwinksihlkw,2014,0,,152,0
Nass Gitwinksihlkw,2014,0,,153,0
Nass Gitwinksihlkw,2014,0,,154,0
Nass Gitwinksihlkw,2014,0,,155,0
Nass Gitwinksihlkw,2014,0,,156,0
Nass Gitwinksihlkw,2014,0,,157,0
Nass Gitwinksihlkw,2014,0,,158,0
Nass Gitwinksihlkw,2014,0,,159,0
Nass Gitwinksihlkw,2014,0,,160,0
Nass Gitwinksihlkw,2014,0,,161,0
Nass Gitwinksihlkw,2014,0,,162,0
Nass Gitwinksihlkw,2014,0,,163,0
Nass Gitwinksihlkw,2014,0,,164,0
Nass Gitwinksihlkw,2014,0,,165,0
Nass Gitwinksihlkw,2014,0,,166,0
Nass Gitwinksihlkw,2014,0,,167,0
Nass Gitwinksihlkw,2014,0,,168,0
Nass Gitwinksihlkw,2014,0,,169,0
Nass Gitwinksihlkw,2014,0,,170,0
Nass Gitwinksihlkw,2014,0,,171,0
Nass Gitwinksihlkw,2014,0,,172,0
Nass Gitwinksihlkw,2014,0,,173,0
Nass Gitwinksihlkw,2014,0,,174,0
Nass Gitwinksihlkw,2014,0,,175,0
Nass Gitwinksihlkw,2014,0,,176,0
Nass Gitwinksihlkw,2014,0,,177,0
Nass Gitwinksihlkw,2014,0,,178,0
Nass Gitwinksihlkw,2014,0,,179,0
Nass Gitwinksihlkw,2014,0,,180,0
Nass Gitwinksihlkw,2014,0,,181,0
Nass Gitwinksihlkw,2014,0,,182,0
Nass Gitwinksihlkw,2014,0,,183,0
Nass Gitwinksihlkw,2014,0,,184,0
Nass Gitwinksihlkw,2014,0,,185,0
Nass Gitwinksihlkw,2014,0,,186,0
Nass Gitwinksihlkw,2014,1,,187,1
Nass Gitwinksihlkw,2014,0,,188,1
Nass Gitwinksihlkw,2014,0,,189,1
Nass Gitwinksihlkw,2014,0,,190,1
Nass Gitwinksihlkw,2014,1,,191,2
Nass Gitwinksihlkw,2014,2,,192,4
Nass Gitwinksihlkw,2014,12,,193,16
Nass Gitwinksihlkw,2014,3,,194,19
Nass Gitwinksihlkw,2014,0,,195,19
Nass Gitwinksihlkw,2014,15,,196,34
Nass Gitwinksihlkw,2014,11,,197,45
Nass Gitwinksihlkw,2014,7,,198,52
Nass Gitwinksihlkw,2014,16,,199,68
Nass Gitwinksihlkw,2014,10,,200,78
Nass Gitwinksihlkw,2014,52,,201,130
Nass Gitwinksihlkw,2014,79,,202,209
Nass Gitwinksihlkw,2014,153,,203,362
Nass Gitwinksihlkw,2014,258,,204,620
Nass Gitwinksihlkw,2014,169,,205,789
Nass Gitwinksihlkw,2014,265,,206,1054
Nass Gitwinksihlkw,2014,307,,207,1361
Nass Gitwinksihlkw,2014,286,,208,1647
Nass Gitwinksihlkw,2014,361,,209,2008
Nass Gitwinksihlkw,2014,313,,210,2321
Nass Gitwinksihlkw,2014,172,,211,2493
Nass Gitwinksihlkw,2014,145,,212,2638
Nass Gitwinksihlkw,2014,348,,213,2986
Nass Gitwinksihlkw,2014,582,,214,3568
Nass Gitwinksihlkw,2014,541,,215,4109
Nass Gitwinksihlkw,2014,496,,216,4605
Nass Gitwinksihlkw,2014,294,,217,4899
Nass Gitwinksihlkw,2014,234,,218,5133
Nass Gitwinksihlkw,2014,336,,219,5469
Nass Gitwinksihlkw,2014,321,,220,5790
Nass Gitwinksihlkw,2014,272,,221,6062
Nass Gitwinksihlkw,2014,180,,222,6242
Nass Gitwinksihlkw,2014,61,,223,6303
Nass Gitwinksihlkw,2014,47,,224,6350
Nass Gitwinksihlkw,2014,34,,225,6384
Nass Gitwinksihlkw,2014,83,,226,6467
Nass Gitwinksihlkw,2014,284,,227,6751
Nass Gitwinksihlkw,2014,410,,228,7161
Nass Gitwinksihlkw,2014,337,,229,7498
Nass Gitwinksihlkw,2014,269,,230,7767
Nass Gitwinksihlkw,2014,387,,231,8154
Nass Gitwinksihlkw,2014,813,,232,8967
Nass Gitwinksihlkw,2014,678,,233,9645
Nass Gitwinksihlkw,2014,654,,234,10299
Nass Gitwinksihlkw,2014,697,,235,10996
Nass Gitwinksihlkw,2014,552,,236,11548
Nass Gitwinksihlkw,2014,645,,237,12193
Nass Gitwinksihlkw,2014,455,,238,12648
Nass Gitwinksihlkw,2014,182,,239,12830
Nass Gitwinksihlkw,2014,496,,240,13326
Nass Gitwinksihlkw,2014,635,,241,13961
Nass Gitwinksihlkw,2014,778,,242,14739
Nass Gitwinksihlkw,2014,315,,243,15054
Nass Gitwinksihlkw,2014,258,,244,15312
Nass Gitwinksihlkw,2014,100,,245,15412
Nass Gitwinksihlkw,2014,286,,246,15698
Nass Gitwinksihlkw,2014,383,,247,16081
Nass Gitwinksihlkw,2014,391,,248,16472
Nass Gitwinksihlkw,2014,210,,249,16682
Nass Gitwinksihlkw,2014,116,,250,16798
Nass Gitwinksihlkw,2014,107,,251,16905
Nass Gitwinksihlkw,2014,90,,252,16995
Nass Gitwinksihlkw,2014,149,,253,17144
Nass Gitwinksihlkw,2014,116,,254,17260
Nass Gitwinksihlkw,2014,58,,255,17318
Nass Gitwinksihlkw,2014,41,,256,17359
Nass Gitwinksihlkw,2014,0,,257,17359
Nass Gitwinksihlkw,2014,0,,258,17359
Nass Gitwinksihlkw,2014,0,,259,17359
Nass Gitwinksihlkw,2014,0,,260,17359
Nass Gitwinksihlkw,2014,0,,261,17359
Nass Gitwinksihlkw,2014,0,,262,17359
Nass Gitwinksihlkw,2014,0,,263,17359
Nass Gitwinksihlkw,2014,0,,264,17359
Nass Gitwinksihlkw,2014,0,,265,17359
Nass Gitwinksihlkw,2014,0,,266,17359
Nass Gitwinksihlkw,2014,0,,267,17359
Nass Gitwinksihlkw,2014,0,,268,17359
Nass Gitwinksihlkw,2014,0,,269,17359
Nass Gitwinksihlkw,2014,0,,270,17359
Nass Gitwinksihlkw,2014,0,,271,17359
Nass Gitwinksihlkw,2014,0,,272,17359
Nass Gitwinksihlkw,2014,0,,273,17359
Nass Gitwinksihlkw,2014,0,,274,17359
Nass Gitwinksihlkw,2014,0,,275,17359
Nass Gitwinksihlkw,2014,0,,276,17359
Nass Gitwinksihlkw,2014,0,,277,17359
Nass Gitwinksihlkw,2014,0,,278,17359
Nass Gitwinksihlkw,2014,0,,279,17359
Nass Gitwinksihlkw,2014,0,,280,17359
Nass Gitwinksihlkw,2014,0,,281,17359
Nass Gitwinksihlkw,2014,0,,282,17359
Nass Gitwinksihlkw,2014,0,,283,17359
Nass Gitwinksihlkw,2014,0,,284,17359
Nass Gitwinksihlkw,2014,0,,285,17359
Nass Gitwinksihlkw,2014,0,,286,17359
Nass Gitwinksihlkw,1993,0,,151,0
Nass Gitwinksihlkw,1993,0,,152,0
Nass Gitwinksihlkw,1993,0,,153,0
Nass Gitwinksihlkw,1993,0,,154,0
Nass Gitwinksihlkw,1993,0,,155,0
Nass Gitwinksihlkw,1993,0,,156,0
Nass Gitwinksihlkw,1993,0,,157,0
Nass Gitwinksihlkw,1993,0,,158,0
Nass Gitwinksihlkw,1993,0,,159,0
Nass Gitwinksihlkw,1993,0,,160,0
Nass Gitwinksihlkw,1993,0,,161,0
Nass Gitwinksihlkw,1993,0,,162,0
Nass Gitwinksihlkw,1993,0,,163,0
Nass Gitwinksihlkw,1993,0,,164,0
Nass Gitwinksihlkw,1993,0,,165,0
Nass Gitwinksihlkw,1993,0,,166,0
Nass Gitwinksihlkw,1993,0,,167,0
Nass Gitwinksihlkw,1993,0,,168,0
Nass Gitwinksihlkw,1993,0,,169,0
Nass Gitwinksihlkw,1993,0,,170,0
Nass Gitwinksihlkw,1993,0,,171,0
Nass Gitwinksihlkw,1993,0,,172,0
Nass Gitwinksihlkw,1993,0,,173,0
Nass Gitwinksihlkw,1993,0,,174,0
Nass Gitwinksihlkw,1993,0,,175,0
Nass Gitwinksihlkw,1993,0,,176,0
Nass Gitwinksihlkw,1993,0,,177,0
Nass Gitwinksihlkw,1993,0,,178,0
Nass Gitwinksihlkw,1993,0,,179,0
Nass Gitwinksihlkw,1993,0,,180,0
Nass Gitwinksihlkw,1993,0,,181,0
Nass Gitwinksihlkw,1993,0,,182,0
Nass Gitwinksihlkw,1993,2,,183,2
Nass Gitwinksihlkw,1993,0,,184,2
Nass Gitwinksihlkw,1993,0,,185,2
Nass Gitwinksihlkw,1993,1,,186,3
Nass Gitwinksihlkw,1993,0,,187,3
Nass Gitwinksihlkw,1993,4,,188,7
Nass Gitwinksihlkw,1993,8,,189,15
Nass Gitwinksihlkw,1993,9,,190,24
Nass Gitwinksihlkw,1993,11,,191,35
Nass Gitwinksihlkw,1993,8,,192,43
Nass Gitwinksihlkw,1993,14,,193,57
Nass Gitwinksihlkw,1993,24,,194,81
Nass Gitwinksihlkw,1993,7,,195,88
Nass Gitwinksihlkw,1993,15,,196,103
Nass Gitwinksihlkw,1993,33,,197,136
Nass Gitwinksihlkw,1993,41,,198,177
Nass Gitwinksihlkw,1993,82,,199,259
Nass Gitwinksihlkw,1993,104,,200,363
Nass Gitwinksihlkw,1993,125,,201,488
Nass Gitwinksihlkw,1993,127,,202,615
Nass Gitwinksihlkw,1993,231,,203,846
Nass Gitwinksihlkw,1993,165,,204,1011
Nass Gitwinksihlkw,1993,126,,205,1137
Nass Gitwinksihlkw,1993,174,,206,1311
Nass Gitwinksihlkw,1993,101,,207,1412
Nass Gitwinksihlkw,1993,114,,208,1526
Nass Gitwinksihlkw,1993,90,,209,1616
Nass Gitwinksihlkw,1993,68,,210,1684
Nass Gitwinksihlkw,1993,10,,211,1694
Nass Gitwinksihlkw,1993,0,,212,1694
Nass Gitwinksihlkw,1993,0,,213,1694
Nass Gitwinksihlkw,1993,116,,214,1810
Nass Gitwinksihlkw,1993,244,,215,2054
Nass Gitwinksihlkw,1993,200,,216,2254
Nass Gitwinksihlkw,1993,204,,217,2458
Nass Gitwinksihlkw,1993,182,,218,2640
Nass Gitwinksihlkw,1993,119,,219,2759
Nass Gitwinksihlkw,1993,152,,220,2911
Nass Gitwinksihlkw,1993,171,,221,3082
Nass Gitwinksihlkw,1993,64,,222,3146
Nass Gitwinksihlkw,1993,32,,223,3178
Nass Gitwinksihlkw,1993,24,,224,3202
Nass Gitwinksihlkw,1993,21,,225,3223
Nass Gitwinksihlkw,1993,12,,226,3235
Nass Gitwinksihlkw,1993,43,,227,3278
Nass Gitwinksihlkw,1993,39,,228,3317
Nass Gitwinksihlkw,1993,25,,229,3342
Nass Gitwinksihlkw,1993,28,,230,3370
Nass Gitwinksihlkw,1993,44,,231,3414
Nass Gitwinksihlkw,1993,34,,232,3448
Nass Gitwinksihlkw,1993,48,,233,3496
Nass Gitwinksihlkw,1993,30,,234,3526
Nass Gitwinksihlkw,1993,12,,235,3538
Nass Gitwinksihlkw,1993,12,,236,3550
Nass Gitwinksihlkw,1993,16,,237,3566
Nass Gitwinksihlkw,1993,21,,238,3587
Nass Gitwinksihlkw,1993,21,,239,3608
Nass Gitwinksihlkw,1993,14,,240,3622
Nass Gitwinksihlkw,1993,0,,241,3622
Nass Gitwinksihlkw,1993,33,,242,3655
Nass Gitwinksihlkw,1993,27,,243,3682
Nass Gitwinksihlkw,1993,3,,244,3685
Nass Gitwinksihlkw,1993,21,,245,3706
Nass Gitwinksihlkw,1993,27,,246,3733
Nass Gitwinksihlkw,1993,23,,247,3756
Nass Gitwinksihlkw,1993,0,,248,3756
Nass Gitwinksihlkw,1993,16,,249,3772
Nass Gitwinksihlkw,1993,26,,250,3798
Nass Gitwinksihlkw,1993,11,,251,3809
Nass Gitwinksihlkw,1993,9,,252,3818
Nass Gitwinksihlkw,1993,4,,253,3822
Nass Gitwinksihlkw,1993,10,,254,3832
Nass Gitwinksihlkw,1993,0,,255,3832
Nass Gitwinksihlkw,1993,7,,256,3839
Nass Gitwinksihlkw,1993,0,,257,3839
Nass Gitwinksihlkw,1993,0,,258,3839
Nass Gitwinksihlkw,1993,0,,259,3839
Nass Gitwinksihlkw,1993,0,,260,3839
Nass Gitwinksihlkw,1993,0,,261,3839
Nass Gitwinksihlkw,1993,0,,262,3839
Nass Gitwinksihlkw,1993,0,,263,3839
Nass Gitwinksihlkw,1993,0,,264,3839
Nass Gitwinksihlkw,1993,0,,265,3839
Nass Gitwinksihlkw,1993,0,,266,3839
Nass Gitwinksihlkw,1993,0,,267,3839
Nass Gitwinksihlkw,1993,0,,268,3839
Nass Gitwinksihlkw,1993,0,,269,3839
Nass Gitwinksihlkw,1993,0,,270,3839
Nass Gitwinksihlkw,1993,0,,271,3839
Nass Gitwinksihlkw,1993,0,,272,3839
Nass Gitwinksihlkw,1993,0,,273,3839
Nass Gitwinksihlkw,1993,0,,274,3839
Nass Gitwinksihlkw,1993,0,,275,3839
Nass Gitwinksihlkw,1993,0,,276,3839
Nass Gitwinksihlkw,1993,0,,277,3839
Nass Gitwinksihlkw,1993,0,,278,3839
Nass Gitwinksihlkw,1993,0,,279,3839
Nass Gitwinksihlkw,1993,0,,280,3839
Nass Gitwinksihlkw,1993,0,,281,3839
Nass Gitwinksihlkw,1993,0,,282,3839
Nass Gitwinksihlkw,1993,0,,283,3839
Nass Gitwinksihlkw,1993,0,,284,3839
Nass Gitwinksihlkw,1993,0,,285,3839
Nass Gitwinksihlkw,1993,0,,286,3839
Nass Gitwinksihlkw,1995,0,,151,0
Nass Gitwinksihlkw,1995,0,,152,0
Nass Gitwinksihlkw,1995,0,,153,0
Nass Gitwinksihlkw,1995,0,,154,0
Nass Gitwinksihlkw,1995,0,,155,0
Nass Gitwinksihlkw,1995,0,,156,0
Nass Gitwinksihlkw,1995,0,,157,0
Nass Gitwinksihlkw,1995,0,,158,0
Nass Gitwinksihlkw,1995,0,,159,0
Nass Gitwinksihlkw,1995,0,,160,0
Nass Gitwinksihlkw,1995,0,,161,0
Nass Gitwinksihlkw,1995,0,,162,0
Nass Gitwinksihlkw,1995,0,,163,0
Nass Gitwinksihlkw,1995,0,,164,0
Nass Gitwinksihlkw,1995,0,,165,0
Nass Gitwinksihlkw,1995,0,,166,0
Nass Gitwinksihlkw,1995,0,,167,0
Nass Gitwinksihlkw,1995,0,,168,0
Nass Gitwinksihlkw,1995,0,,169,0
Nass Gitwinksihlkw,1995,0,,170,0
Nass Gitwinksihlkw,1995,0,,171,0
Nass Gitwinksihlkw,1995,0,,172,0
Nass Gitwinksihlkw,1995,0,,173,0
Nass Gitwinksihlkw,1995,0,,174,0
Nass Gitwinksihlkw,1995,0,,175,0
Nass Gitwinksihlkw,1995,0,,176,0
Nass Gitwinksihlkw,1995,0,,177,0
Nass Gitwinksihlkw,1995,0,,178,0
Nass Gitwinksihlkw,1995,0,,179,0
Nass Gitwinksihlkw,1995,0,,180,0
Nass Gitwinksihlkw,1995,2,,181,2
Nass Gitwinksihlkw,1995,0,,182,2
Nass Gitwinksihlkw,1995,1,,183,3
Nass Gitwinksihlkw,1995,0,,184,3
Nass Gitwinksihlkw,1995,0,,185,3
Nass Gitwinksihlkw,1995,0,,186,3
Nass Gitwinksihlkw,1995,0,,187,3
Nass Gitwinksihlkw,1995,1,,188,4
Nass Gitwinksihlkw,1995,10,,189,14
Nass Gitwinksihlkw,1995,9,,190,23
Nass Gitwinksihlkw,1995,21,,191,44
Nass Gitwinksihlkw,1995,10,,192,54
Nass Gitwinksihlkw,1995,11,,193,65
Nass Gitwinksihlkw,1995,15,,194,80
Nass Gitwinksihlkw,1995,11,,195,91
Nass Gitwinksihlkw,1995,30,,196,121
Nass Gitwinksihlkw,1995,68,,197,189
Nass Gitwinksihlkw,1995,78,,198,267
Nass Gitwinksihlkw,1995,67,,199,334
Nass Gitwinksihlkw,1995,53,,200,387
Nass Gitwinksihlkw,1995,51,,201,438
Nass Gitwinksihlkw,1995,70,,202,508
Nass Gitwinksihlkw,1995,72,,203,580
Nass Gitwinksihlkw,1995,94,,204,674
Nass Gitwinksihlkw,1995,90,,205,764
Nass Gitwinksihlkw,1995,106,,206,870
Nass Gitwinksihlkw,1995,71,,207,941
Nass Gitwinksihlkw,1995,57,,208,998
Nass Gitwinksihlkw,1995,54,,209,1052
Nass Gitwinksihlkw,1995,53,,210,1105
Nass Gitwinksihlkw,1995,11,,211,1116
Nass Gitwinksihlkw,1995,54,,212,1170
Nass Gitwinksihlkw,1995,104,,213,1274
Nass Gitwinksihlkw,1995,122,,214,1396
Nass Gitwinksihlkw,1995,82,,215,1478
Nass Gitwinksihlkw,1995,34,,216,1512
Nass Gitwinksihlkw,1995,14,,217,1526
Nass Gitwinksihlkw,1995,39,,218,1565
Nass Gitwinksihlkw,1995,174,,219,1739
Nass Gitwinksihlkw,1995,22,,220,1761
Nass Gitwinksihlkw,1995,207,,221,1968
Nass Gitwinksihlkw,1995,236,,222,2204
Nass Gitwinksihlkw,1995,129,,223,2333
Nass Gitwinksihlkw,1995,144,,224,2477
Nass Gitwinksihlkw,1995,172,,225,2649
Nass Gitwinksihlkw,1995,197,,226,2846
Nass Gitwinksihlkw,1995,24,,227,2870
Nass Gitwinksihlkw,1995,94,,228,2964
Nass Gitwinksihlkw,1995,113,,229,3077
Nass Gitwinksihlkw,1995,36,,230,3113
Nass Gitwinksihlkw,1995,213,,231,3326
Nass Gitwinksihlkw,1995,102,,232,3428
Nass Gitwinksihlkw,1995,119,,233,3547
Nass Gitwinksihlkw,1995,99,,234,3646
Nass Gitwinksihlkw,1995,134,,235,3780
Nass Gitwinksihlkw,1995,143,,236,3923
Nass Gitwinksihlkw,1995,101,,237,4024
Nass Gitwinksihlkw,1995,138,,238,4162
Nass Gitwinksihlkw,1995,103,,239,4265
Nass Gitwinksihlkw,1995,200,,240,4465
Nass Gitwinksihlkw,1995,180,,241,4645
Nass Gitwinksihlkw,1995,154,,242,4799
Nass Gitwinksihlkw,1995,229,,243,5028
Nass Gitwinksihlkw,1995,77,,244,5105
Nass Gitwinksihlkw,1995,83,,245,5188
Nass Gitwinksihlkw,1995,139,,246,5327
Nass Gitwinksihlkw,1995,110,,247,5437
Nass Gitwinksihlkw,1995,0,,248,5437
Nass Gitwinksihlkw,1995,0,,249,5437
Nass Gitwinksihlkw,1995,0,,250,5437
Nass Gitwinksihlkw,1995,0,,251,5437
Nass Gitwinksihlkw,1995,0,,252,5437
Nass Gitwinksihlkw,1995,0,,253,5437
Nass Gitwinksihlkw,1995,0,,254,5437
Nass Gitwinksihlkw,1995,0,,255,5437
Nass Gitwinksihlkw,1995,0,,256,5437
Nass Gitwinksihlkw,1995,0,,257,5437
Nass Gitwinksihlkw,1995,0,,258,5437
Nass Gitwinksihlkw,1995,0,,259,5437
Nass Gitwinksihlkw,1995,0,,260,5437
Nass Gitwinksihlkw,1995,0,,261,5437
Nass Gitwinksihlkw,1995,0,,262,5437
Nass Gitwinksihlkw,1995,0,,263,5437
Nass Gitwinksihlkw,1995,0,,264,5437
Nass Gitwinksihlkw,1995,0,,265,5437
Nass Gitwinksihlkw,1995,0,,266,5437
Nass Gitwinksihlkw,1995,0,,267,5437
Nass Gitwinksihlkw,1995,0,,268,5437
Nass Gitwinksihlkw,1995,0,,269,5437
Nass Gitwinksihlkw,1995,0,,270,5437
Nass Gitwinksihlkw,1995,0,,271,5437
Nass Gitwinksihlkw,1995,0,,272,5437
Nass Gitwinksihlkw,1995,0,,273,5437
Nass Gitwinksihlkw,1995,0,,274,5437
Nass Gitwinksihlkw,1995,0,,275,5437
Nass Gitwinksihlkw,1995,0,,276,5437
Nass Gitwinksihlkw,1995,0,,277,5437
Nass Gitwinksihlkw,1995,0,,278,5437
Nass Gitwinksihlkw,1995,0,,279,5437
Nass Gitwinksihlkw,1995,0,,280,5437
Nass Gitwinksihlkw,1995,0,,281,5437
Nass Gitwinksihlkw,1995,0,,282,5437
Nass Gitwinksihlkw,1995,0,,283,5437
Nass Gitwinksihlkw,1995,0,,284,5437
Nass Gitwinksihlkw,1995,0,,285,5437
Nass Gitwinksihlkw,1995,0,,286,5437
Nass Gitwinksihlkw,1997,0,,151,0
Nass Gitwinksihlkw,1997,0,,152,0
Nass Gitwinksihlkw,1997,0,,153,0
Nass Gitwinksihlkw,1997,0,,154,0
Nass Gitwinksihlkw,1997,0,,155,0
Nass Gitwinksihlkw,1997,0,,156,0
Nass Gitwinksihlkw,1997,0,,157,0
Nass Gitwinksihlkw,1997,0,,158,0
Nass Gitwinksihlkw,1997,0,,159,0
Nass Gitwinksihlkw,1997,0,,160,0
Nass Gitwinksihlkw,1997,0,,161,0
Nass Gitwinksihlkw,1997,0,,162,0
Nass Gitwinksihlkw,1997,0,,163,0
Nass Gitwinksihlkw,1997,0,,164,0
Nass Gitwinksihlkw,1997,0,,165,0
Nass Gitwinksihlkw,1997,0,,166,0
Nass Gitwinksihlkw,1997,0,,167,0
Nass Gitwinksihlkw,1997,0,,168,0
Nass Gitwinksihlkw,1997,0,,169,0
Nass Gitwinksihlkw,1997,0,,170,0
Nass Gitwinksihlkw,1997,0,,171,0
Nass Gitwinksihlkw,1997,0,,172,0
Nass Gitwinksihlkw,1997,0,,173,0
Nass Gitwinksihlkw,1997,0,,174,0
Nass Gitwinksihlkw,1997,0,,175,0
Nass Gitwinksihlkw,1997,0,,176,0
Nass Gitwinksihlkw,1997,0,,177,0
Nass Gitwinksihlkw,1997,0,,178,0
Nass Gitwinksihlkw,1997,0,,179,0
Nass Gitwinksihlkw,1997,0,,180,0
Nass Gitwinksihlkw,1997,0,,181,0
Nass Gitwinksihlkw,1997,0,,182,0
Nass Gitwinksihlkw,1997,0,,183,0
Nass Gitwinksihlkw,1997,0,,184,0
Nass Gitwinksihlkw,1997,0,,185,0
Nass Gitwinksihlkw,1997,0,,186,0
Nass Gitwinksihlkw,1997,0,,187,0
Nass Gitwinksihlkw,1997,0,,188,0
Nass Gitwinksihlkw,1997,0,,189,0
Nass Gitwinksihlkw,1997,1,,190,1
Nass Gitwinksihlkw,1997,4,,191,5
Nass Gitwinksihlkw,1997,3,,192,8
Nass Gitwinksihlkw,1997,10,,193,18
Nass Gitwinksihlkw,1997,7,,194,25
Nass Gitwinksihlkw,1997,13,,195,38
Nass Gitwinksihlkw,1997,7,,196,45
Nass Gitwinksihlkw,1997,14,,197,59
Nass Gitwinksihlkw,1997,6,,198,65
Nass Gitwinksihlkw,1997,10,,199,75
Nass Gitwinksihlkw,1997,21,,200,96
Nass Gitwinksihlkw,1997,30,,201,126
Nass Gitwinksihlkw,1997,23,,202,149
Nass Gitwinksihlkw,1997,21,,203,170
Nass Gitwinksihlkw,1997,38,,204,208
Nass Gitwinksihlkw,1997,56,,205,264
Nass Gitwinksihlkw,1997,88,,206,352
Nass Gitwinksihlkw,1997,101,,207,453
Nass Gitwinksihlkw,1997,50,,208,503
Nass Gitwinksihlkw,1997,183,,209,686
Nass Gitwinksihlkw,1997,129,,210,815
Nass Gitwinksihlkw,1997,188,,211,1003
Nass Gitwinksihlkw,1997,173,,212,1176
Nass Gitwinksihlkw,1997,319,,213,1495
Nass Gitwinksihlkw,1997,267,,214,1762
Nass Gitwinksihlkw,1997,134,,215,1896
Nass Gitwinksihlkw,1997,252,,216,2148
Nass Gitwinksihlkw,1997,153,,217,2301
Nass Gitwinksihlkw,1997,183,,218,2484
Nass Gitwinksihlkw,1997,222,,219,2706
Nass Gitwinksihlkw,1997,464,,220,3170
Nass Gitwinksihlkw,1997,476,,221,3646
Nass Gitwinksihlkw,1997,402,,222,4048
Nass Gitwinksihlkw,1997,445,,223,4493
Nass Gitwinksihlkw,1997,97,,224,4590
Nass Gitwinksihlkw,1997,74,,225,4664
Nass Gitwinksihlkw,1997,39,,226,4703
Nass Gitwinksihlkw,1997,56,,227,4759
Nass Gitwinksihlkw,1997,418,,228,5177
Nass Gitwinksihlkw,1997,477,,229,5654
Nass Gitwinksihlkw,1997,319,,230,5973
Nass Gitwinksihlkw,1997,368,,231,6341
Nass Gitwinksihlkw,1997,425,,232,6766
Nass Gitwinksihlkw,1997,392,,233,7158
Nass Gitwinksihlkw,1997,218,,234,7376
Nass Gitwinksihlkw,1997,202,,235,7578
Nass Gitwinksihlkw,1997,359,,236,7937
Nass Gitwinksihlkw,1997,551,,237,8488
Nass Gitwinksihlkw,1997,314,,238,8802
Nass Gitwinksihlkw,1997,114,,239,8916
Nass Gitwinksihlkw,1997,131,,240,9047
Nass Gitwinksihlkw,1997,85,,241,9132
Nass Gitwinksihlkw,1997,144,,242,9276
Nass Gitwinksihlkw,1997,784,,243,10060
Nass Gitwinksihlkw,1997,628,,244,10688
Nass Gitwinksihlkw,1997,167,,245,10855
Nass Gitwinksihlkw,1997,0,,246,10855
Nass Gitwinksihlkw,1997,0,,247,10855
Nass Gitwinksihlkw,1997,0,,248,10855
Nass Gitwinksihlkw,1997,0,,249,10855
Nass Gitwinksihlkw,1997,0,,250,10855
Nass Gitwinksihlkw,1997,0,,251,10855
Nass Gitwinksihlkw,1997,0,,252,10855
Nass Gitwinksihlkw,1997,0,,253,10855
Nass Gitwinksihlkw,1997,0,,254,10855
Nass Gitwinksihlkw,1997,0,,255,10855
Nass Gitwinksihlkw,1997,0,,256,10855
Nass Gitwinksihlkw,1997,0,,257,10855
Nass Gitwinksihlkw,1997,0,,258,10855
Nass Gitwinksihlkw,1997,0,,259,10855
Nass Gitwinksihlkw,1997,0,,260,10855
Nass Gitwinksihlkw,1997,0,,261,10855
Nass Gitwinksihlkw,1997,0,,262,10855
Nass Gitwinksihlkw,1997,0,,263,10855
Nass Gitwinksihlkw,1997,0,,264,10855
Nass Gitwinksihlkw,1997,0,,265,10855
Nass Gitwinksihlkw,1997,0,,266,10855
Nass Gitwinksihlkw,1997,0,,267,10855
Nass Gitwinksihlkw,1997,0,,268,10855
Nass Gitwinksihlkw,1997,0,,269,10855
Nass Gitwinksihlkw,1997,0,,270,10855
Nass Gitwinksihlkw,1997,0,,271,10855
Nass Gitwinksihlkw,1997,0,,272,10855
Nass Gitwinksihlkw,1997,0,,273,10855
Nass Gitwinksihlkw,1997,0,,274,10855
Nass Gitwinksihlkw,1997,0,,275,10855
Nass Gitwinksihlkw,1997,0,,276,10855
Nass Gitwinksihlkw,1997,0,,277,10855
Nass Gitwinksihlkw,1997,0,,278,10855
Nass Gitwinksihlkw,1997,0,,279,10855
Nass Gitwinksihlkw,1997,0,,280,10855
Nass Gitwinksihlkw,1997,0,,281,10855
Nass Gitwinksihlkw,1997,0,,282,10855
Nass Gitwinksihlkw,1997,0,,283,10855
Nass Gitwinksihlkw,1997,0,,284,10855
Nass Gitwinksihlkw,1997,0,,285,10855
Nass Gitwinksihlkw,1997,0,,286,10855
Nass Gitwinksihlkw,1999,0,,151,0
Nass Gitwinksihlkw,1999,0,,152,0
Nass Gitwinksihlkw,1999,0,,153,0
Nass Gitwinksihlkw,1999,0,,154,0
Nass Gitwinksihlkw,1999,0,,155,0
Nass Gitwinksihlkw,1999,0,,156,0
Nass Gitwinksihlkw,1999,0,,157,0
Nass Gitwinksihlkw,1999,0,,158,0
Nass Gitwinksihlkw,1999,0,,159,0
Nass Gitwinksihlkw,1999,0,,160,0
Nass Gitwinksihlkw,1999,0,,161,0
Nass Gitwinksihlkw,1999,0,,162,0
Nass Gitwinksihlkw,1999,0,,163,0
Nass Gitwinksihlkw,1999,0,,164,0
Nass Gitwinksihlkw,1999,0,,165,0
Nass Gitwinksihlkw,1999,0,,166,0
Nass Gitwinksihlkw,1999,0,,167,0
Nass Gitwinksihlkw,1999,0,,168,0
Nass Gitwinksihlkw,1999,0,,169,0
Nass Gitwinksihlkw,1999,0,,170,0
Nass Gitwinksihlkw,1999,0,,171,0
Nass Gitwinksihlkw,1999,0,,172,0
Nass Gitwinksihlkw,1999,0,,173,0
Nass Gitwinksihlkw,1999,0,,174,0
Nass Gitwinksihlkw,1999,0,,175,0
Nass Gitwinksihlkw,1999,0,,176,0
Nass Gitwinksihlkw,1999,0,,177,0
Nass Gitwinksihlkw,1999,0,,178,0
Nass Gitwinksihlkw,1999,0,,179,0
Nass Gitwinksihlkw,1999,0,,180,0
Nass Gitwinksihlkw,1999,0,,181,0
Nass Gitwinksihlkw,1999,0,,182,0
Nass Gitwinksihlkw,1999,0,,183,0
Nass Gitwinksihlkw,1999,0,,184,0
Nass Gitwinksihlkw,1999,0,,185,0
Nass Gitwinksihlkw,1999,0,,186,0
Nass Gitwinksihlkw,1999,0,,187,0
Nass Gitwinksihlkw,1999,0,,188,0
Nass Gitwinksihlkw,1999,0,,189,0
Nass Gitwinksihlkw,1999,1,,190,1
Nass Gitwinksihlkw,1999,1,,191,2
Nass Gitwinksihlkw,1999,4,,192,6
Nass Gitwinksihlkw,1999,1,,193,7
Nass Gitwinksihlkw,1999,3,,194,10
Nass Gitwinksihlkw,1999,13,,195,23
Nass Gitwinksihlkw,1999,11,,196,34
Nass Gitwinksihlkw,1999,6,,197,40
Nass Gitwinksihlkw,1999,15,,198,55
Nass Gitwinksihlkw,1999,22,,199,77
Nass Gitwinksihlkw,1999,15,,200,92
Nass Gitwinksihlkw,1999,13,,201,105
Nass Gitwinksihlkw,1999,32,,202,137
Nass Gitwinksihlkw,1999,27,,203,164
Nass Gitwinksihlkw,1999,63,,204,227
Nass Gitwinksihlkw,1999,50,,205,277
Nass Gitwinksihlkw,1999,145,,206,422
Nass Gitwinksihlkw,1999,112,,207,534
Nass Gitwinksihlkw,1999,169,,208,703
Nass Gitwinksihlkw,1999,70,,209,773
Nass Gitwinksihlkw,1999,41,,210,814
Nass Gitwinksihlkw,1999,125,,211,939
Nass Gitwinksihlkw,1999,340,,212,1279
Nass Gitwinksihlkw,1999,630,,213,1909
Nass Gitwinksihlkw,1999,749,,214,2658
Nass Gitwinksihlkw,1999,646,,215,3304
Nass Gitwinksihlkw,1999,373,,216,3677
Nass Gitwinksihlkw,1999,266,,217,3943
Nass Gitwinksihlkw,1999,115,,218,4058
Nass Gitwinksihlkw,1999,43,,219,4101
Nass Gitwinksihlkw,1999,71,,220,4172
Nass Gitwinksihlkw,1999,208,,221,4380
Nass Gitwinksihlkw,1999,214,,222,4594
Nass Gitwinksihlkw,1999,490,,223,5084
Nass Gitwinksihlkw,1999,1295,,224,6379
Nass Gitwinksihlkw,1999,1038,,225,7417
Nass Gitwinksihlkw,1999,678,,226,8095
Nass Gitwinksihlkw,1999,615,,227,8710
Nass Gitwinksihlkw,1999,624,,228,9334
Nass Gitwinksihlkw,1999,581,,229,9915
Nass Gitwinksihlkw,1999,478,,230,10393
Nass Gitwinksihlkw,1999,505,,231,10898
Nass Gitwinksihlkw,1999,588,,232,11486
Nass Gitwinksihlkw,1999,420,,233,11906
Nass Gitwinksihlkw,1999,419,,234,12325
Nass Gitwinksihlkw,1999,574,,235,12899
Nass Gitwinksihlkw,1999,233,,236,13132
Nass Gitwinksihlkw,1999,281,,237,13413
Nass Gitwinksihlkw,1999,366,,238,13779
Nass Gitwinksihlkw,1999,422,,239,14201
Nass Gitwinksihlkw,1999,371,,240,14572
Nass Gitwinksihlkw,1999,200,,241,14772
Nass Gitwinksihlkw,1999,133,,242,14905
Nass Gitwinksihlkw,1999,188,,243,15093
Nass Gitwinksihlkw,1999,184,,244,15277
Nass Gitwinksihlkw,1999,106,,245,15383
Nass Gitwinksihlkw,1999,128,,246,15511
Nass Gitwinksihlkw,1999,80,,247,15591
Nass Gitwinksihlkw,1999,120,,248,15711
Nass Gitwinksihlkw,1999,125,,249,15836
Nass Gitwinksihlkw,1999,156,,250,15992
Nass Gitwinksihlkw,1999,181,,251,16173
Nass Gitwinksihlkw,1999,231,,252,16404
Nass Gitwinksihlkw,1999,291,,253,16695
Nass Gitwinksihlkw,1999,314,,254,17009
Nass Gitwinksihlkw,1999,315,,255,17324
Nass Gitwinksihlkw,1999,329,,256,17653
Nass Gitwinksihlkw,1999,115,,257,17768
Nass Gitwinksihlkw,1999,96,,258,17864
Nass Gitwinksihlkw,1999,79,,259,17943
Nass Gitwinksihlkw,1999,45,,260,17988
Nass Gitwinksihlkw,1999,16,,261,18004
Nass Gitwinksihlkw,1999,41,,262,18045
Nass Gitwinksihlkw,1999,54,,263,18099
Nass Gitwinksihlkw,1999,34,,264,18133
Nass Gitwinksihlkw,1999,58,,265,18191
Nass Gitwinksihlkw,1999,14,,266,18205
Nass Gitwinksihlkw,1999,25,,267,18230
Nass Gitwinksihlkw,1999,41,,268,18271
Nass Gitwinksihlkw,1999,26,,269,18297
Nass Gitwinksihlkw,1999,24,,270,18321
Nass Gitwinksihlkw,1999,16,,271,18337
Nass Gitwinksihlkw,1999,9,,272,18346
Nass Gitwinksihlkw,1999,2,,273,18348
Nass Gitwinksihlkw,1999,0,,274,18348
Nass Gitwinksihlkw,1999,0,,275,18348
Nass Gitwinksihlkw,1999,0,,276,18348
Nass Gitwinksihlkw,1999,0,,277,18348
Nass Gitwinksihlkw,1999,0,,278,18348
Nass Gitwinksihlkw,1999,0,,279,18348
Nass Gitwinksihlkw,1999,0,,280,18348
Nass Gitwinksihlkw,1999,0,,281,18348
Nass Gitwinksihlkw,1999,0,,282,18348
Nass Gitwinksihlkw,1999,0,,283,18348
Nass Gitwinksihlkw,1999,0,,284,18348
Nass Gitwinksihlkw,1999,0,,285,18348
Nass Gitwinksihlkw,1999,0,,286,18348
Nass Gitwinksihlkw,2001,0,,151,0
Nass Gitwinksihlkw,2001,0,,152,0
Nass Gitwinksihlkw,2001,0,,153,0
Nass Gitwinksihlkw,2001,0,,154,0
Nass Gitwinksihlkw,2001,0,,155,0
Nass Gitwinksihlkw,2001,0,,156,0
Nass Gitwinksihlkw,2001,0,,157,0
Nass Gitwinksihlkw,2001,0,,158,0
Nass Gitwinksihlkw,2001,0,,159,0
Nass Gitwinksihlkw,2001,0,,160,0
Nass Gitwinksihlkw,2001,0,,161,0
Nass Gitwinksihlkw,2001,0,,162,0
Nass Gitwinksihlkw,2001,0,,163,0
Nass Gitwinksihlkw,2001,0,,164,0
Nass Gitwinksihlkw,2001,0,,165,0
Nass Gitwinksihlkw,2001,0,,166,0
Nass Gitwinksihlkw,2001,0,,167,0
Nass Gitwinksihlkw,2001,0,,168,0
Nass Gitwinksihlkw,2001,0,,169,0
Nass Gitwinksihlkw,2001,0,,170,0
Nass Gitwinksihlkw,2001,0,,171,0
Nass Gitwinksihlkw,2001,0,,172,0
Nass Gitwinksihlkw,2001,0,,173,0
Nass Gitwinksihlkw,2001,0,,174,0
Nass Gitwinksihlkw,2001,0,,175,0
Nass Gitwinksihlkw,2001,0,,176,0
Nass Gitwinksihlkw,2001,0,,177,0
Nass Gitwinksihlkw,2001,0,,178,0
Nass Gitwinksihlkw,2001,0,,179,0
Nass Gitwinksihlkw,2001,0,,180,0
Nass Gitwinksihlkw,2001,0,,181,0
Nass Gitwinksihlkw,2001,0,,182,0
Nass Gitwinksihlkw,2001,0,,183,0
Nass Gitwinksihlkw,2001,0,,184,0
Nass Gitwinksihlkw,2001,1,,185,1
Nass Gitwinksihlkw,2001,0,,186,1
Nass Gitwinksihlkw,2001,0,,187,1
Nass Gitwinksihlkw,2001,1,,188,2
Nass Gitwinksihlkw,2001,1,,189,3
Nass Gitwinksihlkw,2001,5,,190,8
Nass Gitwinksihlkw,2001,3,,191,11
Nass Gitwinksihlkw,2001,1,,192,12
Nass Gitwinksihlkw,2001,12,,193,24
Nass Gitwinksihlkw,2001,9,,194,33
Nass Gitwinksihlkw,2001,5,,195,38
Nass Gitwinksihlkw,2001,3,,196,41
Nass Gitwinksihlkw,2001,6,,197,47
Nass Gitwinksihlkw,2001,12,,198,59
Nass Gitwinksihlkw,2001,10,,199,69
Nass Gitwinksihlkw,2001,16,,200,85
Nass Gitwinksihlkw,2001,3,,201,88
Nass Gitwinksihlkw,2001,0,,202,88
Nass Gitwinksihlkw,2001,0,,203,88
Nass Gitwinksihlkw,2001,0,,204,88
Nass Gitwinksihlkw,2001,2,,205,90
Nass Gitwinksihlkw,2001,106,,206,196
Nass Gitwinksihlkw,2001,180,,207,376
Nass Gitwinksihlkw,2001,273,,208,649
Nass Gitwinksihlkw,2001,424,,209,1073
Nass Gitwinksihlkw,2001,623,,210,1696
Nass Gitwinksihlkw,2001,686,,211,2382
Nass Gitwinksihlkw,2001,974,,212,3356
Nass Gitwinksihlkw,2001,1494,,213,4850
Nass Gitwinksihlkw,2001,1552,,214,6402
Nass Gitwinksihlkw,2001,1086,,215,7488
Nass Gitwinksihlkw,2001,574,,216,8062
Nass Gitwinksihlkw,2001,439,,217,8501
Nass Gitwinksihlkw,2001,272,,218,8773
Nass Gitwinksihlkw,2001,638,,219,9411
Nass Gitwinksihlkw,2001,927,,220,10338
Nass Gitwinksihlkw,2001,868,,221,11206
Nass Gitwinksihlkw,2001,720,,222,11926
Nass Gitwinksihlkw,2001,469,,223,12395
Nass Gitwinksihlkw,2001,410,,224,12805
Nass Gitwinksihlkw,2001,538,,225,13343
Nass Gitwinksihlkw,2001,425,,226,13768
Nass Gitwinksihlkw,2001,587,,227,14355
Nass Gitwinksihlkw,2001,479,,228,14834
Nass Gitwinksihlkw,2001,382,,229,15216
Nass Gitwinksihlkw,2001,224,,230,15440
Nass Gitwinksihlkw,2001,319,,231,15759
Nass Gitwinksihlkw,2001,267,,232,16026
Nass Gitwinksihlkw,2001,303,,233,16329
Nass Gitwinksihlkw,2001,135,,234,16464
Nass Gitwinksihlkw,2001,154,,235,16618
Nass Gitwinksihlkw,2001,329,,236,16947
Nass Gitwinksihlkw,2001,607,,237,17554
Nass Gitwinksihlkw,2001,201,,238,17755
Nass Gitwinksihlkw,2001,0,,239,17755
Nass Gitwinksihlkw,2001,11,,240,17766
Nass Gitwinksihlkw,2001,206,,241,17972
Nass Gitwinksihlkw,2001,846,,242,18818
Nass Gitwinksihlkw,2001,760,,243,19578
Nass Gitwinksihlkw,2001,1002,,244,20580
Nass Gitwinksihlkw,2001,503,,245,21083
Nass Gitwinksihlkw,2001,287,,246,21370
Nass Gitwinksihlkw,2001,233,,247,21603
Nass Gitwinksihlkw,2001,628,,248,22231
Nass Gitwinksihlkw,2001,940,,249,23171
Nass Gitwinksihlkw,2001,1158,,250,24329
Nass Gitwinksihlkw,2001,727,,251,25056
Nass Gitwinksihlkw,2001,754,,252,25810
Nass Gitwinksihlkw,2001,437,,253,26247
Nass Gitwinksihlkw,2001,215,,254,26462
Nass Gitwinksihlkw,2001,77,,255,26539
Nass Gitwinksihlkw,2001,83,,256,26622
Nass Gitwinksihlkw,2001,54,,257,26676
Nass Gitwinksihlkw,2001,0,,258,26676
Nass Gitwinksihlkw,2001,0,,259,26676
Nass Gitwinksihlkw,2001,0,,260,26676
Nass Gitwinksihlkw,2001,0,,261,26676
Nass Gitwinksihlkw,2001,0,,262,26676
Nass Gitwinksihlkw,2001,0,,263,26676
Nass Gitwinksihlkw,2001,0,,264,26676
Nass Gitwinksihlkw,2001,0,,265,26676
Nass Gitwinksihlkw,2001,0,,266,26676
Nass Gitwinksihlkw,2001,0,,267,26676
Nass Gitwinksihlkw,2001,0,,268,26676
Nass Gitwinksihlkw,2001,0,,269,26676
Nass Gitwinksihlkw,2001,0,,270,26676
Nass Gitwinksihlkw,2001,0,,271,26676
Nass Gitwinksihlkw,2001,0,,272,26676
Nass Gitwinksihlkw,2001,0,,273,26676
Nass Gitwinksihlkw,2001,0,,274,26676
Nass Gitwinksihlkw,2001,0,,275,26676
Nass Gitwinksihlkw,2001,0,,276,26676
Nass Gitwinksihlkw,2001,0,,277,26676
Nass Gitwinksihlkw,2001,0,,278,26676
Nass Gitwinksihlkw,2001,0,,279,26676
Nass Gitwinksihlkw,2001,0,,280,26676
Nass Gitwinksihlkw,2001,0,,281,26676
Nass Gitwinksihlkw,2001,0,,282,26676
Nass Gitwinksihlkw,2001,0,,283,26676
Nass Gitwinksihlkw,2001,0,,284,26676
Nass Gitwinksihlkw,2001,0,,285,26676
Nass Gitwinksihlkw,2001,0,,286,26676
Nass Gitwinksihlkw,2003,0,,151,0
Nass Gitwinksihlkw,2003,0,,152,0
Nass Gitwinksihlkw,2003,0,,153,0
Nass Gitwinksihlkw,2003,0,,154,0
Nass Gitwinksihlkw,2003,0,,155,0
Nass Gitwinksihlkw,2003,0,,156,0
Nass Gitwinksihlkw,2003,0,,157,0
Nass Gitwinksihlkw,2003,0,,158,0
Nass Gitwinksihlkw,2003,0,,159,0
Nass Gitwinksihlkw,2003,0,,160,0
Nass Gitwinksihlkw,2003,0,,161,0
Nass Gitwinksihlkw,2003,0,,162,0
Nass Gitwinksihlkw,2003,0,,163,0
Nass Gitwinksihlkw,2003,0,,164,0
Nass Gitwinksihlkw,2003,0,,165,0
Nass Gitwinksihlkw,2003,0,,166,0
Nass Gitwinksihlkw,2003,0,,167,0
Nass Gitwinksihlkw,2003,0,,168,0
Nass Gitwinksihlkw,2003,0,,169,0
Nass Gitwinksihlkw,2003,0,,170,0
Nass Gitwinksihlkw,2003,0,,171,0
Nass Gitwinksihlkw,2003,0,,172,0
Nass Gitwinksihlkw,2003,0,,173,0
Nass Gitwinksihlkw,2003,0,,174,0
Nass Gitwinksihlkw,2003,0,,175,0
Nass Gitwinksihlkw,2003,0,,176,0
Nass Gitwinksihlkw,2003,0,,177,0
Nass Gitwinksihlkw,2003,0,,178,0
Nass Gitwinksihlkw,2003,1,,179,1
Nass Gitwinksihlkw,2003,1,,180,2
Nass Gitwinksihlkw,2003,1,,181,3
Nass Gitwinksihlkw,2003,0,,182,3
Nass Gitwinksihlkw,2003,0,,183,3
Nass Gitwinksihlkw,2003,0,,184,3
Nass Gitwinksihlkw,2003,1,,185,4
Nass Gitwinksihlkw,2003,3,,186,7
Nass Gitwinksihlkw,2003,4,,187,11
Nass Gitwinksihlkw,2003,8,,188,19
Nass Gitwinksihlkw,2003,21,,189,40
Nass Gitwinksihlkw,2003,25,,190,65
Nass Gitwinksihlkw,2003,18,,191,83
Nass Gitwinksihlkw,2003,54,,192,137
Nass Gitwinksihlkw,2003,60,,193,197
Nass Gitwinksihlkw,2003,36,,194,233
Nass Gitwinksihlkw,2003,95,,195,328
Nass Gitwinksihlkw,2003,181,,196,509
Nass Gitwinksihlkw,2003,374,,197,883
Nass Gitwinksihlkw,2003,389,,198,1272
Nass Gitwinksihlkw,2003,791,,199,2063
Nass Gitwinksihlkw,2003,675,,200,2738
Nass Gitwinksihlkw,2003,1002,,201,3740
Nass Gitwinksihlkw,2003,465,,202,4205
Nass Gitwinksihlkw,2003,737,,203,4942
Nass Gitwinksihlkw,2003,1265,,204,6207
Nass Gitwinksihlkw,2003,1218,,205,7425
Nass Gitwinksihlkw,2003,1300,,206,8725
Nass Gitwinksihlkw,2003,1034,,207,9759
Nass Gitwinksihlkw,2003,1167,,208,10926
Nass Gitwinksihlkw,2003,1446,,209,12372
Nass Gitwinksihlkw,2003,932,,210,13304
Nass Gitwinksihlkw,2003,783,,211,14087
Nass Gitwinksihlkw,2003,533,,212,14620
Nass Gitwinksihlkw,2003,410,,213,15030
Nass Gitwinksihlkw,2003,451,,214,15481
Nass Gitwinksihlkw,2003,530,,215,16011
Nass Gitwinksihlkw,2003,429,,216,16440
Nass Gitwinksihlkw,2003,224,,217,16664
Nass Gitwinksihlkw,2003,469,,218,17133
Nass Gitwinksihlkw,2003,411,,219,17544
Nass Gitwinksihlkw,2003,395,,220,17939
Nass Gitwinksihlkw,2003,278,,221,18217
Nass Gitwinksihlkw,2003,373,,222,18590
Nass Gitwinksihlkw,2003,401,,223,18991
Nass Gitwinksihlkw,2003,280,,224,19271
Nass Gitwinksihlkw,2003,174,,225,19445
Nass Gitwinksihlkw,2003,253,,226,19698
Nass Gitwinksihlkw,2003,195,,227,19893
Nass Gitwinksihlkw,2003,242,,228,20135
Nass Gitwinksihlkw,2003,207,,229,20342
Nass Gitwinksihlkw,2003,67,,230,20409
Nass Gitwinksihlkw,2003,130,,231,20539
Nass Gitwinksihlkw,2003,213,,232,20752
Nass Gitwinksihlkw,2003,321,,233,21073
Nass Gitwinksihlkw,2003,227,,234,21300
Nass Gitwinksihlkw,2003,432,,235,21732
Nass Gitwinksihlkw,2003,200,,236,21932
Nass Gitwinksihlkw,2003,128,,237,22060
Nass Gitwinksihlkw,2003,113,,238,22173
Nass Gitwinksihlkw,2003,81,,239,22254
Nass Gitwinksihlkw,2003,75,,240,22329
Nass Gitwinksihlkw,2003,76,,241,22405
Nass Gitwinksihlkw,2003,67,,242,22472
Nass Gitwinksihlkw,2003,64,,243,22536
Nass Gitwinksihlkw,2003,71,,244,22607
Nass Gitwinksihlkw,2003,45,,245,22652
Nass Gitwinksihlkw,2003,31,,246,22683
Nass Gitwinksihlkw,2003,49,,247,22732
Nass Gitwinksihlkw,2003,51,,248,22783
Nass Gitwinksihlkw,2003,0,,249,22783
Nass Gitwinksihlkw,2003,0,,250,22783
Nass Gitwinksihlkw,2003,0,,251,22783
Nass Gitwinksihlkw,2003,0,,252,22783
Nass Gitwinksihlkw,2003,0,,253,22783
Nass Gitwinksihlkw,2003,0,,254,22783
Nass Gitwinksihlkw,2003,0,,255,22783
Nass Gitwinksihlkw,2003,0,,256,22783
Nass Gitwinksihlkw,2003,0,,257,22783
Nass Gitwinksihlkw,2003,0,,258,22783
Nass Gitwinksihlkw,2003,0,,259,22783
Nass Gitwinksihlkw,2003,0,,260,22783
Nass Gitwinksihlkw,2003,0,,261,22783
Nass Gitwinksihlkw,2003,0,,262,22783
Nass Gitwinksihlkw,2003,0,,263,22783
Nass Gitwinksihlkw,2003,0,,264,22783
Nass Gitwinksihlkw,2003,0,,265,22783
Nass Gitwinksihlkw,2003,0,,266,22783
Nass Gitwinksihlkw,2003,0,,267,22783
Nass Gitwinksihlkw,2003,0,,268,22783
Nass Gitwinksihlkw,2003,0,,269,22783
Nass Gitwinksihlkw,2003,0,,270,22783
Nass Gitwinksihlkw,2003,0,,271,22783
Nass Gitwinksihlkw,2003,0,,272,22783
Nass Gitwinksihlkw,2003,0,,273,22783
Nass Gitwinksihlkw,2003,0,,274,22783
Nass Gitwinksihlkw,2003,0,,275,22783
Nass Gitwinksihlkw,2003,0,,276,22783
Nass Gitwinksihlkw,2003,0,,277,22783
Nass Gitwinksihlkw,2003,0,,278,22783
Nass Gitwinksihlkw,2003,0,,279,22783
Nass Gitwinksihlkw,2003,0,,280,22783
Nass Gitwinksihlkw,2003,0,,281,22783
Nass Gitwinksihlkw,2003,0,,282,22783
Nass Gitwinksihlkw,2003,0,,283,22783
Nass Gitwinksihlkw,2003,0,,284,22783
Nass Gitwinksihlkw,2003,0,,285,22783
Nass Gitwinksihlkw,2003,0,,286,22783
Nass Gitwinksihlkw,2005,0,,151,0
Nass Gitwinksihlkw,2005,0,,152,0
Nass Gitwinksihlkw,2005,0,,153,0
Nass Gitwinksihlkw,2005,0,,154,0
Nass Gitwinksihlkw,2005,0,,155,0
Nass Gitwinksihlkw,2005,0,,156,0
Nass Gitwinksihlkw,2005,0,,157,0
Nass Gitwinksihlkw,2005,0,,158,0
Nass Gitwinksihlkw,2005,0,,159,0
Nass Gitwinksihlkw,2005,0,,160,0
Nass Gitwinksihlkw,2005,0,,161,0
Nass Gitwinksihlkw,2005,0,,162,0
Nass Gitwinksihlkw,2005,0,,163,0
Nass Gitwinksihlkw,2005,0,,164,0
Nass Gitwinksihlkw,2005,0,,165,0
Nass Gitwinksihlkw,2005,0,,166,0
Nass Gitwinksihlkw,2005,0,,167,0
Nass Gitwinksihlkw,2005,0,,168,0
Nass Gitwinksihlkw,2005,0,,169,0
Nass Gitwinksihlkw,2005,0,,170,0
Nass Gitwinksihlkw,2005,0,,171,0
Nass Gitwinksihlkw,2005,0,,172,0
Nass Gitwinksihlkw,2005,0,,173,0
Nass Gitwinksihlkw,2005,0,,174,0
Nass Gitwinksihlkw,2005,0,,175,0
Nass Gitwinksihlkw,2005,0,,176,0
Nass Gitwinksihlkw,2005,0,,177,0
Nass Gitwinksihlkw,2005,0,,178,0
Nass Gitwinksihlkw,2005,0,,179,0
Nass Gitwinksihlkw,2005,1,,180,1
Nass Gitwinksihlkw,2005,1,,181,2
Nass Gitwinksihlkw,2005,0,,182,2
Nass Gitwinksihlkw,2005,0,,183,2
Nass Gitwinksihlkw,2005,7,,184,9
Nass Gitwinksihlkw,2005,4,,185,13
Nass Gitwinksihlkw,2005,2,,186,15
Nass Gitwinksihlkw,2005,0,,187,15
Nass Gitwinksihlkw,2005,1,,188,16
Nass Gitwinksihlkw,2005,7,,189,23
Nass Gitwinksihlkw,2005,14,,190,37
Nass Gitwinksihlkw,2005,6,,191,43
Nass Gitwinksihlkw,2005,14,,192,57
Nass Gitwinksihlkw,2005,20,,193,77
Nass Gitwinksihlkw,2005,27,,194,104
Nass Gitwinksihlkw,2005,33,,195,137
Nass Gitwinksihlkw,2005,132,,196,269
Nass Gitwinksihlkw,2005,65,,197,334
Nass Gitwinksihlkw,2005,321,,198,655
Nass Gitwinksihlkw,2005,372,,199,1027
Nass Gitwinksihlkw,2005,239,,200,1266
Nass Gitwinksihlkw,2005,337,,201,1603
Nass Gitwinksihlkw,2005,284,,202,1887
Nass Gitwinksihlkw,2005,432,,203,2319
Nass Gitwinksihlkw,2005,517,,204,2836
Nass Gitwinksihlkw,2005,453,,205,3289
Nass Gitwinksihlkw,2005,503,,206,3792
Nass Gitwinksihlkw,2005,342,,207,4134
Nass Gitwinksihlkw,2005,234,,208,4368
Nass Gitwinksihlkw,2005,107,,209,4475
Nass Gitwinksihlkw,2005,168,,210,4643
Nass Gitwinksihlkw,2005,142,,211,4785
Nass Gitwinksihlkw,2005,245,,212,5030
Nass Gitwinksihlkw,2005,369,,213,5399
Nass Gitwinksihlkw,2005,313,,214,5712
Nass Gitwinksihlkw,2005,218,,215,5930
Nass Gitwinksihlkw,2005,155,,216,6085
Nass Gitwinksihlkw,2005,142,,217,6227
Nass Gitwinksihlkw,2005,109,,218,6336
Nass Gitwinksihlkw,2005,158,,219,6494
Nass Gitwinksihlkw,2005,117,,220,6611
Nass Gitwinksihlkw,2005,162,,221,6773
Nass Gitwinksihlkw,2005,145,,222,6918
Nass Gitwinksihlkw,2005,150,,223,7068
Nass Gitwinksihlkw,2005,122,,224,7190
Nass Gitwinksihlkw,2005,106,,225,7296
Nass Gitwinksihlkw,2005,148,,226,7444
Nass Gitwinksihlkw,2005,142,,227,7586
Nass Gitwinksihlkw,2005,93,,228,7679
Nass Gitwinksihlkw,2005,66,,229,7745
Nass Gitwinksihlkw,2005,209,,230,7954
Nass Gitwinksihlkw,2005,202,,231,8156
Nass Gitwinksihlkw,2005,72,,232,8228
Nass Gitwinksihlkw,2005,32,,233,8260
Nass Gitwinksihlkw,2005,51,,234,8311
Nass Gitwinksihlkw,2005,186,,235,8497
Nass Gitwinksihlkw,2005,243,,236,8740
Nass Gitwinksihlkw,2005,136,,237,8876
Nass Gitwinksihlkw,2005,76,,238,8952
Nass Gitwinksihlkw,2005,88,,239,9040
Nass Gitwinksihlkw,2005,94,,240,9134
Nass Gitwinksihlkw,2005,56,,241,9190
Nass Gitwinksihlkw,2005,49,,242,9239
Nass Gitwinksihlkw,2005,25,,243,9264
Nass Gitwinksihlkw,2005,25,,244,9289
Nass Gitwinksihlkw,2005,27,,245,9316
Nass Gitwinksihlkw,2005,28,,246,9344
Nass Gitwinksihlkw,2005,25,,247,9369
Nass Gitwinksihlkw,2005,20,,248,9389
Nass Gitwinksihlkw,2005,23,,249,9412
Nass Gitwinksihlkw,2005,17,,250,9429
Nass Gitwinksihlkw,2005,3,,251,9432
Nass Gitwinksihlkw,2005,2,,252,9434
Nass Gitwinksihlkw,2005,11,,253,9445
Nass Gitwinksihlkw,2005,19,,254,9464
Nass Gitwinksihlkw,2005,11,,255,9475
Nass Gitwinksihlkw,2005,6,,256,9481
Nass Gitwinksihlkw,2005,7,,257,9488
Nass Gitwinksihlkw,2005,6,,258,9494
Nass Gitwinksihlkw,2005,7,,259,9501
Nass Gitwinksihlkw,2005,0,,260,9501
Nass Gitwinksihlkw,2005,0,,261,9501
Nass Gitwinksihlkw,2005,0,,262,9501
Nass Gitwinksihlkw,2005,0,,263,9501
Nass Gitwinksihlkw,2005,0,,264,9501
Nass Gitwinksihlkw,2005,0,,265,9501
Nass Gitwinksihlkw,2005,0,,266,9501
Nass Gitwinksihlkw,2005,0,,267,9501
Nass Gitwinksihlkw,2005,0,,268,9501
Nass Gitwinksihlkw,2005,0,,269,9501
Nass Gitwinksihlkw,2005,0,,270,9501
Nass Gitwinksihlkw,2005,0,,271,9501
Nass Gitwinksihlkw,2005,0,,272,9501
Nass Gitwinksihlkw,2005,0,,273,9501
Nass Gitwinksihlkw,2005,0,,274,9501
Nass Gitwinksihlkw,2005,0,,275,9501
Nass Gitwinksihlkw,2005,0,,276,9501
Nass Gitwinksihlkw,2005,0,,277,9501
Nass Gitwinksihlkw,2005,0,,278,9501
Nass Gitwinksihlkw,2005,0,,279,9501
Nass Gitwinksihlkw,2005,0,,280,9501
Nass Gitwinksihlkw,2005,0,,281,9501
Nass Gitwinksihlkw,2005,0,,282,9501
Nass Gitwinksihlkw,2005,0,,283,9501
Nass Gitwinksihlkw,2005,0,,284,9501
Nass Gitwinksihlkw,2005,0,,285,9501
Nass Gitwinksihlkw,2005,0,,286,9501
Nass Gitwinksihlkw,2007,0,,151,0
Nass Gitwinksihlkw,2007,0,,152,0
Nass Gitwinksihlkw,2007,0,,153,0
Nass Gitwinksihlkw,2007,0,,154,0
Nass Gitwinksihlkw,2007,0,,155,0
Nass Gitwinksihlkw,2007,0,,156,0
Nass Gitwinksihlkw,2007,0,,157,0
Nass Gitwinksihlkw,2007,0,,158,0
Nass Gitwinksihlkw,2007,0,,159,0
Nass Gitwinksihlkw,2007,0,,160,0
Nass Gitwinksihlkw,2007,0,,161,0
Nass Gitwinksihlkw,2007,0,,162,0
Nass Gitwinksihlkw,2007,0,,163,0
Nass Gitwinksihlkw,2007,0,,164,0
Nass Gitwinksihlkw,2007,0,,165,0
Nass Gitwinksihlkw,2007,0,,166,0
Nass Gitwinksihlkw,2007,0,,167,0
Nass Gitwinksihlkw,2007,0,,168,0
Nass Gitwinksihlkw,2007,0,,169,0
Nass Gitwinksihlkw,2007,0,,170,0
Nass Gitwinksihlkw,2007,0,,171,0
Nass Gitwinksihlkw,2007,0,,172,0
Nass Gitwinksihlkw,2007,0,,173,0
Nass Gitwinksihlkw,2007,0,,174,0
Nass Gitwinksihlkw,2007,0,,175,0
Nass Gitwinksihlkw,2007,0,,176,0
Nass Gitwinksihlkw,2007,0,,177,0
Nass Gitwinksihlkw,2007,0,,178,0
Nass Gitwinksihlkw,2007,0,,179,0
Nass Gitwinksihlkw,2007,0,,180,0
Nass Gitwinksihlkw,2007,0,,181,0
Nass Gitwinksihlkw,2007,0,,182,0
Nass Gitwinksihlkw,2007,0,,183,0
Nass Gitwinksihlkw,2007,0,,184,0
Nass Gitwinksihlkw,2007,0,,185,0
Nass Gitwinksihlkw,2007,0,,186,0
Nass Gitwinksihlkw,2007,0,,187,0
Nass Gitwinksihlkw,2007,0,,188,0
Nass Gitwinksihlkw,2007,0,,189,0
Nass Gitwinksihlkw,2007,0,,190,0
Nass Gitwinksihlkw,2007,1,,191,1
Nass Gitwinksihlkw,2007,0,,192,1
Nass Gitwinksihlkw,2007,0,,193,1
Nass Gitwinksihlkw,2007,0,,194,1
Nass Gitwinksihlkw,2007,0,,195,1
Nass Gitwinksihlkw,2007,0,,196,1
Nass Gitwinksihlkw,2007,0,,197,1
Nass Gitwinksihlkw,2007,0,,198,1
Nass Gitwinksihlkw,2007,0,,199,1
Nass Gitwinksihlkw,2007,0,,200,1
Nass Gitwinksihlkw,2007,2,,201,3
Nass Gitwinksihlkw,2007,0,,202,3
Nass Gitwinksihlkw,2007,12,,203,15
Nass Gitwinksihlkw,2007,19,,204,34
Nass Gitwinksihlkw,2007,18,,205,52
Nass Gitwinksihlkw,2007,68,,206,120
Nass Gitwinksihlkw,2007,53,,207,173
Nass Gitwinksihlkw,2007,130,,208,303
Nass Gitwinksihlkw,2007,237,,209,540
Nass Gitwinksihlkw,2007,132,,210,672
Nass Gitwinksihlkw,2007,515,,211,1187
Nass Gitwinksihlkw,2007,521,,212,1708
Nass Gitwinksihlkw,2007,582,,213,2290
Nass Gitwinksihlkw,2007,549,,214,2839
Nass Gitwinksihlkw,2007,412,,215,3251
Nass Gitwinksihlkw,2007,393,,216,3644
Nass Gitwinksihlkw,2007,337,,217,3981
Nass Gitwinksihlkw,2007,352,,218,4333
Nass Gitwinksihlkw,2007,390,,219,4723
Nass Gitwinksihlkw,2007,290,,220,5013
Nass Gitwinksihlkw,2007,389,,221,5402
Nass Gitwinksihlkw,2007,276,,222,5678
Nass Gitwinksihlkw,2007,372,,223,6050
Nass Gitwinksihlkw,2007,368,,224,6418
Nass Gitwinksihlkw,2007,328,,225,6746
Nass Gitwinksihlkw,2007,198,,226,6944
Nass Gitwinksihlkw,2007,207,,227,7151
Nass Gitwinksihlkw,2007,135,,228,7286
Nass Gitwinksihlkw,2007,104,,229,7390
Nass Gitwinksihlkw,2007,84,,230,7474
Nass Gitwinksihlkw,2007,36,,231,7510
Nass Gitwinksihlkw,2007,57,,232,7567
Nass Gitwinksihlkw,2007,93,,233,7660
Nass Gitwinksihlkw,2007,151,,234,7811
Nass Gitwinksihlkw,2007,136,,235,7947
Nass Gitwinksihlkw,2007,69,,236,8016
Nass Gitwinksihlkw,2007,60,,237,8076
Nass Gitwinksihlkw,2007,49,,238,8125
Nass Gitwinksihlkw,2007,38,,239,8163
Nass Gitwinksihlkw,2007,21,,240,8184
Nass Gitwinksihlkw,2007,27,,241,8211
Nass Gitwinksihlkw,2007,30,,242,8241
Nass Gitwinksihlkw,2007,18,,243,8259
Nass Gitwinksihlkw,2007,18,,244,8277
Nass Gitwinksihlkw,2007,20,,245,8297
Nass Gitwinksihlkw,2007,15,,246,8312
Nass Gitwinksihlkw,2007,16,,247,8328
Nass Gitwinksihlkw,2007,8,,248,8336
Nass Gitwinksihlkw,2007,17,,249,8353
Nass Gitwinksihlkw,2007,22,,250,8375
Nass Gitwinksihlkw,2007,20,,251,8395
Nass Gitwinksihlkw,2007,14,,252,8409
Nass Gitwinksihlkw,2007,10,,253,8419
Nass Gitwinksihlkw,2007,9,,254,8428
Nass Gitwinksihlkw,2007,9,,255,8437
Nass Gitwinksihlkw,2007,2,,256,8439
Nass Gitwinksihlkw,2007,1,,257,8440
Nass Gitwinksihlkw,2007,2,,258,8442
Nass Gitwinksihlkw,2007,2,,259,8444
Nass Gitwinksihlkw,2007,4,,260,8448
Nass Gitwinksihlkw,2007,1,,261,8449
Nass Gitwinksihlkw,2007,0,,262,8449
Nass Gitwinksihlkw,2007,0,,263,8449
Nass Gitwinksihlkw,2007,0,,264,8449
Nass Gitwinksihlkw,2007,0,,265,8449
Nass Gitwinksihlkw,2007,0,,266,8449
Nass Gitwinksihlkw,2007,0,,267,8449
Nass Gitwinksihlkw,2007,0,,268,8449
Nass Gitwinksihlkw,2007,0,,269,8449
Nass Gitwinksihlkw,2007,0,,270,8449
Nass Gitwinksihlkw,2007,0,,271,8449
Nass Gitwinksihlkw,2007,0,,272,8449
Nass Gitwinksihlkw,2007,0,,273,8449
Nass Gitwinksihlkw,2007,0,,274,8449
Nass Gitwinksihlkw,2007,0,,275,8449
Nass Gitwinksihlkw,2007,0,,276,8449
Nass Gitwinksihlkw,2007,0,,277,8449
Nass Gitwinksihlkw,2007,0,,278,8449
Nass Gitwinksihlkw,2007,0,,279,8449
Nass Gitwinksihlkw,2007,0,,280,8449
Nass Gitwinksihlkw,2007,0,,281,8449
Nass Gitwinksihlkw,2007,0,,282,8449
Nass Gitwinksihlkw,2007,0,,283,8449
Nass Gitwinksihlkw,2007,0,,284,8449
Nass Gitwinksihlkw,2007,0,,285,8449
Nass Gitwinksihlkw,2007,0,,286,8449
Nass Gitwinksihlkw,2009,0,,151,0
Nass Gitwinksihlkw,2009,0,,152,0
Nass Gitwinksihlkw,2009,0,,153,0
Nass Gitwinksihlkw,2009,0,,154,0
Nass Gitwinksihlkw,2009,0,,155,0
Nass Gitwinksihlkw,2009,0,,156,0
Nass Gitwinksihlkw,2009,0,,157,0
Nass Gitwinksihlkw,2009,0,,158,0
Nass Gitwinksihlkw,2009,0,,159,0
Nass Gitwinksihlkw,2009,0,,160,0
Nass Gitwinksihlkw,2009,0,,161,0
Nass Gitwinksihlkw,2009,0,,162,0
Nass Gitwinksihlkw,2009,0,,163,0
Nass Gitwinksihlkw,2009,0,,164,0
Nass Gitwinksihlkw,2009,0,,165,0
Nass Gitwinksihlkw,2009,0,,166,0
Nass Gitwinksihlkw,2009,0,,167,0
Nass Gitwinksihlkw,2009,0,,168,0
Nass Gitwinksihlkw,2009,0,,169,0
Nass Gitwinksihlkw,2009,0,,170,0
Nass Gitwinksihlkw,2009,0,,171,0
Nass Gitwinksihlkw,2009,0,,172,0
Nass Gitwinksihlkw,2009,0,,173,0
Nass Gitwinksihlkw,2009,0,,174,0
Nass Gitwinksihlkw,2009,0,,175,0
Nass Gitwinksihlkw,2009,0,,176,0
Nass Gitwinksihlkw,2009,0,,177,0
Nass Gitwinksihlkw,2009,0,,178,0
Nass Gitwinksihlkw,2009,0,,179,0
Nass Gitwinksihlkw,2009,0,,180,0
Nass Gitwinksihlkw,2009,0,,181,0
Nass Gitwinksihlkw,2009,1,,182,1
Nass Gitwinksihlkw,2009,0,,183,1
Nass Gitwinksihlkw,2009,2,,184,3
Nass Gitwinksihlkw,2009,3,,185,6
Nass Gitwinksihlkw,2009,2,,186,8
Nass Gitwinksihlkw,2009,1,,187,9
Nass Gitwinksihlkw,2009,0,,188,9
Nass Gitwinksihlkw,2009,1,,189,10
Nass Gitwinksihlkw,2009,1,,190,11
Nass Gitwinksihlkw,2009,7,,191,18
Nass Gitwinksihlkw,2009,4,,192,22
Nass Gitwinksihlkw,2009,1,,193,23
Nass Gitwinksihlkw,2009,4,,194,27
Nass Gitwinksihlkw,2009,7,,195,34
Nass Gitwinksihlkw,2009,16,,196,50
Nass Gitwinksihlkw,2009,37,,197,87
Nass Gitwinksihlkw,2009,76,,198,163
Nass Gitwinksihlkw,2009,78,,199,241
Nass Gitwinksihlkw,2009,70,,200,311
Nass Gitwinksihlkw,2009,167,,201,478
Nass Gitwinksihlkw,2009,235,,202,713
Nass Gitwinksihlkw,2009,354,,203,1067
Nass Gitwinksihlkw,2009,390,,204,1457
Nass Gitwinksihlkw,2009,396,,205,1853
Nass Gitwinksihlkw,2009,317,,206,2170
Nass Gitwinksihlkw,2009,296,,207,2466
Nass Gitwinksihlkw,2009,427,,208,2893
Nass Gitwinksihlkw,2009,488,,209,3381
Nass Gitwinksihlkw,2009,406,,210,3787
Nass Gitwinksihlkw,2009,153,,211,3940
Nass Gitwinksihlkw,2009,280,,212,4220
Nass Gitwinksihlkw,2009,136,,213,4356
Nass Gitwinksihlkw,2009,270,,214,4626
Nass Gitwinksihlkw,2009,818,,215,5444
Nass Gitwinksihlkw,2009,1346,,216,6790
Nass Gitwinksihlkw,2009,2154,,217,8944
Nass Gitwinksihlkw,2009,2004,,218,10948
Nass Gitwinksihlkw,2009,1857,,219,12805
Nass Gitwinksihlkw,2009,1469,,220,14274
Nass Gitwinksihlkw,2009,1049,,221,15323
Nass Gitwinksihlkw,2009,897,,222,16220
Nass Gitwinksihlkw,2009,625,,223,16845
Nass Gitwinksihlkw,2009,704,,224,17549
Nass Gitwinksihlkw,2009,664,,225,18213
Nass Gitwinksihlkw,2009,592,,226,18805
Nass Gitwinksihlkw,2009,379,,227,19184
Nass Gitwinksihlkw,2009,278,,228,19462
Nass Gitwinksihlkw,2009,316,,229,19778
Nass Gitwinksihlkw,2009,282,,230,20060
Nass Gitwinksihlkw,2009,267,,231,20327
Nass Gitwinksihlkw,2009,228,,232,20555
Nass Gitwinksihlkw,2009,227,,233,20782
Nass Gitwinksihlkw,2009,321,,234,21103
Nass Gitwinksihlkw,2009,433,,235,21536
Nass Gitwinksihlkw,2009,397,,236,21933
Nass Gitwinksihlkw,2009,316,,237,22249
Nass Gitwinksihlkw,2009,259,,238,22508
Nass Gitwinksihlkw,2009,184,,239,22692
Nass Gitwinksihlkw,2009,174,,240,22866
Nass Gitwinksihlkw,2009,141,,241,23007
Nass Gitwinksihlkw,2009,114,,242,23121
Nass Gitwinksihlkw,2009,132,,243,23253
Nass Gitwinksihlkw,2009,159,,244,23412
Nass Gitwinksihlkw,2009,118,,245,23530
Nass Gitwinksihlkw,2009,101,,246,23631
Nass Gitwinksihlkw,2009,82,,247,23713
Nass Gitwinksihlkw,2009,49,,248,23762
Nass Gitwinksihlkw,2009,51,,249,23813
Nass Gitwinksihlkw,2009,45,,250,23858
Nass Gitwinksihlkw,2009,69,,251,23927
Nass Gitwinksihlkw,2009,29,,252,23956
Nass Gitwinksihlkw,2009,23,,253,23979
Nass Gitwinksihlkw,2009,13,,254,23992
Nass Gitwinksihlkw,2009,12,,255,24004
Nass Gitwinksihlkw,2009,0,,256,24004
Nass Gitwinksihlkw,2009,0,,257,24004
Nass Gitwinksihlkw,2009,0,,258,24004
Nass Gitwinksihlkw,2009,0,,259,24004
Nass Gitwinksihlkw,2009,0,,260,24004
Nass Gitwinksihlkw,2009,0,,261,24004
Nass Gitwinksihlkw,2009,0,,262,24004
Nass Gitwinksihlkw,2009,0,,263,24004
Nass Gitwinksihlkw,2009,0,,264,24004
Nass Gitwinksihlkw,2009,0,,265,24004
Nass Gitwinksihlkw,2009,0,,266,24004
Nass Gitwinksihlkw,2009,0,,267,24004
Nass Gitwinksihlkw,2009,0,,268,24004
Nass Gitwinksihlkw,2009,0,,269,24004
Nass Gitwinksihlkw,2009,0,,270,24004
Nass Gitwinksihlkw,2009,0,,271,24004
Nass Gitwinksihlkw,2009,0,,272,24004
Nass Gitwinksihlkw,2009,0,,273,24004
Nass Gitwinksihlkw,2009,0,,274,24004
Nass Gitwinksihlkw,2009,0,,275,24004
Nass Gitwinksihlkw,2009,0,,276,24004
Nass Gitwinksihlkw,2009,0,,277,24004
Nass Gitwinksihlkw,2009,0,,278,24004
Nass Gitwinksihlkw,2009,0,,279,24004
Nass Gitwinksihlkw,2009,0,,280,24004
Nass Gitwinksihlkw,2009,0,,281,24004
Nass Gitwinksihlkw,2009,0,,282,24004
Nass Gitwinksihlkw,2009,0,,283,24004
Nass Gitwinksihlkw,2009,0,,284,24004
Nass Gitwinksihlkw,2009,0,,285,24004
Nass Gitwinksihlkw,2009,0,,286,24004
Nass Gitwinksihlkw,2011,0,,151,0
Nass Gitwinksihlkw,2011,0,,152,0
Nass Gitwinksihlkw,2011,0,,153,0
Nass Gitwinksihlkw,2011,0,,154,0
Nass Gitwinksihlkw,2011,0,,155,0
Nass Gitwinksihlkw,2011,0,,156,0
Nass Gitwinksihlkw,2011,0,,157,0
Nass Gitwinksihlkw,2011,0,,158,0
Nass Gitwinksihlkw,2011,0,,159,0
Nass Gitwinksihlkw,2011,0,,160,0
Nass Gitwinksihlkw,2011,0,,161,0
Nass Gitwinksihlkw,2011,0,,162,0
Nass Gitwinksihlkw,2011,0,,163,0
Nass Gitwinksihlkw,2011,0,,164,0
Nass Gitwinksihlkw,2011,0,,165,0
Nass Gitwinksihlkw,2011,0,,166,0
Nass Gitwinksihlkw,2011,0,,167,0
Nass Gitwinksihlkw,2011,0,,168,0
Nass Gitwinksihlkw,2011,0,,169,0
Nass Gitwinksihlkw,2011,0,,170,0
Nass Gitwinksihlkw,2011,0,,171,0
Nass Gitwinksihlkw,2011,0,,172,0
Nass Gitwinksihlkw,2011,0,,173,0
Nass Gitwinksihlkw,2011,0,,174,0
Nass Gitwinksihlkw,2011,0,,175,0
Nass Gitwinksihlkw,2011,0,,176,0
Nass Gitwinksihlkw,2011,0,,177,0
Nass Gitwinksihlkw,2011,0,,178,0
Nass Gitwinksihlkw,2011,0,,179,0
Nass Gitwinksihlkw,2011,0,,180,0
Nass Gitwinksihlkw,2011,0,,181,0
Nass Gitwinksihlkw,2011,0,,182,0
Nass Gitwinksihlkw,2011,0,,183,0
Nass Gitwinksihlkw,2011,0,,184,0
Nass Gitwinksihlkw,2011,1,,185,1
Nass Gitwinksihlkw,2011,0,,186,1
Nass Gitwinksihlkw,2011,0,,187,1
Nass Gitwinksihlkw,2011,0,,188,1
Nass Gitwinksihlkw,2011,1,,189,2
Nass Gitwinksihlkw,2011,0,,190,2
Nass Gitwinksihlkw,2011,3,,191,5
Nass Gitwinksihlkw,2011,3,,192,8
Nass Gitwinksihlkw,2011,5,,193,13
Nass Gitwinksihlkw,2011,8,,194,21
Nass Gitwinksihlkw,2011,9,,195,30
Nass Gitwinksihlkw,2011,6,,196,36
Nass Gitwinksihlkw,2011,27,,197,63
Nass Gitwinksihlkw,2011,23,,198,86
Nass Gitwinksihlkw,2011,54,,199,140
Nass Gitwinksihlkw,2011,47,,200,187
Nass Gitwinksihlkw,2011,49,,201,236
Nass Gitwinksihlkw,2011,72,,202,308
Nass Gitwinksihlkw,2011,81,,203,389
Nass Gitwinksihlkw,2011,110,,204,499
Nass Gitwinksihlkw,2011,121,,205,620
Nass Gitwinksihlkw,2011,111,,206,731
Nass Gitwinksihlkw,2011,147,,207,878
Nass Gitwinksihlkw,2011,248,,208,1126
Nass Gitwinksihlkw,2011,254,,209,1380
Nass Gitwinksihlkw,2011,190,,210,1570
Nass Gitwinksihlkw,2011,326,,211,1896
Nass Gitwinksihlkw,2011,223,,212,2119
Nass Gitwinksihlkw,2011,328,,213,2447
Nass Gitwinksihlkw,2011,332,,214,2779
Nass Gitwinksihlkw,2011,286,,215,3065
Nass Gitwinksihlkw,2011,348,,216,3413
Nass Gitwinksihlkw,2011,248,,217,3661
Nass Gitwinksihlkw,2011,244,,218,3905
Nass Gitwinksihlkw,2011,190,,219,4095
Nass Gitwinksihlkw,2011,140,,220,4235
Nass Gitwinksihlkw,2011,79,,221,4314
Nass Gitwinksihlkw,2011,92,,222,4406
Nass Gitwinksihlkw,2011,92,,223,4498
Nass Gitwinksihlkw,2011,96,,224,4594
Nass Gitwinksihlkw,2011,84,,225,4678
Nass Gitwinksihlkw,2011,45,,226,4723
Nass Gitwinksihlkw,2011,43,,227,4766
Nass Gitwinksihlkw,2011,26,,228,4792
Nass Gitwinksihlkw,2011,30,,229,4822
Nass Gitwinksihlkw,2011,37,,230,4859
Nass Gitwinksihlkw,2011,43,,231,4902
Nass Gitwinksihlkw,2011,25,,232,4927
Nass Gitwinksihlkw,2011,5,,233,4932
Nass Gitwinksihlkw,2011,0,,234,4932
Nass Gitwinksihlkw,2011,0,,235,4932
Nass Gitwinksihlkw,2011,9,,236,4941
Nass Gitwinksihlkw,2011,12,,237,4953
Nass Gitwinksihlkw,2011,62,,238,5015
Nass Gitwinksihlkw,2011,93,,239,5108
Nass Gitwinksihlkw,2011,106,,240,5214
Nass Gitwinksihlkw,2011,105,,241,5319
Nass Gitwinksihlkw,2011,95,,242,5414
Nass Gitwinksihlkw,2011,135,,243,5549
Nass Gitwinksihlkw,2011,182,,244,5731
Nass Gitwinksihlkw,2011,132,,245,5863
Nass Gitwinksihlkw,2011,73,,246,5936
Nass Gitwinksihlkw,2011,36,,247,5972
Nass Gitwinksihlkw,2011,14,,248,5986
Nass Gitwinksihlkw,2011,5,,249,5991
Nass Gitwinksihlkw,2011,0,,250,5991
Nass Gitwinksihlkw,2011,0,,251,5991
Nass Gitwinksihlkw,2011,0,,252,5991
Nass Gitwinksihlkw,2011,0,,253,5991
Nass Gitwinksihlkw,2011,0,,254,5991
Nass Gitwinksihlkw,2011,0,,255,5991
Nass Gitwinksihlkw,2011,0,,256,5991
Nass Gitwinksihlkw,2011,104,,257,6095
Nass Gitwinksihlkw,2011,84,,258,6179
Nass Gitwinksihlkw,2011,60,,259,6239
Nass Gitwinksihlkw,2011,22,,260,6261
Nass Gitwinksihlkw,2011,0,,261,6261
Nass Gitwinksihlkw,2011,0,,262,6261
Nass Gitwinksihlkw,2011,0,,263,6261
Nass Gitwinksihlkw,2011,0,,264,6261
Nass Gitwinksihlkw,2011,0,,265,6261
Nass Gitwinksihlkw,2011,0,,266,6261
Nass Gitwinksihlkw,2011,0,,267,6261
Nass Gitwinksihlkw,2011,0,,268,6261
Nass Gitwinksihlkw,2011,0,,269,6261
Nass Gitwinksihlkw,2011,0,,270,6261
Nass Gitwinksihlkw,2011,0,,271,6261
Nass Gitwinksihlkw,2011,0,,272,6261
Nass Gitwinksihlkw,2011,0,,273,6261
Nass Gitwinksihlkw,2011,0,,274,6261
Nass Gitwinksihlkw,2011,0,,275,6261
Nass Gitwinksihlkw,2011,0,,276,6261
Nass Gitwinksihlkw,2011,0,,277,6261
Nass Gitwinksihlkw,2011,0,,278,6261
Nass Gitwinksihlkw,2011,0,,279,6261
Nass Gitwinksihlkw,2011,0,,280,6261
Nass Gitwinksihlkw,2011,0,,281,6261
Nass Gitwinksihlkw,2011,0,,282,6261
Nass Gitwinksihlkw,2011,0,,283,6261
Nass Gitwinksihlkw,2011,0,,284,6261
Nass Gitwinksihlkw,2011,0,,285,6261
Nass Gitwinksihlkw,2011,0,,286,6261
Nass Gitwinksihlkw,2013,0,,151,0
Nass Gitwinksihlkw,2013,0,,152,0
Nass Gitwinksihlkw,2013,0,,153,0
Nass Gitwinksihlkw,2013,0,,154,0
Nass Gitwinksihlkw,2013,0,,155,0
Nass Gitwinksihlkw,2013,0,,156,0
Nass Gitwinksihlkw,2013,0,,157,0
Nass Gitwinksihlkw,2013,0,,158,0
Nass Gitwinksihlkw,2013,0,,159,0
Nass Gitwinksihlkw,2013,0,,160,0
Nass Gitwinksihlkw,2013,0,,161,0
Nass Gitwinksihlkw,2013,0,,162,0
Nass Gitwinksihlkw,2013,0,,163,0
Nass Gitwinksihlkw,2013,0,,164,0
Nass Gitwinksihlkw,2013,0,,165,0
Nass Gitwinksihlkw,2013,0,,166,0
Nass Gitwinksihlkw,2013,0,,167,0
Nass Gitwinksihlkw,2013,0,,168,0
Nass Gitwinksihlkw,2013,0,,169,0
Nass Gitwinksihlkw,2013,0,,170,0
Nass Gitwinksihlkw,2013,0,,171,0
Nass Gitwinksihlkw,2013,0,,172,0
Nass Gitwinksihlkw,2013,0,,173,0
Nass Gitwinksihlkw,2013,0,,174,0
Nass Gitwinksihlkw,2013,0,,175,0
Nass Gitwinksihlkw,2013,0,,176,0
Nass Gitwinksihlkw,2013,0,,177,0
Nass Gitwinksihlkw,2013,0,,178,0
Nass Gitwinksihlkw,2013,0,,179,0
Nass Gitwinksihlkw,2013,0,,180,0
Nass Gitwinksihlkw,2013,0,,181,0
Nass Gitwinksihlkw,2013,2,,182,2
Nass Gitwinksihlkw,2013,1,,183,3
Nass Gitwinksihlkw,2013,0,,184,3
Nass Gitwinksihlkw,2013,3,,185,6
Nass Gitwinksihlkw,2013,7,,186,13
Nass Gitwinksihlkw,2013,14,,187,27
Nass Gitwinksihlkw,2013,16,,188,43
Nass Gitwinksihlkw,2013,16,,189,59
Nass Gitwinksihlkw,2013,14,,190,73
Nass Gitwinksihlkw,2013,10,,191,83
Nass Gitwinksihlkw,2013,25,,192,108
Nass Gitwinksihlkw,2013,40,,193,148
Nass Gitwinksihlkw,2013,30,,194,178
Nass Gitwinksihlkw,2013,13,,195,191
Nass Gitwinksihlkw,2013,6,,196,197
Nass Gitwinksihlkw,2013,39,,197,236
Nass Gitwinksihlkw,2013,73,,198,309
Nass Gitwinksihlkw,2013,73,,199,382
Nass Gitwinksihlkw,2013,109,,200,491
Nass Gitwinksihlkw,2013,118,,201,609
Nass Gitwinksihlkw,2013,259,,202,868
Nass Gitwinksihlkw,2013,362,,203,1230
Nass Gitwinksihlkw,2013,548,,204,1778
Nass Gitwinksihlkw,2013,539,,205,2317
Nass Gitwinksihlkw,2013,384,,206,2701
Nass Gitwinksihlkw,2013,395,,207,3096
Nass Gitwinksihlkw,2013,308,,208,3404
Nass Gitwinksihlkw,2013,440,,209,3844
Nass Gitwinksihlkw,2013,513,,210,4357
Nass Gitwinksihlkw,2013,433,,211,4790
Nass Gitwinksihlkw,2013,320,,212,5110
Nass Gitwinksihlkw,2013,233,,213,5343
Nass Gitwinksihlkw,2013,300,,214,5643
Nass Gitwinksihlkw,2013,450,,215,6093
Nass Gitwinksihlkw,2013,476,,216,6569
Nass Gitwinksihlkw,2013,634,,217,7203
Nass Gitwinksihlkw,2013,606,,218,7809
Nass Gitwinksihlkw,2013,645,,219,8454
Nass Gitwinksihlkw,2013,553,,220,9007
Nass Gitwinksihlkw,2013,465,,221,9472
Nass Gitwinksihlkw,2013,610,,222,10082
Nass Gitwinksihlkw,2013,535,,223,10617
Nass Gitwinksihlkw,2013,467,,224,11084
Nass Gitwinksihlkw,2013,272,,225,11356
Nass Gitwinksihlkw,2013,135,,226,11491
Nass Gitwinksihlkw,2013,235,,227,11726
Nass Gitwinksihlkw,2013,123,,228,11849
Nass Gitwinksihlkw,2013,285,,229,12134
Nass Gitwinksihlkw,2013,209,,230,12343
Nass Gitwinksihlkw,2013,122,,231,12465
Nass Gitwinksihlkw,2013,132,,232,12597
Nass Gitwinksihlkw,2013,288,,233,12885
Nass Gitwinksihlkw,2013,194,,234,13079
Nass Gitwinksihlkw,2013,185,,235,13264
Nass Gitwinksihlkw,2013,168,,236,13432
Nass Gitwinksihlkw,2013,154,,237,13586
Nass Gitwinksihlkw,2013,119,,238,13705
Nass Gitwinksihlkw,2013,101,,239,13806
Nass Gitwinksihlkw,2013,134,,240,13940
Nass Gitwinksihlkw,2013,122,,241,14062
Nass Gitwinksihlkw,2013,99,,242,14161
Nass Gitwinksihlkw,2013,66,,243,14227
Nass Gitwinksihlkw,2013,46,,244,14273
Nass Gitwinksihlkw,2013,35,,245,14308
Nass Gitwinksihlkw,2013,67,,246,14375
Nass Gitwinksihlkw,2013,33,,247,14408
Nass Gitwinksihlkw,2013,41,,248,14449
Nass Gitwinksihlkw,2013,41,,249,14490
Nass Gitwinksihlkw,2013,28,,250,14518
Nass Gitwinksihlkw,2013,18,,251,14536
Nass Gitwinksihlkw,2013,14,,252,14550
Nass Gitwinksihlkw,2013,13,,253,14563
Nass Gitwinksihlkw,2013,22,,254,14585
Nass Gitwinksihlkw,2013,14,,255,14599
Nass Gitwinksihlkw,2013,4,,256,14603
Nass Gitwinksihlkw,2013,0,,257,14603
Nass Gitwinksihlkw,2013,0,,258,14603
Nass Gitwinksihlkw,2013,0,,259,14603
Nass Gitwinksihlkw,2013,0,,260,14603
Nass Gitwinksihlkw,2013,0,,261,14603
Nass Gitwinksihlkw,2013,0,,262,14603
Nass Gitwinksihlkw,2013,0,,263,14603
Nass Gitwinksihlkw,2013,0,,264,14603
Nass Gitwinksihlkw,2013,0,,265,14603
Nass Gitwinksihlkw,2013,0,,266,14603
Nass Gitwinksihlkw,2013,0,,267,14603
Nass Gitwinksihlkw,2013,0,,268,14603
Nass Gitwinksihlkw,2013,0,,269,14603
Nass Gitwinksihlkw,2013,0,,270,14603
Nass Gitwinksihlkw,2013,0,,271,14603
Nass Gitwinksihlkw,2013,0,,272,14603
Nass Gitwinksihlkw,2013,0,,273,14603
Nass Gitwinksihlkw,2013,0,,274,14603
Nass Gitwinksihlkw,2013,0,,275,14603
Nass Gitwinksihlkw,2013,0,,276,14603
Nass Gitwinksihlkw,2013,0,,277,14603
Nass Gitwinksihlkw,2013,0,,278,14603
Nass Gitwinksihlkw,2013,0,,279,14603
Nass Gitwinksihlkw,2013,0,,280,14603
Nass Gitwinksihlkw,2013,0,,281,14603
Nass Gitwinksihlkw,2013,0,,282,14603
Nass Gitwinksihlkw,2013,0,,283,14603
Nass Gitwinksihlkw,2013,0,,284,14603
Nass Gitwinksihlkw,2013,0,,285,14603
Nass Gitwinksihlkw,2013,0,,286,14603
Nass Gitwinksihlkw,2015,0,,151,0
Nass Gitwinksihlkw,2015,0,,152,0
Nass Gitwinksihlkw,2015,0,,153,0
Nass Gitwinksihlkw,2015,0,,154,0
Nass Gitwinksihlkw,2015,0,,155,0
Nass Gitwinksihlkw,2015,0,,156,0
Nass Gitwinksihlkw,2015,0,,157,0
Nass Gitwinksihlkw,2015,0,,158,0
Nass Gitwinksihlkw,2015,0,,159,0
Nass Gitwinksihlkw,2015,0,,160,0
Nass Gitwinksihlkw,2015,0,,161,0
Nass Gitwinksihlkw,2015,0,,162,0
Nass Gitwinksihlkw,2015,0,,163,0
Nass Gitwinksihlkw,2015,0,,164,0
Nass Gitwinksihlkw,2015,0,,165,0
Nass Gitwinksihlkw,2015,0,,166,0
Nass Gitwinksihlkw,2015,0,,167,0
Nass Gitwinksihlkw,2015,0,,168,0
Nass Gitwinksihlkw,2015,0,,169,0
Nass Gitwinksihlkw,2015,0,,170,0
Nass Gitwinksihlkw,2015,0,,171,0
Nass Gitwinksihlkw,2015,0,,172,0
Nass Gitwinksihlkw,2015,0,,173,0
Nass Gitwinksihlkw,2015,0,,174,0
Nass Gitwinksihlkw,2015,0,,175,0
Nass Gitwinksihlkw,2015,0,,176,0
Nass Gitwinksihlkw,2015,0,,177,0
Nass Gitwinksihlkw,2015,0,,178,0
Nass Gitwinksihlkw,2015,1,,179,1
Nass Gitwinksihlkw,2015,4,,180,5
Nass Gitwinksihlkw,2015,0,,181,5
Nass Gitwinksihlkw,2015,2,,182,7
Nass Gitwinksihlkw,2015,5,,183,12
Nass Gitwinksihlkw,2015,5,,184,17
Nass Gitwinksihlkw,2015,9,,185,26
Nass Gitwinksihlkw,2015,11,,186,37
Nass Gitwinksihlkw,2015,16,,187,53
Nass Gitwinksihlkw,2015,10,,188,63
Nass Gitwinksihlkw,2015,5,,189,68
Nass Gitwinksihlkw,2015,10,,190,78
Nass Gitwinksihlkw,2015,10,,191,88
Nass Gitwinksihlkw,2015,16,,192,104
Nass Gitwinksihlkw,2015,10,,193,114
Nass Gitwinksihlkw,2015,26,,194,140
Nass Gitwinksihlkw,2015,31,,195,171
Nass Gitwinksihlkw,2015,45,,196,216
Nass Gitwinksihlkw,2015,37,,197,253
Nass Gitwinksihlkw,2015,56,,198,309
Nass Gitwinksihlkw,2015,94,,199,403
Nass Gitwinksihlkw,2015,35,,200,438
Nass Gitwinksihlkw,2015,29,,201,467
Nass Gitwinksihlkw,2015,33,,202,500
Nass Gitwinksihlkw,2015,19,,203,519
Nass Gitwinksihlkw,2015,33,,204,552
Nass Gitwinksihlkw,2015,55,,205,607
Nass Gitwinksihlkw,2015,39,,206,646
Nass Gitwinksihlkw,2015,103,,207,749
Nass Gitwinksihlkw,2015,212,,208,961
Nass Gitwinksihlkw,2015,130,,209,1091
Nass Gitwinksihlkw,2015,51,,210,1142
Nass Gitwinksihlkw,2015,90,,211,1232
Nass Gitwinksihlkw,2015,149,,212,1381
Nass Gitwinksihlkw,2015,47,,213,1428
Nass Gitwinksihlkw,2015,52,,214,1480
Nass Gitwinksihlkw,2015,222,,215,1702
Nass Gitwinksihlkw,2015,243,,216,1945
Nass Gitwinksihlkw,2015,170,,217,2115
Nass Gitwinksihlkw,2015,119,,218,2234
Nass Gitwinksihlkw,2015,209,,219,2443
Nass Gitwinksihlkw,2015,188,,220,2631
Nass Gitwinksihlkw,2015,103,,221,2734
Nass Gitwinksihlkw,2015,77,,222,2811
Nass Gitwinksihlkw,2015,91,,223,2902
Nass Gitwinksihlkw,2015,60,,224,2962
Nass Gitwinksihlkw,2015,19,,225,2981
Nass Gitwinksihlkw,2015,49,,226,3030
Nass Gitwinksihlkw,2015,129,,227,3159
Nass Gitwinksihlkw,2015,147,,228,3306
Nass Gitwinksihlkw,2015,154,,229,3460
Nass Gitwinksihlkw,2015,87,,230,3547
Nass Gitwinksihlkw,2015,67,,231,3614
Nass Gitwinksihlkw,2015,42,,232,3656
Nass Gitwinksihlkw,2015,51,,233,3707
Nass Gitwinksihlkw,2015,42,,234,3749
Nass Gitwinksihlkw,2015,43,,235,3792
Nass Gitwinksihlkw,2015,38,,236,3830
Nass Gitwinksihlkw,2015,62,,237,3892
Nass Gitwinksihlkw,2015,59,,238,3951
Nass Gitwinksihlkw,2015,39,,239,3990
Nass Gitwinksihlkw,2015,31,,240,4021
Nass Gitwinksihlkw,2015,8,,241,4029
Nass Gitwinksihlkw,2015,6,,242,4035
Nass Gitwinksihlkw,2015,6,,243,4041
Nass Gitwinksihlkw,2015,5,,244,4046
Nass Gitwinksihlkw,2015,11,,245,4057
Nass Gitwinksihlkw,2015,17,,246,4074
Nass Gitwinksihlkw,2015,22,,247,4096
Nass Gitwinksihlkw,2015,2,,248,4098
Nass Gitwinksihlkw,2015,2,,249,4100
Nass Gitwinksihlkw,2015,2,,250,4102
Nass Gitwinksihlkw,2015,2,,251,4104
Nass Gitwinksihlkw,2015,3,,252,4107
Nass Gitwinksihlkw,2015,1,,253,4108
Nass Gitwinksihlkw,2015,4,,254,4112
Nass Gitwinksihlkw,2015,0,,255,4112
Nass Gitwinksihlkw,2015,0,,256,4112
Nass Gitwinksihlkw,2015,0,,257,4112
Nass Gitwinksihlkw,2015,0,,258,4112
Nass Gitwinksihlkw,2015,0,,259,4112
Nass Gitwinksihlkw,2015,0,,260,4112
Nass Gitwinksihlkw,2015,0,,261,4112
Nass Gitwinksihlkw,2015,0,,262,4112
Nass Gitwinksihlkw,2015,0,,263,4112
Nass Gitwinksihlkw,2015,0,,264,4112
Nass Gitwinksihlkw,2015,0,,265,4112
Nass Gitwinksihlkw,2015,0,,266,4112
Nass Gitwinksihlkw,2015,0,,267,4112
Nass Gitwinksihlkw,2015,0,,268,4112
Nass Gitwinksihlkw,2015,0,,269,4112
Nass Gitwinksihlkw,2015,0,,270,4112
Nass Gitwinksihlkw,2015,0,,271,4112
Nass Gitwinksihlkw,2015,0,,272,4112
Nass Gitwinksihlkw,2015,0,,273,4112
Nass Gitwinksihlkw,2015,0,,274,4112
Nass Gitwinksihlkw,2015,0,,275,4112
Nass Gitwinksihlkw,2015,0,,276,4112
Nass Gitwinksihlkw,2015,0,,277,4112
Nass Gitwinksihlkw,2015,0,,278,4112
Nass Gitwinksihlkw,2015,0,,279,4112
Nass Gitwinksihlkw,2015,0,,280,4112
Nass Gitwinksihlkw,2015,0,,281,4112
Nass Gitwinksihlkw,2015,0,,282,4112
Nass Gitwinksihlkw,2015,0,,283,4112
Nass Gitwinksihlkw,2015,0,,284,4112
Nass Gitwinksihlkw,2015,0,,285,4112
Nass Gitwinksihlkw,2015,0,,286,4112
Kulukak,1994,0,,179,0
Kulukak,1994,0,,180,0
Kulukak,1994,0,,181,0
Kulukak,1994,0,,182,0
Kulukak,1994,0,,183,0
Kulukak,1994,0,,184,0
Kulukak,1994,0,,185,0
Kulukak,1994,0,,186,0
Kulukak,1994,18,,187,18
Kulukak,1994,0,,188,18
Kulukak,1994,6,,189,24
Kulukak,1994,30,,190,54
Kulukak,1994,36,,191,90
Kulukak,1994,18,,192,108
Kulukak,1994,54,,193,162
Kulukak,1994,42,,194,204
Kulukak,1994,24,,195,228
Kulukak,1994,408,,196,636
Kulukak,1994,306,,197,942
Kulukak,1994,186,,198,1128
Kulukak,1994,378,,199,1506
Kulukak,1994,150,,200,1656
Kulukak,1994,1548,,201,3204
Kulukak,1994,444,,202,3648
Kulukak,1994,264,,203,3912
Kulukak,1994,426,,204,4338
Kulukak,1994,1410,,205,5748
Kulukak,1994,966,,206,6714
Kulukak,1994,768,,207,7482
Kulukak,1994,1119,,208,8601
Kulukak,1994,1134,,209,9735
Kulukak,1994,1326,,210,11061
Kulukak,1994,972,,211,12033
Kulukak,1994,654,,212,12687
Kulukak,1995,6,,177,6
Kulukak,1995,0,,178,6
Kulukak,1995,0,,179,6
Kulukak,1995,18,,180,24
Kulukak,1995,0,,181,24
Kulukak,1995,6,,182,30
Kulukak,1995,12,,183,42
Kulukak,1995,0,,184,42
Kulukak,1995,0,,185,42
Kulukak,1995,0,,186,42
Kulukak,1995,0,,187,42
Kulukak,1995,12,,188,54
Kulukak,1995,0,,189,54
Kulukak,1995,0,,190,54
Kulukak,1995,6,,191,60
Kulukak,1995,18,,192,78
Kulukak,1995,6,,193,84
Kulukak,1995,18,,194,102
Kulukak,1995,54,,195,156
Kulukak,1995,24,,196,180
Kulukak,1995,42,,197,222
Kulukak,1995,66,,198,288
Kulukak,1995,48,,199,336
Kulukak,1995,84,,200,420
Kulukak,1995,72,,201,492
Kulukak,1995,18,,202,510
Kulukak,1995,54,,203,564
Kulukak,1995,18,,204,582
Kulukak,1995,23,,205,605
Kulukak,1995,26,,206,630
Kulukak,1995,36,,207,666
Kulukak,1995,132,,208,798
Kulukak,1995,96,,209,894
Kulukak,1995,9,,210,903
Kulukak,1995,42,,211,945
Kulukak,1995,6,,212,951
Kulukak,1995,18,,213,969
Kulukak,1995,30,,214,999
Kulukak,1995,24,,215,1023
Kulukak,1995,8,,216,1031
Kulukak,1995,8,,217,1038
Kulukak,1995,6,,218,1044
Kulukak,1995,6,,219,1050
Kulukak,1995,0,,220,1050
Kulukak,1995,6,,221,1056
Kulukak,1995,6,,222,1062
Kulukak,1995,0,,223,1062
Kulukak,1995,0,,224,1062
Kulukak,1995,0,,225,1062
Kulukak,1995,0,,226,1062
Kulukak,1995,6,,227,1068
Kulukak,1995,0,,228,1068
Kulukak,1995,6,,229,1074
Kulukak,1995,12,,230,1086
Kulukak,1995,0,,231,1086
Kulukak,1995,6,,232,1092
Kulukak,1995,9,,233,1101
Kulukak,1995,6,,234,1107
Kulukak,1995,6,,235,1113
Kulukak,1995,0,,236,1113
Kulukak,1995,0,,237,1113
Kulukak,1995,0,,238,1113
Kulukak,1995,0,,239,1113
Kulukak,1995,6,,240,1119
Kulukak,1995,0,,241,1119
Kulukak,1995,24,,242,1143
Kulukak,1995,6,,243,1149
Kulukak,1995,12,,244,1161
Kulukak,1995,6,,245,1167
Kulukak,1995,0,,246,1167
Kulukak,1995,0,,247,1167
Kulukak,1995,0,,248,1167
Kulukak,1995,0,,249,1167
Kulukak,1995,0,,250,1167
Kulukak,1995,0,,251,1167
Kulukak,1995,0,,252,1167
Kulukak,1995,6,,253,1173
Kulukak,1995,12,,254,1185
Kulukak,1995,0,,255,1185
Kulukak,1995,3,,256,1188
Kulukak,1995,6,,257,1194
Kulukak,1996,0,,175,0
Kulukak,1996,0,,176,0
Kulukak,1996,0,,177,0
Kulukak,1996,36,,178,36
Kulukak,1996,0,,179,36
Kulukak,1996,0,,180,36
Kulukak,1996,0,,181,36
Kulukak,1996,0,,182,36
Kulukak,1996,36,,183,72
Kulukak,1996,96,,184,168
Kulukak,1996,120,,185,288
Kulukak,1996,156,,186,444
Kulukak,1996,246,,187,690
Kulukak,1996,144,,188,834
Kulukak,1996,306,,189,1140
Kulukak,1996,306,,190,1446
Kulukak,1996,354,,191,1800
Kulukak,1996,318,,192,2118
Kulukak,1996,348,,193,2466
Kulukak,1996,150,,194,2616
Kulukak,1996,54,,195,2670
Kulukak,1996,108,,196,2778
Kulukak,1996,132,,197,2910
Kulukak,1996,138,,198,3048
Kulukak,1996,102,,199,3150
Kulukak,1996,108,,200,3258
Kulukak,1996,162,,201,3420
Kulukak,1996,390,,202,3810
Kulukak,1996,450,,203,4260
Kulukak,1996,678,,204,4938
Kulukak,1996,678,,205,5616
Kulukak,1996,288,,206,5904
Kulukak,1996,486,,207,6390
Kulukak,1996,252,,208,6642
Kulukak,1996,120,,209,6762
Kulukak,1996,294,,210,7056
Kulukak,1996,222,,211,7278
Kulukak,1996,126,,212,7404
Kulukak,1996,234,,213,7638
Kulukak,1996,204,,214,7842
Kulukak,1996,126,,215,7968
Kulukak,1996,120,,216,8088
Kulukak,1996,54,,217,8142
Kulukak,1996,90,,218,8232
Kulukak,1996,66,,219,8298
Kulukak,1996,186,,220,8484
Kulukak,1996,126,,221,8610
Kulukak,1996,66,,222,8676
Kulukak,1996,102,,223,8778
Kulukak,1996,42,,224,8820
Kulukak,1996,120,,225,8940
Kulukak,1996,78,,226,9018
Kulukak,1996,126,,227,9144
Kulukak,1996,84,,228,9228
Kulukak,1996,42,,229,9270
Kulukak,1996,42,,230,9312
Kulukak,1996,54,,231,9366
Kulukak,1996,96,,232,9462
Kulukak,1996,30,,233,9492
Kulukak,1996,36,,234,9528
Kulukak,1996,12,,235,9540
Kulukak,1996,24,,236,9564
Kulukak,1996,12,,237,9576
Kulukak,1996,6,,238,9582
Kulukak,1996,24,,239,9606
Kulukak,1996,24,,240,9630
Kulukak,1996,30,,241,9660
Kulukak,1996,0,,242,9660
Kulukak,1996,24,,243,9684
Kulukak,1996,12,,244,9696
Kulukak,1996,0,,245,9696
Kulukak,1996,18,,246,9714
Kulukak,1996,12,,247,9726
Kulukak,1996,12,,248,9738
Kulukak,1996,12,,249,9750
Kulukak,1996,18,,250,9768
Kulukak,1996,12,,251,9780
Kulukak,1996,0,,252,9780
Kulukak,1996,0,,253,9780
Coghill lake,1987,2,,179,2
Coghill lake,1987,0,,180,2
Coghill lake,1987,0,,181,2
Coghill lake,1987,0,,182,2
Coghill lake,1987,0,,183,2
Coghill lake,1987,0,,184,2
Coghill lake,1987,0,,185,2
Coghill lake,1987,0,,186,2
Coghill lake,1987,21,,187,23
Coghill lake,1987,39,,188,62
Coghill lake,1987,31,,189,93
Coghill lake,1987,186,,190,279
Coghill lake,1987,408,,191,687
Coghill lake,1987,1212,,192,1899
Coghill lake,1987,2841,,193,4740
Coghill lake,1987,4945,,194,9685
Coghill lake,1987,6493,,195,16178
Coghill lake,1987,3303,,196,19481
Coghill lake,1987,7206,,197,26687
Coghill lake,1987,400,,198,27087
Coghill lake,1987,245,,199,27332
Coghill lake,1987,1658,,200,28990
Coghill lake,1987,3197,,201,32187
Coghill lake,1987,3166,,202,35353
Coghill lake,1987,2990,,203,38343
Coghill lake,1987,3100,,204,41443